number,zeroes count,ones count,s,p-value,success
6CCBE091F343333648F5914C283A4A7987394909A0A77DC2676B325018C559E4,138,118,20,0.2112995473337106,PASS
582A25CB919C22EDD74B5E393CF0EEB5E82CA1FDBC69505BC8CD4A99C27657C,126,130,4,0.8025873486341526,PASS
331593E7AC4AE6E6720196FA7B96B9C12508527CD9178BFA0959D73BFAC81CFA,123,133,10,0.5319710580974012,PASS
338F0218A6294AADD69454614E1188F6B339F205D55C9A59A17A68DBB98C5B09,136,120,16,0.31731050786291404,PASS
D40B286E024E28BD591F609D52F517A8F99A40FC75FBC508D88A57661F67365C,129,127,2,0.9005235503397743,PASS
2A552840441EC74DC2BEDD796490248B202FDF988036410D6F14961C9D0920B1,147,109,38,0.01754895019147673,PASS
11E2E472974748E841E065E8DF0196F8E5F79D283A586C95BB0B23E0B01712CF,133,123,10,0.5319710580974012,PASS
A36DCB5F8713C9B96CFA9699B6A96E9A606843F68B8059E661EFA5874E4160EA,125,131,6,0.7076604666545525,PASS
44DB29F5C550479A1188DDFAB8A51BBDDB2BFB75306A3428187C376DA0A830DB,128,128,0,1.0,PASS
F3E7D35CEB99F75E3D944883B96D1541DD606F1D261FFA209C7F33C82803A5A5,122,134,12,0.4532547047537365,PASS
22AD26F9A7B97D7BBAA2F660E9AAC499AFA74AB8F4D5E91F36A88C2156D62A31,121,135,14,0.38157390570502125,PASS
24AB721E38C17EF224BD01F0FE86D23C43407ED13872E6E9F63FDA9FEF943053,123,133,10,0.5319710580974012,PASS
70523394FAE7D240D5F6793D75C7DC4A2716AA219B6A2065495E566B5C58B27A,127,129,2,0.9005235503397743,PASS
50083141E75A06839C8C59B5B7A5A279051F224D69BD9939FC1E463FD0010DF,138,118,20,0.2112995473337106,PASS
7EC9D6B4D00DD49986C3449E8D14153771AFE1BF50A65DE2D77B4A3C6573EE7F,118,138,20,0.2112995473337106,PASS
1711B3411129C79709408C1E928AE4DD1AE2F72C410435438B294CA91F441160,150,106,44,0.005959526470109114,FAIL
519967CD2BC25CC6DC664C5E11C9EA217168E6F37F1CAE9F6A01CE4A93FC2925,126,130,4,0.8025873486341526,PASS
C3A913A50F68395BE339B9ED646FF28C49F670674FE689C563D6B01F4D23B28B,122,134,12,0.4532547047537365,PASS
447099F1A090B26D3AF227E0BC025FE5034D2772F47DBED9B85CD25FEA5D0097,127,129,2,0.9005235503397743,PASS
26E50B5B14EFF56A3BDBB28FB4AB3962D0FAFC8A70B7589F99A2999D788EDC47,116,140,24,0.13361440253771617,PASS
7E7328978A77DE3CF8F7D0A5BF960EFDFE5F15BBADDAFB6501CE9E020ADE9C98,109,147,38,0.01754895019147673,PASS
EFF411324078F91C9B7A34B9B11FFF85C903A911E96E6A037216171D7D271738,127,129,2,0.9005235503397743,PASS
FDF9984817B051C6AA92EEAE6772AAB8BEECA33942861A0A9746FAC51AC337B5,125,131,6,0.7076604666545525,PASS
3AC5D5AE32C7E0F30C4D90DEE813BD454FBC84F4206D4946428C3C6769881555,135,121,14,0.38157390570502125,PASS
F7E7227766CA07ECBD7C19C6332E196A0F04CDFBA22EA92E0407B112C10D6C1,133,123,10,0.5319710580974012,PASS
7648DAA4A8EFD27F222616942E7E836AB5529E35794E94CDBAE0008A5D7D85A9,129,127,2,0.9005235503397743,PASS
B5168E84D9C017E4D1630B5A085A76005B9D2F58EF7609F4329063E123321CD,140,116,24,0.13361440253771617,PASS
7E6F3AB9D77C8DF9F9939560A7291B0ACE8DC136B7D09F2BC5D48AB2EAD21243,120,136,16,0.31731050786291404,PASS
BA57BBE065CC7F81B7C154EB96D99229054FC7BCD4A601679D783E11B05FB74,124,132,8,0.6170750774519738,PASS
3279E08EFD54E24FEE6395A70246F5235D21F477842E8B1CA1C2A9A79BE5354D,126,130,4,0.8025873486341526,PASS
619947D766266250F76365ADD3C088F3B70BAEEB603DF04CE4E5DD37EF7FC259,117,139,22,0.16913144470267139,PASS
CDF1DCDB2A68DBA2C5C4AF885F888BDE722FF7A5EB95C966506F4C9A73F05D9,118,138,20,0.2112995473337106,PASS
E0FB52F312C6E42AB16CE2DDE771C31B07D6AACC95322775B6DAF7DF2A7C6A91,117,139,22,0.16913144470267139,PASS
8499ECD57DD156E94B8C7A5E51B8C4A4682D4611A16E2BFEAF681C452BEA1DAF,126,130,4,0.8025873486341526,PASS
A7053F2624BE98219F41019DFF6DACBBB03B155E71CA02E57C00460CE49DB8A3,133,123,10,0.5319710580974012,PASS
254E1C9EFD69D3B04C3CA44E64F07821FA4D3766AB5FD38E89F40331E221F4B3,127,129,2,0.9005235503397743,PASS
6D0EF4A3487331DF345810D9DDB14243011E13857C5A0C1D89203941FE3FB4D,139,117,22,0.16913144470267139,PASS
9B1A58D4F2442E1F4D2607F1A44FCFBFA8E63F94BA74D36E71E4379EF8570DF,118,138,20,0.2112995473337106,PASS
3BF4E535C72F627F3D5661BC8BB0E234C426962454BB7FEC2FF3D3F4B060675,120,136,16,0.31731050786291404,PASS
A055E6D1068E9A1A86D598C8533B7BED7AE489D9E24764667A984CF64C3197A7,128,128,0,1.0,PASS
B046D47DB2686A5D48F8836DF2EF0BA1F74F05C8E1A1FF2724BBCE25EB1DF175,119,137,18,0.2605890342736178,PASS
31A9E4D3B4C448A12100E11763D107DAAEE6D3102AA1539EB9E55859B7AA36F1,135,121,14,0.38157390570502125,PASS
42308FC6629525FB0D2D7E4D1A4991C65AFABE14FC6A1BF9585E8361DB028A7E,128,128,0,1.0,PASS
9BE358F0F0F39BEFDF4CC2A5931069F398271C00BF8790B3409E880FA43F0BEC,128,128,0,1.0,PASS
6A2663EC7ECDE86F3EDEBE943C558E6ECA0019BEF68AED0D0F010E444D30043F,128,128,0,1.0,PASS
5E6DDA281466A279AEFFF55F08F8A54BBD90FDFBDF1A8B41BBF7248F577A654,113,143,30,0.060792723530522785,PASS
51F73B3AE9A8A6C062C79394A3FCB45E28C47F975A28C87F0267C8C90B75A96A,127,129,2,0.9005235503397743,PASS
2B7A56993872B76F19CD34064FCE183B2D85D89A91C903B9D7AF1CFF9FA0AA7C,121,135,14,0.38157390570502125,PASS
AF3A670D5FF68F5F46DAB31E08551B0E5C320B0D5223FAEE6F92F21A25A5D980,125,131,6,0.7076604666545525,PASS
4BFEFA3B6064A57C9646139DF0D1287FB4A2197104D5E5ECE8417DDC61475734,126,130,4,0.8025873486341526,PASS
FB49C8290D8764C07763178B2C8DCF3EF5B7E237560EA8001146EA58D1CF8D67,129,127,2,0.9005235503397743,PASS
43D671BDEC5EF30D44BBED2356C84461980FC30ED44FE03A661CD94D5E59AD25,127,129,2,0.9005235503397743,PASS
C79265E665EB958EA34E5DEAA0B8EFA026394D91CE933375CD5E56D54A831AC2,125,131,6,0.7076604666545525,PASS
93E35EB8ACE7829C91CB8D010546212597DE71FDBFDD4A71C26FA641BE4C6757,123,133,10,0.5319710580974012,PASS
7E8CFA4C0F2A32A9E159CAF20B95556B616F63E0524CF20C5557BB8BDCB23B98,126,130,4,0.8025873486341526,PASS
7EA21CD6E97CBC111A1108A68AD8C651E03AB6E5FE2A9ACD98D5430C3689EBB8,132,124,8,0.6170750774519738,PASS
EDE63DC8EFCB8F35D06711C07D82EF410847D67B615A2C57A12919913BF811FF,124,132,8,0.6170750774519738,PASS
DDF0106997E73860988A09826A9EA463650E0B2CA355687B78EB493F13862DB7,134,122,12,0.4532547047537365,PASS
FEF727A4ECCDFC6099B26415FDEF7006AA488250935113CD11595A09D1B00CAD,133,123,10,0.5319710580974012,PASS
E33A558C119747994232BA9A6B3845B2F3109B0BE95AF5CF03BE02FDCF76A652,126,130,4,0.8025873486341526,PASS
47AD8B3C6EF28528D33B192C61EE4939C391E704EA4FF786E0D39F5C62699D08,127,129,2,0.9005235503397743,PASS
E587D5D701D31919296E7086587B4509CEE79987FAE8CA20089D002C19E852C3,139,117,22,0.16913144470267139,PASS
59EF52D94CCF8619AF501C05DC6BB98713882FC93FC6B0A9F9A8058D21D7E038,130,126,4,0.8025873486341526,PASS
99A3F00D654E0F3A569E2A495400DA90B7F8CD16C4D689FBF21596BF43C896BB,128,128,0,1.0,PASS
2AB76E8783054580E4BFD497AD2F8E2B0CE4F000C6E41630D3E2DA335170031F,137,119,18,0.2605890342736178,PASS
1CEB2D5105E5806DD66333AB91BBE4D19DB33ED74C9010E6FF7C3C67A99CC9A8,123,133,10,0.5319710580974012,PASS
77B99BFBCFAA69F4EFB3AB0D1193937E4EF5403926C31FA834C47E51E400CDD1,120,136,16,0.31731050786291404,PASS
C97A712C14782EFE95AF6562CCCED07CAA97DFCF8443C2D77B08D5D22D194050,127,129,2,0.9005235503397743,PASS
4AFC057A25C289511E51341D9010181948C5D017FDD5A3C7DE92203A366514C9,144,112,32,0.04550026389635853,PASS
B1A7EEC0A025EC838E75715F7E2C8E8FB7F8AE2312CC8FB908F2D2158B581D9A,126,130,4,0.8025873486341526,PASS
957B0225C490744E9BED140C4925F127F5AB1BF8955B84736B2395970C89CC9E,132,124,8,0.6170750774519738,PASS
1C475254E11908CFD10133F9F20E5C63B3E9134D71455877BC7BE1324080A3AF,135,121,14,0.38157390570502125,PASS
783920B57A0E4F6CDC7CCFC11A29FF9B2AA47D151172C7E8B7A87CDDC848C1F9,123,133,10,0.5319710580974012,PASS
500313143ABD8213970D59323C12F0A61CF73247FCC7BD80BF963C2308330D27,138,118,20,0.2112995473337106,PASS
F7A3CD04803CB26C27BD2CFBEFB6664D88BD21E8525A5295B9008C42CE99F305,131,125,6,0.7076604666545525,PASS
3516A429FCECCC8C7035BE4F9D5AD3B2E6CCA568AD49EBF64F3795EF59F27EA1,114,142,28,0.08011831372763423,PASS
E398DC5EA7C7E6D2A99CCD3CD7D65FE0BEAA05BDA1849E2F7C640A6E9E896C3A,118,138,20,0.2112995473337106,PASS
FB2FC3A61072D7B06CED938999919802DBA271AFE7537A81BB977A93E8F76A9,121,135,14,0.38157390570502125,PASS
8409479AA5A1279EE41ACE4EA84B0462A6EFE3FEA1B656BE006B4DE3154B5C0,135,121,14,0.38157390570502125,PASS
6ED1023A62FFFE780186C3847DE514B85B64EAFBCAF3973F8EF4C64BCECEF5FD,112,144,32,0.04550026389635853,PASS
624904EE5807ACBE9259E08A6F6CD62963C77AD0A8A797D65BD101EED8FC0036,131,125,6,0.7076604666545525,PASS
2E60391C05CA278D14F4E95A1EA9278258E52426EBFFD8F5139BE3347B85C34A,130,126,4,0.8025873486341526,PASS
CED1272E7FCBC47142E959BDD8A80A2D840C232F1244FABBDEE43395130E8F67,128,128,0,1.0,PASS
1908577A685DBD0D9FB953F35FD01F8F2D34E4BA7237E68D0582D93158208135,129,127,2,0.9005235503397743,PASS
AEF292A2198E2E7D24872911E562541B3F213B0D754BC235669D43D4795EDBE0,130,126,4,0.8025873486341526,PASS
4F7313C445A7E44BC235F75FB9D185A61CD1DB464D535C4897FFB6E86B450645,123,133,10,0.5319710580974012,PASS
90D004A50C5985CEF2B505690169D7107D2D4A4BDBFE8852CA9682846A1676D2,141,115,26,0.10416255883043901,PASS
E656FB7EF3DB44038692FF28DFF9A7E603853AF5F8BE35559555C6B0D908E62E,115,141,26,0.10416255883043901,PASS
CBC3C8200C8696887C9A736E2FD1161BF66AA8ED72907249DBE32F36126EACE5,129,127,2,0.9005235503397743,PASS
6EB3C90E325C1BB7637274C8964172C0B97BF5C3C72FD9071885F941E656C447,127,129,2,0.9005235503397743,PASS
C63C22C3DB05FAE78012E737160E2BA8824DB84915160F4AF07E716B4F770916,134,122,12,0.4532547047537365,PASS
332D41A19135C5D67E8E23360474A156C0DA786FE599908FA6544E9D0D0FC379,133,123,10,0.5319710580974012,PASS
D50D3917A4513D39AD75E2C1E5ED0CA9B9DD481D06CCAA0756FCA355E717FCDF,120,136,16,0.31731050786291404,PASS
93134FFBC9FFFCA9E9CFC2C2454EF398D03F662C24802A99764E70F5B8486237,124,132,8,0.6170750774519738,PASS
8E99A5F716B0FAEDC81FB6E93B2407FFEF4610C05464D39BCB2B25D330CCFBD,121,135,14,0.38157390570502125,PASS
1D3183F70F7CF1082F492E218A2B18FD8C79C3988B92DE6F74E606FD3A53B1E0,127,129,2,0.9005235503397743,PASS
6CD4EFF065ED652BCA2B0DD881C34B89F33227E34182CB30E4A8278AA2EDABF1,129,127,2,0.9005235503397743,PASS
445873CE38D5DD2D2086380CA05C8F510F92D39E0DE327058B1F1B4B25DB0D0,140,116,24,0.13361440253771617,PASS
3BF88D15517AA3ABD819092C001880636CA99D9DB68111C0BB043CA31AD5F1E0,143,113,30,0.060792723530522785,PASS
F103329A8B74598B818BCFE225BDE0C404A7A75459978B251E190C1BEF4C3421,137,119,18,0.2605890342736178,PASS
D1AB87E4FEA4F607FB92AE431F67AD5E6D341ED5666A14F7C032A106505C9680,127,129,2,0.9005235503397743,PASS
2ABD7A026D68064BBC5E62FF453882A9F9AA98133F97927EB0E27BF115B9C4F3,123,133,10,0.5319710580974012,PASS
4AAE16DA37169125900483495629512BF577EAAB68EA1AAAD45CEA6EA55E15C1,133,123,10,0.5319710580974012,PASS
FAE18C80BCDEEABF961A59324A0EAE9C771D40053CA9A0D10D551237FB23D5A,132,124,8,0.6170750774519738,PASS
742BD761C051847CAE82E5D9430E61F0F9101D204EAE64D06D67021D804C4502,147,109,38,0.01754895019147673,PASS
A678213F343EDF390C59216D2314729F28CD92C140C8B1EE7F3DF5B944F0C791,129,127,2,0.9005235503397743,PASS
8DDDB7BE880EB5D0BDA8393C49DAA3020E3C99EDC281B63316510527E2FC09D8,132,124,8,0.6170750774519738,PASS
D13480A7D4D4E3481456943D876A5AEB0D28C75C4301816FCA3152319F25891D,141,115,26,0.10416255883043901,PASS
9BC66808ADE4F9AE6506ACCD89B6880ADF8AEE4C02FA2A47CE0DED70817D01A,135,121,14,0.38157390570502125,PASS
F129DC076C22EF5CF7CB8CC2918AD99755BF33ECBE2114735144F057639E7774,121,135,14,0.38157390570502125,PASS
BD9671673BCEDE9419CC6402EA96F8A8C92DDA4047CCA446AB0BDCB348C40A2E,133,123,10,0.5319710580974012,PASS
C137A802301BFE6D3E1355817AA11D1FCB52FD065C5638A3C71677E0AA76D921,130,126,4,0.8025873486341526,PASS
C10019E78A8FCFF4CCE7C27BD79106EA187D3364F46627FFE9B74B7BE4361A8F,117,139,22,0.16913144470267139,PASS
9FE3EF901C467EC2FF171695B6706DA1A71C811380A57B5EE4C23EA7BF8BA7E6,119,137,18,0.2605890342736178,PASS
C4576255390BFC75BFBEEBB07BAAC02F36F2FF10BA86E3556A78A4A8A2F5C65A,118,138,20,0.2112995473337106,PASS
67AA7BF5E9ED9CD55173D8DDF1BB17D7EE9083CA77EA59250A44F17F952F119E,111,145,34,0.03358661289689768,PASS
B98B89F1EFEE0EA727891FACDCD1AC367CF07D083124D0140F55BB260C019009,135,121,14,0.38157390570502125,PASS
109FA7877F43CDA97B2B2C75965C6291D7F087548D132FDE5C2E7CB62B17B95B,118,138,20,0.2112995473337106,PASS
DCE11203019CD26766F230A20FDC3CF9D1FE4C40AD853C60950B6467B73BAFCE,130,126,4,0.8025873486341526,PASS
2509047AF33E4879D0A13901CABC85403A35EECC675CB899DB7137DF5785AE86,130,126,4,0.8025873486341526,PASS
D1ACD3AB5B6ECFD614D29695BB47FD118343B29C8BB26E8848D51EBC47027333,125,131,6,0.7076604666545525,PASS
2A991B50F28F912C7BE2DDF0AE93893882C226D07835CA3F21F98C95D26BEE0C,131,125,6,0.7076604666545525,PASS
F6B08D773F92154BCD85CA1BCFDF46C5001C8DA1F9F45AA9129784FAD381F50C,126,130,4,0.8025873486341526,PASS
20E5CF9C8304FED67939F0742F664E402AD0ED84369594A7AFA1FF2416B70341,131,125,6,0.7076604666545525,PASS
449E3E399B493A2B4B9403146C886BC345E21A6F39A38E3749DBA8CBC0B5A501,136,120,16,0.31731050786291404,PASS
A6B4B4918241C68E5A4CAA7BDAE17FB36FC61B2F0B99A86A9C47C3F27FD012D2,125,131,6,0.7076604666545525,PASS
211AE8D7E2CB311D91E1EBD56D03B2F77BF2271FBB672B1661DDCF0161A6E1DA,119,137,18,0.2605890342736178,PASS
5C014F0A1FE07950C11CD4BA326CC63EC97C4E893238E5EF0BA31B4AF17D573A,130,126,4,0.8025873486341526,PASS
9799A59F22890A269ED0492E965D17309E56AD3EFDD1A03137FC262F9415203,134,122,12,0.4532547047537365,PASS
94E43A8B2D037E64F5FAD4D82E2DF9CAF0E66370DCE7ACBA75FBA47074A7D7FF,111,145,34,0.03358661289689768,PASS
AF4C107B9184D1F1F3849AB26F8A1002C9A7859D3EB8993999693E0AC1577F16,132,124,8,0.6170750774519738,PASS
8EA6DD0E5210FC3CDC67760C9B45A14BBBF321CA31EB107860CCBAE1F21E5FAA,127,129,2,0.9005235503397743,PASS
4F7C620C0A2C794455A58C89327672A381CBEE49F8E9F264D534DB20231A8124,140,116,24,0.13361440253771617,PASS
F478A7ABDD40DE7AC4142B78C1CBFF5C927A53535E46991AF2009B0681EDE5A7,125,131,6,0.7076604666545525,PASS
F0F2BE122534B1B554D2842522CCEAF1FC514829A4565BE97F2EA55AB9C71C38,130,126,4,0.8025873486341526,PASS
E46B6CE86FAA17D31FC532171B754B3E079DEFE895156DA85F4A881A73186AD6,122,134,12,0.4532547047537365,PASS
3FFEBD05F4A79B059B487DA95A7B1EFD7E8E30A18FE5BE8AA7FDEAC17ACB0949,111,145,34,0.03358661289689768,PASS
402831FF5AF1E254B4B4162583CDB68872233ECA1A1151104BCC1D58AA8DE8D7,139,117,22,0.16913144470267139,PASS
D133987FACCE63A85C62839CDAA19C223E900274DB61998BAB48D02373635A0C,137,119,18,0.2605890342736178,PASS
6E470AE43F4312024FB2A381DC84EAEB9ECE3E6200C5584D664A5ABFED247772,131,125,6,0.7076604666545525,PASS
262835DDA03A40629A29A1133640F2913A6FDDF2D5BF023FB168CAAFDB60EA57,130,126,4,0.8025873486341526,PASS
992D50933328BB634A6160338C9CD19A97D3DCAD0F9A71CD527FE976594EA00E,129,127,2,0.9005235503397743,PASS
EF3585B6F5B02A8650E366F3E88C6C8021A9231A2AD7757F553725053E5650FC,129,127,2,0.9005235503397743,PASS
C5DDDFDE3ED7DCCE62E7EB8A507FD5FE6429DF6554D9BB06B7977891070A3F8C,108,148,40,0.0124193306515523,PASS
6010EF76B356F2D85D1494C3507EF47FE375D12A59E71FBA0AEEEFED7CC472C6,115,141,26,0.10416255883043901,PASS
C99BC19E628FB51D8936533FEC14A42F5053AA5AC5FB354E1A0E25C2A9DF55B4,126,130,4,0.8025873486341526,PASS
140716C7CF127A0A3FCF80854CEE255E721B070A3A71D49D04567794BA3BC87F,131,125,6,0.7076604666545525,PASS
7D946848D64B43A6F6E8A1B02889C1B215A97E70515A44C1547754CF46C4DE1A,137,119,18,0.2605890342736178,PASS
8522532FC70E7BF6EB1681ED9D57C554A18F3893B616517ADC5AD4EE040CC706,128,128,0,1.0,PASS
40BCE60B8A05B4AB679385CFF88E37B2BABD0EE3202E9EABE4324D93A7C8580C,130,126,4,0.8025873486341526,PASS
BEB66044B0A53C242BC8FD77944CB2E51A017645D90EEAC3F1E7701558AE48B8,133,123,10,0.5319710580974012,PASS
38D293E94070A8CF08FAA2F94873462985E50D14C4ADCBCEF9625540F48DB8C7,135,121,14,0.38157390570502125,PASS
52ABF622013DA118640064F60134FC2E0FFEFF0495E092328527954EF6B99344,138,118,20,0.2112995473337106,PASS
94FF2210AF0C0639CE6D9CF1D9F5993D01D4DFA6E895113AD3452E584C1BB828,131,125,6,0.7076604666545525,PASS
4C567E519752EF601073D7DCD00D435C18C7D25FC60ECDD29FE82B4060E6A133,131,125,6,0.7076604666545525,PASS
5B67E98A090EC3BC1B0132B6C078FA40CE44D0D026183786292678DF85279B6,141,115,26,0.10416255883043901,PASS
,256,0,256,1.2777508801076536e-57,FAIL
7D5CD2B6F84EB6C3BEE325DF94F092E3407660350DBE750F339AE3B3CBF7ABE4,114,142,28,0.08011831372763423,PASS
5E8D650626F6D7996A9A5B378EFC85FD6C6270D9EAEFB906B6EED98E751161B3,115,141,26,0.10416255883043901,PASS
A5F37649D91B7E765700534317761C622D366E48E76924953148AFF5F590A693,127,129,2,0.9005235503397743,PASS
AA43F304C6ACCB520F86E3B609932DD88318B0F943CB09C1B26586CE3E8AFAD8,134,122,12,0.4532547047537365,PASS
8745AD97B5CF0A9485433E8F2D41026E71CE24DD74C4281C3C7B2A190F0E699A,135,121,14,0.38157390570502125,PASS
E4833DC7F8CCBB49BA700740DB5A920EDDC81DE28B2AC163C4A362D08BB03ADA,133,123,10,0.5319710580974012,PASS
E3C118B3495CF77216CBA9590ECB4CB5C9D3E98F0461802B48CB42D022276631,138,118,20,0.2112995473337106,PASS
60A669BB37FC15076B0A538CE6C2D3E4E785664462CEC1EBCACD80F7F0C89AD5,127,129,2,0.9005235503397743,PASS
E666652DA9440CB7CEFF4EE803DA567E15053A2FF0649AD4DB189867261866A6,129,127,2,0.9005235503397743,PASS
3EE6EE607F5432850E28628CCCAF1105A2A2EE076D8AA80D43F66EBEA262A607,135,121,14,0.38157390570502125,PASS
8BC379BAB30A628D7901846416F0C85EFCB6C09CF847BF8F0E7A8F83F388411,133,123,10,0.5319710580974012,PASS
AE648BA56A1CCDF520B229C30BCD11495F080A6F2A3091018E1F52693B31A243,143,113,30,0.060792723530522785,PASS
A695BFE739CF3FF9FDA42487C03821EF96929313D2596C75C66099BABD6C5BA,120,136,16,0.31731050786291404,PASS
8AA27994D980F627CF9F8A4DD77168B6DC1BAD10D3662A8B61A3D9C3A195D011,130,126,4,0.8025873486341526,PASS
C439AED4893C495368380B4DB2FFED7AFABAC1E9CA1879C9BCD1A12A179C84FD,124,132,8,0.6170750774519738,PASS
707243A8EA9DB3FDA6AD86A20B7B558279981FD8D3BE6F8B17CE8649CDA71241,124,132,8,0.6170750774519738,PASS
68608AFBB6EC949B9D399F4E54C364496EFCB9B767FFD329AF33FE4B46869214,116,140,24,0.13361440253771617,PASS
CBE968AEC61CA497D87FDC8D1AD5F7EC31F746AA8C26E31D734D8BA78D8B1A3,120,136,16,0.31731050786291404,PASS
543227C3016FFE59627B0A82B4FDA9AC066B3B0DBF72B73554F93299FE0CECF3,120,136,16,0.31731050786291404,PASS
41D8626D214465729ED87458A0DFACA74D1FFD4B0288A4B75B2AFE8FFBD7DFF1,119,137,18,0.2605890342736178,PASS
9A0EC0B2528B973BC0F52F27DC6CD4CF5D150FDC445C73311C7EFDE84F6F7142,122,134,12,0.4532547047537365,PASS
C9D632026BF7662B1CBF9280F26BA49C98D908E2338A899FECFB01A3A20B0448,137,119,18,0.2605890342736178,PASS
D509218BEDCF95AECE53E5A77C44CD1D45F57065A21703D36B6B29FA9C5BE845,122,134,12,0.4532547047537365,PASS
3A170392C83AD23DEA1743A3BA4D23A66CE8C8908E336FE27998E8CD925B3537,130,126,4,0.8025873486341526,PASS
,256,0,256,1.2777508801076536e-57,FAIL
3F17CF3202014E27061CE8CAA994A3A86AA470ACC02D3DD6AE64DD5FF738BF3,131,125,6,0.7076604666545525,PASS
FD9C8C59E26CF93E1A2057F687B6916BF0929FEF4DE847468FB32DA688C07485,123,133,10,0.5319710580974012,PASS
D9C2C83712FAC00E9C312B6645E152C683A82D9803FC52EFF605F9ED2D08F22D,133,123,10,0.5319710580974012,PASS
3910EEDD9818559A28871CF72C3F8948D334B6D58459953A1518FF6381880F8,138,118,20,0.2112995473337106,PASS
A20351E711AE3D5EF2095D752EC4A0C439D7992E9F9F24770AE84172DAA4D3CC,129,127,2,0.9005235503397743,PASS
8F085B2A07DAC979CDA8CEE3DE17E44F8000EEACEBC9BB6AC7C466D8372BE301,126,130,4,0.8025873486341526,PASS
E1272A53F4C0F608585A06CD8966F48CDBBE41C8711B8F74F46176CD49A71350,133,123,10,0.5319710580974012,PASS
68195F22865C0B4BFCE8DD6A91CC2550F58470E4A66B18AF89231EC06A575969,135,121,14,0.38157390570502125,PASS
C7A3709B896F736D4C3953B81919F0D98A2586112974FAA0E04176E0011CFFB,136,120,16,0.31731050786291404,PASS
48BF13C2C4CE0728E22CE322ED0D41778E57B41CDEBC8CD0FD4BF8F7029A0EB5,128,128,0,1.0,PASS
B6AE9338C80855F644E4A69B2FAF3FB767D627BDB110F21AB47F9E217F7780DD,116,140,24,0.13361440253771617,PASS
6BFF0D132B372F9218EDA125FD8286D6634B4F9131A2D675F5ADA215800D4EC6,128,128,0,1.0,PASS
486AC53BAEBD8123D311C9052612FD5EA107EA5B89E1691289A24D63D38EFFC1,132,124,8,0.6170750774519738,PASS
F059AD5BFC3893407A5438A2E9DF0A5BD8E3866E7BE1EBF0221C1576EB6B5A05,124,132,8,0.6170750774519738,PASS
94CC396B0177360869313CA4A61CD35EF5F57A61C48DA77641560B69836BDBC5,129,127,2,0.9005235503397743,PASS
9A50177A272E9F696CA50F5865B6A3F73AC8667712B027DDE9B7C83E3B9534C4,122,134,12,0.4532547047537365,PASS
A2B16DBDEE0E2DC4224658F59076C72F1902A44059902C35063EC60A1D98EF0,143,113,30,0.060792723530522785,PASS
58F6715890B0FE692C50657D9AD83CF90F1A2C05D7763FD508A31AC842F2FBC7,127,129,2,0.9005235503397743,PASS
BDB03DBE0A8DF9310F07B8AACE1161991E7248C38A7C5B09D306873E14E5E17B,130,126,4,0.8025873486341526,PASS
6727CA68FB5A5AA99433CE14D19E640A0E498220E902BE6AF5C4302D53CF7F41,134,122,12,0.4532547047537365,PASS
4BA13E5AFCA6E8725233C23B8E92383419F09AF48EA7AA6A6E20F4623D36E023,132,124,8,0.6170750774519738,PASS
4FE82124D273B316A204D1EED9C3530219A0EA6F65CD9DDF45265E248C270F57,132,124,8,0.6170750774519738,PASS
524515E3615685AE8D38A9F12A5129E8D38614D49348A0C1709928DE4B9DD189,142,114,28,0.08011831372763423,PASS
6A2B72A9B6E17B44DC2C60C11081854CD9A10A1FA64B1AE148BDED5734C90424,142,114,28,0.08011831372763423,PASS
9D4D4901CDF23607AAB3862F1ACDF0D640560299529B16618EB83EA1A50E46F5,136,120,16,0.31731050786291404,PASS
A5FE6659909ABA6B13B6FBE0BF84AB2813DFDFB72F5B59E81113C5F8193CF735,114,142,28,0.08011831372763423,PASS
F68B6162C30884D1438127D106EEE1569BC0BA1794224135B17EBBDFFAD2FE3,131,125,6,0.7076604666545525,PASS
FE5147A856E4A970321B56D8DC9B6069C107B2DD1CD831FADEF433844D37BF1F,123,133,10,0.5319710580974012,PASS
6C7BA81B14802A8D7B823084F6601C620C1B66545337A7A876AB27296790E74A,140,116,24,0.13361440253771617,PASS
E55BB916C53BAD3C34085EEE5ACE7549E9115C17176FA61751DB77C639F1103C,122,134,12,0.4532547047537365,PASS
A307A347DF77451E8EBB8D08CB3A21665923074B9DF381FD1A1FD4700CC7102,133,123,10,0.5319710580974012,PASS
1D1892209A70FDA23C2191195D9EE3DC5CE9266D765CA9406C5F930B2E08DA76,134,122,12,0.4532547047537365,PASS
618F8CAF51C1916323D767231318F707E4F8E0884DEBF799B65723656B78049E,127,129,2,0.9005235503397743,PASS
7258B8ED331CB4CA2C07ED62189F47D9B36D00A8B18443B43FEE364350C2ECFF,129,127,2,0.9005235503397743,PASS
8EC5A73151D27E84BD22A890DF785488DECCF5D819AA90C8004BCB31BE6A2839,136,120,16,0.31731050786291404,PASS
850D79B50DA6E90DDEA3069A625BE9D34B8B0FB8B65FF291FE6079CF2FF92039,120,136,16,0.31731050786291404,PASS
F8F6B8668DA9343000913F6F0499EB785756DBA071A3B41A7C386306D9607B26,132,124,8,0.6170750774519738,PASS
6AE1F0D5ACD058673DD6ECA47FFC44E3B92C1E6E28EB0D6024DE650D5D997C48,125,131,6,0.7076604666545525,PASS
ADDE0101DDD54CAFEB76430C4D4F15C93DE6A44402A049EDF9B36F9E1351FB0,129,127,2,0.9005235503397743,PASS
509D97335F49B8B8231C6E032D1CE8D3C9DE7C4DE679740C041A2AD1C8CBE6BA,130,126,4,0.8025873486341526,PASS
A89C91617E4E7F3BBECBFA71D69F04AC5856EE976638EB22C24E1AD14789A89C,123,133,10,0.5319710580974012,PASS
F2E7BD55ACBEA44DA4F7C75CE48C7823BC1F3E533E3C6FCBFEE5F5043A78911A,113,143,30,0.060792723530522785,PASS
33C53ED8509F49F1DB45F99A50C64A53DD3392CF2F72BCC8E2FB59CE1E9AE793,117,139,22,0.16913144470267139,PASS
364E74EB9C132C300450AFC185F066572701C08156746806B85BA33824C60A6,150,106,44,0.005959526470109114,FAIL
ACBFBB54B4ECB51D052923EA82A1D00DDC9285B0BC6D7F27D52C10C8DAD8A31,133,123,10,0.5319710580974012,PASS
393833B113F55695F499D222D9C55695CC95F55A9E598244EC7B6604E81A1A95,131,125,6,0.7076604666545525,PASS
7DD385DE805563F8839682F28A5169C5C2821166627CA83A08A40070115FEA46,145,111,34,0.03358661289689768,PASS
573EBCC07A2D6CEDB52A5C3297F9383DF49D22FEF240BE4C15E0A77A2D5DE898,120,136,16,0.31731050786291404,PASS
2F6A4023A20EB9CDD0F2A9FED24E4B64A2F7A5FBC17A8546923B9734B8091430,132,124,8,0.6170750774519738,PASS
AB65B143D2710BDF85380AD5A1823196DDA26643F691E960D35BE7886C48C3CE,132,124,8,0.6170750774519738,PASS
8763C20BD30A3C0B3D4ADB6794F388A229E51C144EED03FB8D9776F477875F1B,124,132,8,0.6170750774519738,PASS
ED53AAA43B36FD0D1CA467B764E51C15499DC9AD24BB84BD0623A746543B5F82,127,129,2,0.9005235503397743,PASS
4413DA667A3E45ADF82ACB352E2DB0AC11BEC8A1108BF80A81BFCCB21C4D136,137,119,18,0.2605890342736178,PASS
D79EC1F7BEE529AE1EC4CFFC86E725917D61F199495B776870A8CA4B7BAF6AC6,113,143,30,0.060792723530522785,PASS
F8F646276365EEB1934F0DC46A24A48BF9FCEB4C7FD9EAC21FE6449DBC956AF,117,139,22,0.16913144470267139,PASS
527AC05A6B2BB00B3D18328161425EB5A78127AA6FF68E505FBA1488D8554A5E,136,120,16,0.31731050786291404,PASS
29868D2DFD0B4936F3715F1ED4D20ECCAB9E3CFC8361ADC49241B749E491F05F,125,131,6,0.7076604666545525,PASS
760E88429F6B329AAEA057A11C152AF1DD96B672E1BF222C8BD021F50EF637FE,126,130,4,0.8025873486341526,PASS
630ACCA8D9D71B202E2F2D9311DE67EE8FE47142B3F2D3A4F000CBDD45403181,134,122,12,0.4532547047537365,PASS
B37C161A3AF11E281EAE22183F6798F3354E0A84E630B63680DCFED54F4CDC1B,129,127,2,0.9005235503397743,PASS
353E33C20DDFA0A87B64669F5FCA86755928B3BA51322C2CD8773A924014AA2F,131,125,6,0.7076604666545525,PASS
4D69A54C7C612D3EFC0CB5F39F7556105AB6FBC6C22AAAC3EDFE52B1AEA42CD5,119,137,18,0.2605890342736178,PASS
A59E3739CC4A940AD088CF377009559A6629BA47C2066C273A3B2AA8F233051B,138,118,20,0.2112995473337106,PASS
2C9661CD4C10A0AA464E4200F964F407BE23A4DD6B7F191BEC57DCE86EBB50E,133,123,10,0.5319710580974012,PASS
BC59E64C76F4294687B8AF6340679F4821435BC2B2917DE6F09350BA8D479498,131,125,6,0.7076604666545525,PASS
2CD5573C54FF2F6330645D3AE6DD62C6CB9A86139C8E33B34979D7D78F1C90A5,121,135,14,0.38157390570502125,PASS
2E7BEB1C558A1E12CFA0579AB357477D6BED0C19A606B0CA75521318845B2B0E,131,125,6,0.7076604666545525,PASS
9CA179FB837BDFF9FEF8915F7B277E5F46E5BA69E5DF127F1D1CD2BF9B6634AE,99,157,58,0.0002889614517624719,FAIL
E078D8CC399CECC6EAF031933D6162EC33B2680C6FDBEB2F91F0944A0B945768,129,127,2,0.9005235503397743,PASS
ADBB644F72FAF4580A38A8B12F10DEDBF7509F1834157B45EAFE08F583D429C0,126,130,4,0.8025873486341526,PASS
D9681678558335382A50D398FB2E0ECCAF0778BAB17DD5FA4D96E92AEA907C0C,127,129,2,0.9005235503397743,PASS
C971CD6090E1C4224A73E74A06B017F64BDBE80A35FEC3307FD9987C08E564D0,133,123,10,0.5319710580974012,PASS
BC4E6E12F973C9C34AAEB74AE3D0F638D9E8517A1388C6A532D94E7AAF0FF159,121,135,14,0.38157390570502125,PASS
EA9A0F5415E5ED5DC9F36FEC5FA53E007F6025462816E8E8FFB53303F552DF17,118,138,20,0.2112995473337106,PASS
389AA610B536990A34EE422A320A14F6CE4BFD02A880425339A2C1C0790CB050,151,105,46,0.0040402749798920095,FAIL
8EB008C6F6133F8D36A4852620C324AF54B013A4401C6FA53402C04CFE5EB848,146,110,36,0.024448945310089426,PASS
96B60593DB6F8DFB2031951F957BD8F55BE548DDF379083AAC77FBA6AAB0C76,116,140,24,0.13361440253771617,PASS
F5C768D14DE4BCA8D7A20CEFD760D64F3DC0E0A817994955AA857BDD0DF88DDA,122,134,12,0.4532547047537365,PASS
DAFE1E6D83AE82CE445C5697BC2A7AD9C0BB01EDBF913DB2F5A81BDB5565A0D4,120,136,16,0.31731050786291404,PASS
4C6471B8233FACEDDA63191992490E3FCC8BE3BD8A25F580B2A510260A41B2E5,136,120,16,0.31731050786291404,PASS
75DB9ED66524ACE9C43284A7F9564E645071A552DC576F79D792E7DF8325D44C,121,135,14,0.38157390570502125,PASS
5EA461BB10EBEBBBD0E461CA236DC37CCC3827B0543BB123ED1FB0023CBEB9F5,124,132,8,0.6170750774519738,PASS
CE8D783568269E4C47C6434786D75452FC913A6EEE9ED6307B79D63CA0BA7312,125,131,6,0.7076604666545525,PASS
C09DE11B1F5B5E6091837907F6C8913E0700FD684838DFA383F1611CA4C37DE,134,122,12,0.4532547047537365,PASS
498D15481B389DCD3C85C6E566EE0BC6B44E24717705774998832A2E00AF3CF9,134,122,12,0.4532547047537365,PASS
74A33D9B18A5EAA5AAC9EAAC9D8232C621508EFA43C7908907A29F84FE4D20AE,134,122,12,0.4532547047537365,PASS
DFEFEB213237098B8DAB9B0F01166DF9F37AB82EF2ABCFB2E1A5520106C00AD2,126,130,4,0.8025873486341526,PASS
D0A4431D7CF9CDA44402AD6F7875433645C0DDCE8AF03ADE91EA9B84113F28A9,132,124,8,0.6170750774519738,PASS
8EEE7FDD17C4CCCFFA5DFDAC2E5970ED178D81967CE431AD5C681641FB31F2CC,115,141,26,0.10416255883043901,PASS
3035E545B1E1DE723AA8D0B9A62B4E385FBBB84C985C4408947E2815CB70A197,135,121,14,0.38157390570502125,PASS
191F4BAF4A6349B2E60CB2A17E339F4C208F044FC0E26134D4146A5F274055A1,139,117,22,0.16913144470267139,PASS
DA6C4CCB1B1DEC1C231F598BBC8652B8D6B9D82FC748AD760724CD544B2CB531,128,128,0,1.0,PASS
AF80BEA10AE7E04C70DFFF0F80C54079D022ABB4D0DF501040AFA984A34D7C82,138,118,20,0.2112995473337106,PASS
D6FDF8E882F5E24400B343FDCCDF15ADFC49C1EF6D538ED1B0F4D76C3BC82BDF,114,142,28,0.08011831372763423,PASS
87FD30F3B21C675082E48B0EE04D34F61B9012777F86746CE4D53937226AF176,128,128,0,1.0,PASS
728B39EF7B76FB8EB57C14EA3AFB428F0CA2DB6063EB7663912D1187EDA74402,121,135,14,0.38157390570502125,PASS
5A327D37AAC30FDDC5FC279341962D9E404A3675D20350AE8C842B9DC738E81E,131,125,6,0.7076604666545525,PASS
E13D03E65CC49CF505E5ED9614990E0F4F06BA45E4D59BD57B8D4A63C95038A0,131,125,6,0.7076604666545525,PASS
5DC3DB62B088480D6DD36096669E737ABB5C4534945DBF49ABCA2499FE5E74A8,125,131,6,0.7076604666545525,PASS
22052E5D346C07E5EECB8D8A61B8C6E61CD427009A0FD49441D1CB1564A7BCA4,138,118,20,0.2112995473337106,PASS
DB54169D9CBF31DBC93162F70363AA5793BC64007D5FCB10A9B746B65657CA64,123,133,10,0.5319710580974012,PASS
F70A3C11D143F19587437D64944466726E0B844E314B7BEAC90C40E49825023,144,112,32,0.04550026389635853,PASS
56CF8902DA18130C37AC040FDE19C497955963F096E973B96034C548C2C387A,140,116,24,0.13361440253771617,PASS
8522275BD5BDC482F538BC8F3D7BA270C52B48A18BED0FB522F02AD04945A2C4,134,122,12,0.4532547047537365,PASS
742620AC491D8F9F9DEF01A9C88397EF50ABE9B334BA24A2D1788BA8558BEA7E,127,129,2,0.9005235503397743,PASS
7AC5DCF8AF7FEAE41E5BBFF225E9319D7AEF6F8B9ADF7B819B8C38172AA50BCF,106,150,44,0.005959526470109114,FAIL
BFB2FDB7422A785E45FBCFB705351A3D877A9F42D78E1C5D4D415CCB0AD41903,121,135,14,0.38157390570502125,PASS
2DA699D8EAA8748ED7833F804B7BD377DE8876D85AB401A719F3ED45AB4E92B4,122,134,12,0.4532547047537365,PASS
,256,0,256,1.2777508801076536e-57,FAIL
ADD3BDD526E99223C5429F5EA7BB3C44988751B5B9A485261535109A7839F9B8,128,128,0,1.0,PASS
A495B91A0797424AC63BF04DBE7C1243D28B4209DB2A7970D09183FEB923E19F,132,124,8,0.6170750774519738,PASS
6AC13785D061EDC5777FE8B6FEFD004BC5D352C42E4209EF0B883C6C9A3C055,130,126,4,0.8025873486341526,PASS
2C134FA4A070942C90CB063EDEBD4585B9A3A1646724D30CA1AC3C5BB745C4BF,135,121,14,0.38157390570502125,PASS
87D276573A46FCD17101C6BE9F690DA74CCC199F188CED88859A477A9DCE659,127,129,2,0.9005235503397743,PASS
88D2F14D55F1F069097C809143AAD8A7BAABF268864666BA20686B371FD62743,133,123,10,0.5319710580974012,PASS
FFD18370D5EADE8410C7EF365EDD9C5D3C1F0DAF6CF0050D6F129ADAE6F1F91C,116,140,24,0.13361440253771617,PASS
479BE7E8CE6FD72B8ABC10A2D751F0F3BA11464ADD4086EE97C8C742A779D2F2,122,134,12,0.4532547047537365,PASS
AB4EAE1676FBA828B439BCC76BC387659127EFC3F01C9C0BB74B877A085337F3,120,136,16,0.31731050786291404,PASS
BF9368C4D7655250A2935AD8A7E48B8FAD2294E5B907C73A7A2D90C5B908C022,134,122,12,0.4532547047537365,PASS
69FA7DA69D25416D9346979B0CC91D83EC67F31CDD919CE3A01438A9AC651CE5,127,129,2,0.9005235503397743,PASS
68E4BF42A10B2DA379AA0E966A1EBF95E7FE264915E9C0A6C68552E7E2185F3D,125,131,6,0.7076604666545525,PASS
29C162B30F298723F384488F9033ED4E8888E4DEA575D9919DA3B9DB7EF22B92,128,128,0,1.0,PASS
5FB27DA13A31B65A9EB606965107D862D67FC74599D2B5B7E9592961978603C3,124,132,8,0.6170750774519738,PASS
5C2B1AA08D372ACA9C6E4624EE99DD8D99206C1C9DE5102FEC7916DD1A63C8D7,130,126,4,0.8025873486341526,PASS
9FA9024369CA0AC8F056B3780409519679BA55B8860D6DDD3AFB325763131A78,134,122,12,0.4532547047537365,PASS
16A4220B5F62493A586CF1517F1F576170A50C89BA87A1D27DB2EE3B9EF62C65,127,129,2,0.9005235503397743,PASS
9E38BD0D98D54AC12606FDE6BACABF3B46815A17F99B97AA1EEE7B00C1CAB8E2,123,133,10,0.5319710580974012,PASS
5C2E33AF3A7480E70A30902B577362ED9011CF57DD23B29900B54836347684E8,137,119,18,0.2605890342736178,PASS
5687E38D81B360B004709FFDD5AB9F4A2DDC8EE8A0A4B09591460AC4E7F1D90E,132,124,8,0.6170750774519738,PASS
4086C21B0AAC2BDBF20BB7031BB87B3B956D3C3E147B8C5E961246844FB0CAD9,132,124,8,0.6170750774519738,PASS
803C4C5DEAFF1D37DC781155F93575E25F72F0FB6A1843450212F06CD3C40247,130,126,4,0.8025873486341526,PASS
42B8512B253C47632337BC1C16A9AE9E3B6840D73B195611F0E9EC2174A57538,134,122,12,0.4532547047537365,PASS
992040F80D1DDA8F5E33B12C06DB7D68CB2B6A8FE542F87A07A531105BCAE6A2,132,124,8,0.6170750774519738,PASS
E6A58D99628023B7FA848F0B369E2078772509151F224CF014B5BA096A03EF5B,136,120,16,0.31731050786291404,PASS
2F6FCCD798D76325785A0EF30B7252D160D6E789950C9C02DF50A26AD320757D,128,128,0,1.0,PASS
F462AFAECB3C144F80EFB562798B975238732EF0C3F3AC630584B2C149983211,132,124,8,0.6170750774519738,PASS
FCB3438ABC0E39C19EBE6A4CF1A99C89984A6D9B9C8FC5D7D4B6A02AD378A8B,126,130,4,0.8025873486341526,PASS
AEF8D654E0A2C80D7F8EF6C320A96FE12CDF41075D78AE8F7EB57786ED79911,121,135,14,0.38157390570502125,PASS
7F12DA9CF5BF4925DE32CC3224BD1C4D1F066861DD67F162F63D465FE977D0E1,118,138,20,0.2112995473337106,PASS
44C599370B87D236F7B564BDD07A21F318A3FC770F8A3714073A9BFAA310F032,127,129,2,0.9005235503397743,PASS
94827C0A71CB4340B417F2AABC38B8903FDD43D2EF8F5E7028D3847E5AC08A54,134,122,12,0.4532547047537365,PASS
9A2776868278D84E594A2264EA9C8643BE32F3162A1C9E27983B7E499D9BC09F,131,125,6,0.7076604666545525,PASS
D24172B501CF4B669C09BB5FCAADD62DFF4CD4AE9E5FA73980016CDDF1C21571,123,133,10,0.5319710580974012,PASS
7BA57128D7876D81A971079A26AA42D645B4A601DE712D386FEA2355D48F88AC,132,124,8,0.6170750774519738,PASS
6B885DF493109669CDE6D6CD668234A72C121AC50E01F89E00DFC75A87D9B190,135,121,14,0.38157390570502125,PASS
98A2C7745AF2D32FC2173FC31C92462002CDECE3DDFAD1B4ACF20D5BDB8E94B3,124,132,8,0.6170750774519738,PASS
37FCD478B1ACE41D36B55A0BB84D907CFAB23FB5213657C345795D6267F2DBF,118,138,20,0.2112995473337106,PASS
DE10C9FC5672853A9F486CA1A08890907EBC4AE28578F7E9A2D45BCED6467930,132,124,8,0.6170750774519738,PASS
1AA0EBE3A095B912D353139F193236DF14E7D8FEA8DF7F39C991AD253EDE441C,121,135,14,0.38157390570502125,PASS
858BAD1888A0209DD8A6F930DD1C2622E4ED10895166D426C6E7CF13A99DED1D,136,120,16,0.31731050786291404,PASS
E41EDE3DF98D26E60704C86E5EB6A91B07D581F0E3300E8D5437200AAD061534,137,119,18,0.2605890342736178,PASS
D544A1E070DD75C4727444A78B8B130A07EACF9C3386C4120C94B44F139BDE23,137,119,18,0.2605890342736178,PASS
F647F78F0210C658D4187A7AE20A8FC10C7652FB64233CE9A80533BFC17E282D,132,124,8,0.6170750774519738,PASS
289FE0E404DCAC9FA79970409323D09FF624D9A2475263DDC0ADE96DD2CDD1F4,128,128,0,1.0,PASS
D6CE3E5D1B62498687CD3F117DF9808315C7D2D20BA00D418E899CCB5ED78AC7,129,127,2,0.9005235503397743,PASS
770E3A5B609FA53ED87E4F2D4B0C8E916E2735E50E82873B1EC641DA4EB6C481,128,128,0,1.0,PASS
89F5FA8DDDBF06BCAF5237F2F64E9B5AC1E6D7321A0535C45E0C14D275A39B66,119,137,18,0.2605890342736178,PASS
22C7720D5507906A426CB2E482F7260CE5B321A56A97EB19529A7196B10D7114,139,117,22,0.16913144470267139,PASS
8522F5E196C2FE11C524435BE3EF67F5E037096D3A0ABCED35C9F63EBC1F7128,121,135,14,0.38157390570502125,PASS
51030EB55BDC0BEBD20AE4D220E7C746503AECD369A025D4CB398D436AF8C020,138,118,20,0.2112995473337106,PASS
EC5B6AABDC657BE88429D5469DD96B99EAFD9EAD883C38CA98CFD28F50217D26,120,136,16,0.31731050786291404,PASS
FE17E1F6BD2022D84765FBD93EC60EC5BC54C9A7B77DFB67CCD848B383D3C74C,114,142,28,0.08011831372763423,PASS
BC7EBEADC9B2C88DA0E9470E20B88E2539B1B354B2A93F4BBF1332BA5BC99918,126,130,4,0.8025873486341526,PASS
BD53859C9830965A603B10AC068CCB81356F19C6D5823FC15AAE426E4CFDD237,134,122,12,0.4532547047537365,PASS
D83D231901FE0D01A08C9735BA3C3CDFFA445E5F5486624D2A89963634806CFA,135,121,14,0.38157390570502125,PASS
238CA219F3FAB183AC57451473BB8DFDC85378239C06B3FE431AAD5432497E0C,129,127,2,0.9005235503397743,PASS
6A280719051A0EF567CE69551E6ABACD3FB4DBD2BC15BCCECEF081C584DA7669,125,131,6,0.7076604666545525,PASS
428EC700AC33D85D8EFF62054D14328CE94A970F45AD181AC8D1F357579307D0,136,120,16,0.31731050786291404,PASS
DB9DCAA426167ED8292CB4F63D2AFCFD2E206DF2FFF6CB19238BDD74BD527BB1,112,144,32,0.04550026389635853,PASS
47A84DD10DE889F34428EC96BBE02578640096CD4915219B60355D43E2EC16B8,141,115,26,0.10416255883043901,PASS
9FD1CCE4663A00DEB29EDAB2CA0F5C943603321123554A30087EF41EE6F1A9DD,132,124,8,0.6170750774519738,PASS
39A5E14AF3FA60A7642677F63F5E5587BCA556D4EF4F0D1E598476FD380991F8,118,138,20,0.2112995473337106,PASS
64915CD62ADBC98BC813EEB34684DB2ADBAAA6BB4383159ABFF565D53A9F7DA5,118,138,20,0.2112995473337106,PASS
33C4A151D54E66BF7D601F63E51FD88B2775A5D573DCF88DACBEB9F14FBFE90F,110,146,36,0.024448945310089426,PASS
430E3C718487AD92E26B39BEB9DFC9CA07B11A0D4DCD20A8D8303342ABE78525,134,122,12,0.4532547047537365,PASS
FEB0B5FF0E5C3147BB0853792FC02C1641884861FDF51A1AB025D0590EB21FDA,132,124,8,0.6170750774519738,PASS
FA0025F2C5F6D3DF959DE984FD4919FFEE6E497111CF8DB691D19989D3BBA6ED,113,143,30,0.060792723530522785,PASS
9D07F900C746DF8955A609C7EFD93EEB43764A039F86241D012A572848311599,135,121,14,0.38157390570502125,PASS
4BD79E560A126B808123290F36AB64D639AE1708D0D5FB96AF232D95DF59C65D,128,128,0,1.0,PASS
4202ADC06843B3039D07FB60079ECFF0A1A0649A5DFC45C43EA7D0F773798FB2,130,126,4,0.8025873486341526,PASS
14F4631780F5F7CE8BF4BE753E594C01987AB2A2652FAAC958576BB58F79588,125,131,6,0.7076604666545525,PASS
F45A42AF8C9DEACE3FE0B03DA596C45DECCE7195CAAD40B7DD08FED06845450D,125,131,6,0.7076604666545525,PASS
FFD126863A3908BF02D4521378FE8BE0E43BFA10EDECAD8B55E5DE1EF4E8BB18,121,135,14,0.38157390570502125,PASS
DC287818360AC8D90036F2419AFA7B6430EEEC2E7B769C8543FBBBEEE4816269,129,127,2,0.9005235503397743,PASS
20F331DD23EA51647FC350368BB6F8960767B6AA7C305A128D927BDECEBFA4B4,123,133,10,0.5319710580974012,PASS
3B8C6F29FFEE9B4424DAF2D1FB9029A121DD5A3B901161D0E6810135489EC56C,133,123,10,0.5319710580974012,PASS
751A1127C473513726C7EFB5AAABEA52907C9D6AABF8EBCD043882878B3538FC,125,131,6,0.7076604666545525,PASS
9ED10C04FE9CCF5B35F76EC282F9F08BCC93D670A99FB25203AAC5F617620596,125,131,6,0.7076604666545525,PASS
9104E705F93E9AFD3872EE138C8763DEDC0A272D8513F14A9A39E75B34802B7F,126,130,4,0.8025873486341526,PASS
6EB6AAE4CB3B4C80418D6ED7E57F9A965C16D81A176B44A21D7B3D3FB247963F,120,136,16,0.31731050786291404,PASS
F599BE46F2AB55DA198B2686E4B5F9470A386EB81B90111F16426FBCDBDDB14,126,130,4,0.8025873486341526,PASS
82376B533D07A1DC8DC8D05B41ACE11FB0DD34F03CE1CCBD1255B2061B041CCB,135,121,14,0.38157390570502125,PASS
8518951F0A15C065E37D791A7C0FEEC855E00AC22D5C1FC24DF66DEF0A1B3815,132,124,8,0.6170750774519738,PASS
E42205EB2808D8DDEDBA9E7B414251A31AF15F13671085F1D8D9B54BA2A6CFC9,130,126,4,0.8025873486341526,PASS
137E7E0528F97271AA84CF7DD4444A978225D2ACDE736272528FF04A7045463F,130,126,4,0.8025873486341526,PASS
CC706D446F5667900C909A82F7F9C2DF7B2C80897409AD734FA3A30580B726A2,135,121,14,0.38157390570502125,PASS
6E47B4DF35DB11BF5182462FE290DAB1614690D6ACDBBEAB41A0E912365EFE8,127,129,2,0.9005235503397743,PASS
929F995900EE7624604509506C28C95D9B23B3C9999F2DBD7AD363AE15217C75,131,125,6,0.7076604666545525,PASS
FD0003B8F08D953E94C3A2356582D029D6CA707E03FBF3EF7B5FB30EF7F4723B,119,137,18,0.2605890342736178,PASS
EA78898D0B902A02A095EA1E12149D4898C35F951A2DBDD520C4A5E8B9DACA1D,140,116,24,0.13361440253771617,PASS
99D2814997D5C4E5EA2C3A430293C620B1FDCDD10AF5315E9D9D7EC46C5A713D,128,128,0,1.0,PASS
104E74C8713DC96D57093E075F75D0856F41EC8E432796FC36B292380DF96B55,128,128,0,1.0,PASS
7E8532B247856E8DC2A8C83678C20308F0409331E4D66DA729782B22BC788804,145,111,34,0.03358661289689768,PASS
80F40F24ACA1D8DD8CBFC2831206ABD7C382AD0816B158CD429953B6F4F4561C,137,119,18,0.2605890342736178,PASS
6CC2E4A248785A66C80F714A82F7DD3F43D43049DBE86241EF1F3FF323AF9312,127,129,2,0.9005235503397743,PASS
4FD4705CA9722B11D5832A6FB16B84C9D83711496C876A4A1BD2E646143E3E8E,133,123,10,0.5319710580974012,PASS
35D7D676E871A90427CCB72C65186243352D50E83FE070C9063C4364B8B838B0,138,118,20,0.2112995473337106,PASS
4CBF86796C7DDA1D89711639F43B058EC5899CD9E45104CCB046B09A5A9B5FD2,129,127,2,0.9005235503397743,PASS
E0B41E92567FCDFFD735A7F8FCEFE332DD804EF2928D204477F6C7DDC72BC9A8,112,144,32,0.04550026389635853,PASS
5EFE5B402676194D96777F077013EE971A1A7C1F89AA0876F3AD1876379F765C,119,137,18,0.2605890342736178,PASS
4A249D4DC869A6AE1617C861B6C050A5FC172F2BC6D96208946FC114FF0ABAE4,135,121,14,0.38157390570502125,PASS
1BD8342D8A0E31B75E95231F7726F16F3AFEC5AC2FE0048B870A273B6DFB245D,123,133,10,0.5319710580974012,PASS
B8DD387C0492D9B6634280CBC7B2E8C5C91FEAC24696A624C8C279346AB9A73A,133,123,10,0.5319710580974012,PASS
A20136E73A4E53F18C5F1886F4987E52088BDDB78100F16CE6C3351277271A25,135,121,14,0.38157390570502125,PASS
AC9848CFA013494840CCDBF9611040D3888FEDA8907AADE80ECDB6A2250FBBA4,140,116,24,0.13361440253771617,PASS
44602E198F2D90EF90AB66EAF1A9BE168E3DF88AFA4EB5944ABFF93B3A822089,127,129,2,0.9005235503397743,PASS
30735BCD83477D7D844FCA07960D43DC155F4D8FC98E43550D552F0C3E4CEE1C,127,129,2,0.9005235503397743,PASS
583DF6B5AF1C7BC250C0BA3729DB3E2BF57241031E21089E8DB38B83357921,134,122,12,0.4532547047537365,PASS
C70F1F401181B43591ABA03C3C74AC392EF0F2F81DCD39780F05E19A3663A88C,136,120,16,0.31731050786291404,PASS
42087F588CBD1FAECC0C0D627B5F6DD5506A0A813633288C7D3C7D1884F43D24,135,121,14,0.38157390570502125,PASS
B191088228CAB5D5BCAF220A4299AA97261B2C73CD9026A9F2B63CEB6DE71790,134,122,12,0.4532547047537365,PASS
50CEFD4A05E275B9E48D1DC38E4932DD7DE75107B8CBD78A5EC15803A322DB41,128,128,0,1.0,PASS
7BE1A785CAAED6595B0E13FD06B6E0661AE24B58CA8BC143704F49881D11DF95,130,126,4,0.8025873486341526,PASS
181794545941E0031C4F55106107593C44B50BD8DC763E36354AE2CFC9B09247,142,114,28,0.08011831372763423,PASS
9D4ED2F4FF465D2288DA6424C8094C449BFF0F3A14C54B532A50E66C25217CF5,133,123,10,0.5319710580974012,PASS
75AE67CF9407140ECB68B9BB03ACC01E98E655B11996D963C1099AC4A55A81B5,134,122,12,0.4532547047537365,PASS
4C7089B3AE4653F7374E4BB1006EB9E7DE0868110C019D3FB7D7C5DA78569531,128,128,0,1.0,PASS
EB9526678591D5D611F010190373F6C1F757E4704B297C423628C4BE4C39880A,137,119,18,0.2605890342736178,PASS
F3750FF49E2D400C3E4EA6BE077342C4898E07FA673B6AD7235B573FCB29E188,123,133,10,0.5319710580974012,PASS
4EDDDFCD0A7F3EA8300179CC1621493D4FA35C2381A690CAD0D63047E0AF6298,135,121,14,0.38157390570502125,PASS
DB97A66F51CDAEE808BD9CC27FEBD40027CE6306763F01104E8D9B298A86640E,131,125,6,0.7076604666545525,PASS
88D4A0F810BDFEA49814278FA79FC1303A254DC0469051CCDEC39F6354D240BC,138,118,20,0.2112995473337106,PASS
1CC09C5161A44D4B3D7E5809341AB71C2B98AB2A84DABA9A8C1923E6A5502385,142,114,28,0.08011831372763423,PASS
1073FADA57EB44C42E5C9261FEC06D9F74BB1ABE0FFA72D77F5C92DDBB4DADA6,111,145,34,0.03358661289689768,PASS
2D580DF207F1C3BB3FE87B7CAD2642752BEB52C698B6204F71A7BA9BEFB6FAC4,116,140,24,0.13361440253771617,PASS
6EDBD7CE169DF5C54687361EDAEE81AC35445227B4407B1FB1928087E64B56F7,123,133,10,0.5319710580974012,PASS
74E34B0B5E94A5C40EAAB867F24D64D12204CE1EFA26BD85639603F738F5E25E,128,128,0,1.0,PASS
AF4BD7A111D0FD8C0056F6F71B9FFB792404432F227B3E853F9266B82E7A1966,123,133,10,0.5319710580974012,PASS
A2E7D29B0A83BE7461CFCED33A0079DE078002492FE1340C06601C8F0722731,144,112,32,0.04550026389635853,PASS
D0CABADAE9D85BFC2396BE76B55AEBEB532784D8D8AFCE18C8C96F7FC9928FFF,109,147,38,0.01754895019147673,PASS
C9EF9DC3A2B1722FF40622D610176CFDEF8ECC26060D896A2672AB28422FE014,134,122,12,0.4532547047537365,PASS
282BDDE7A0239A4A245F65EC6724D58BC1747A32BE8B78DC938F2E86921DB038,130,126,4,0.8025873486341526,PASS
B1B9AE394CBE779FA5AA83C4EEBD38156C86202BF61A79F1E6C731A40FE5EB0,123,133,10,0.5319710580974012,PASS
C2A3E1685DC275BB9FC7B437B10A30C3124775E74C4DE45DA260924963C18F1E,131,125,6,0.7076604666545525,PASS
5F19455F018C41D44C80286B54926ED7511D8107F33AD851ABCDBBFCAC4C1A21,137,119,18,0.2605890342736178,PASS
38BCD277D61C75611536524C8440FD40AD6FE52398CB95C109A2B97FAEBCEDAC,127,129,2,0.9005235503397743,PASS
BE977FF749F409B454DF7839F24030D3C7182515654A29CDB6911316C4A12F12,131,125,6,0.7076604666545525,PASS
1712B61FF83D37CF1B179ABBD51DCB7303772D79C12AE47A0089F00893737281,127,129,2,0.9005235503397743,PASS
5A91EC816D020AFA5F1BCA8EA706F7A0CEA9FAD59CC04FC5B326389F0B75D4A,128,128,0,1.0,PASS
5AFF13E68ED5A47DCC04E06D7A20BD2CF1F977BE4FB7316D75F5927DA36A48DF,111,145,34,0.03358661289689768,PASS
DCC64F444F66E9677451A5006B6375BC9EF3ADB22D9A9C0799B48B168BDFE833,122,134,12,0.4532547047537365,PASS
B0B5543358DD754AB70A61FD310A295459299E416F5BBD4C4D07A3CB483AEC2E,130,126,4,0.8025873486341526,PASS
3944F519AC9CF27B9D01AE992D59384A4006CBB53561B3D65EF90005D8C87DBD,131,125,6,0.7076604666545525,PASS
16DF64AAB993685B70EA48DA429B6A08CAF7B2DD1652B3B8C8FD077675999264,126,130,4,0.8025873486341526,PASS
5A60DA93E263FBFC686E4284CB2DE1E5C80BB453FCF0DC9003836E454B4B25D1,131,125,6,0.7076604666545525,PASS
5B8D0215FEB1F598477B52FF8635CB58C20CFC274AAF1D3BD9917E2EA27D8D90,121,135,14,0.38157390570502125,PASS
3EB0B5E896E4A8072766F586285BC3826B944CD77A43B08AEC17CE09B59A7953,130,126,4,0.8025873486341526,PASS
40999548A5511AC525DCA5596B114C54C3002E1C8294D6ED5AA63479121E5319,146,110,36,0.024448945310089426,PASS
8F4C3FBE963AE839BDB7C88525E271AB5D4F0C12169AAB845E20191F816885D,133,123,10,0.5319710580974012,PASS
266083D180D6E035B42333164916CCFABDD62CB993148D41A366E45389A6FFE8,135,121,14,0.38157390570502125,PASS
6C06934BD95D742DDF00611A8678672E2FAB5C1FA03BFB48A8EE313DBBE22D80,128,128,0,1.0,PASS
14025233B3DA3A0D1AAC911717EE1B73CF20BFEA850F19517FA0CE3587EA3E1B,128,128,0,1.0,PASS
6722F9B84C2F2D5E10466668CACA57B35705D638FCCB5087FE8BBA9EB43880E3,127,129,2,0.9005235503397743,PASS
9604851EBB948FDE9197840C8EDCFCBA19DD779CE49E98242C6763010B189BCD,131,125,6,0.7076604666545525,PASS
989F7A8C2C903AF30F5EDEF2DCBD5D07BD63C5EB3BE25E20440ACEA16D9AC285,123,133,10,0.5319710580974012,PASS
D6E3C38694377A98E381DEE951F181D36EF0EA1103B5E9B7C98A78908D4D3042,131,125,6,0.7076604666545525,PASS
E438C68160062408A0474899F80B7BFE9D3552499BDDD3E5EB3B93059EE47F2B,130,126,4,0.8025873486341526,PASS
215F7FB246D838C1E200E804C4371804005CA57E4B87F090D7A3AA64FBC56C7C,139,117,22,0.16913144470267139,PASS
7D9A6D112CAE5F600B524EB6B709ED67A7ECFDDE46482DBC3647977A2C325EAC,119,137,18,0.2605890342736178,PASS
8AD33FCBFEC3318283F6F940524E94AAE34291A18D9579C69A0F050558749A66,134,122,12,0.4532547047537365,PASS
D865E58E14A00C1C4E4745D27FD7D9AB9C140D7DB417DF3F01739D43B8144045,132,124,8,0.6170750774519738,PASS
3120A6DBB1536D53FA1E9FACEDD5DCA5B03AED49663A8296D990EE2875DD7D11,121,135,14,0.38157390570502125,PASS
70696A3E0E1A8E72A3E35839D98F364C930008AC0077509EF8C0F6CF3D2095CB,137,119,18,0.2605890342736178,PASS
C29ACB40F24EEF21C4E4196ECA0C136C8C5D607AEF45813F5493AC275AFCC442,134,122,12,0.4532547047537365,PASS
BE82E3EE44EF976D221E928CF0D1FFA2C75A2E0DCAD9C7B8A7D92BD798623516,120,136,16,0.31731050786291404,PASS
3F08138BED397D319B80C53583E598E8CEA00EEAB4A6F129D49ADF9A0F921346,131,125,6,0.7076604666545525,PASS
EFE39D53971D537F9D34BF600DA4979C89456776486A0ED98EFBB7467C077A2,119,137,18,0.2605890342736178,PASS
7632AFAEB2FCB759F9C5AF0F627E26B1AFCE29CAF250CFEC270627CDD09D3B20,116,140,24,0.13361440253771617,PASS
C685BCEBCD23F9B557E43827F75258FEF9965F089E344ABD82B3B93D19069F28,119,137,18,0.2605890342736178,PASS
E2994E20D6AA7868BBA05669F56A026FF57B593C1DFCCD967790F0AD1DE011AC,125,131,6,0.7076604666545525,PASS
5AAB257BB1F67D1401CD10D25F7CD0484AB3313AFEAA98A59B467FF3E07B0F45,123,133,10,0.5319710580974012,PASS
FFA66072E47CC1BB6A7C708271152264E55FBD569B7A90220998FBD2D1F495B4,126,130,4,0.8025873486341526,PASS
BFC67AE91174EF9B8839454215CF7E365050A102E9869DFF88E565A8DC7A6BBB,123,133,10,0.5319710580974012,PASS
620249C77D99CA7BB18C0D3631C945204EF138696BD4130BD9B95D535B1EB7D5,129,127,2,0.9005235503397743,PASS
C11E5E8B193C4921CAAD6F44CDD2BCC57AF0DB5C8D134045E2DB5DBB923DE4E1,126,130,4,0.8025873486341526,PASS
16E32F5910F5855B6A4C7055C53CF6550D37654410E39554D50195BB9D048F10,137,119,18,0.2605890342736178,PASS
E0F17EEC7028BDF3406E4224C1ECB7E8213525A62F654AD485AC17EDB67E996C,127,129,2,0.9005235503397743,PASS
5DAB87D1053A6269D4B451FEF35B7B37287BB9990F8D8DEA645A42F1EE5F09DF,116,140,24,0.13361440253771617,PASS
9B943D41E1B490A7D8859C00C684990BAF3BA6A9D5AC0D937FD4618893BA3358,135,121,14,0.38157390570502125,PASS
C7392D6E8358B07C4AFD9B132DFBAD0D298517072BCB6B37FEC6D8FA918D1687,120,136,16,0.31731050786291404,PASS
80A1A840F6C85B5315FB742EEDD60227A086B46847F460F596E929A75358084E,138,118,20,0.2112995473337106,PASS
C354BB155566050AB9065965F409414EA15EC8446D3D0B81F106C4AC5A2184B9,145,111,34,0.03358661289689768,PASS
F1707B7A353F89F1B842D09C6618DFAAA25A8BDEC8EC67F3EBC5261480D3E073,124,132,8,0.6170750774519738,PASS
A0DA824D1D0540C9378D7B3BD1918113F6F0B0DD77D792AA8E280728CB725BFC,131,125,6,0.7076604666545525,PASS
3A4812B45D22447CC73F3B26977D2C632ACD80462FCB8B6ADBF6E50134439C87,131,125,6,0.7076604666545525,PASS
D892F6AFE2B03C3BA9699DE932F88DB926D7D994923080C20082B1A2CBC23856,136,120,16,0.31731050786291404,PASS
CC40A8F852771E74517B9391420EE14A1CB2B0350B1994D334EEFC1FD01764CF,134,122,12,0.4532547047537365,PASS
93859B702316A50ACFE72B282E3DD64D541BFE60CBB2DFB593915C8B50CC40A9,130,126,4,0.8025873486341526,PASS
9E7ACC930752D092B3190528C5F3BFDE46262DA8440C72D7228928A75493C8F1,137,119,18,0.2605890342736178,PASS
6080B2903EF36F167C3018B3C8E1A2C8F9844006365A8DD5AB26EC244CF0ECA,143,113,30,0.060792723530522785,PASS
1FACA6A72AAF00B9B3E05443925947B3B9C8EA0D8B920B19FC1CAD5F1AD15447,131,125,6,0.7076604666545525,PASS
C2BA19D33119E0A0DEE422FD09B4A3C5FF6241EFA3EC60F34C59CFE4C2599921,129,127,2,0.9005235503397743,PASS
AD2FDE6C6CF10C3EEB642DD3BF6B12EB1F9EF6B1B8DCEC14B9A01FE74EFFDDBD,104,152,48,0.0026997960632601987,FAIL
9BEB53124721EA5EFEC02555B63CA5756CFD71231BF84FB3767BAA6819B3251D,119,137,18,0.2605890342736178,PASS
17097F576EB56E5D068AA1741953E0A0062C19E4AEDA20C0299958165809B7D5,140,116,24,0.13361440253771617,PASS
6B1AF47BEB9E71E73A29A711A53B00EE327EFFF21593420F63A0FD819528990D,124,132,8,0.6170750774519738,PASS
D8482FD8406925CFC8FC3BF207496F059412C29CCCEE0ACFE849EAB9FDA5E384,129,127,2,0.9005235503397743,PASS
D7A6D40C80E9225C01EA4A82E5C31E885CEED227B6E96EA8432F43E6E3B9280B,135,121,14,0.38157390570502125,PASS
8BD0695EF0BE9760BF1CD46B4CCA3FE9836446B08C9A26B2F36A6C6E223F44A7,126,130,4,0.8025873486341526,PASS
9CDE2246BEA85297EAB033DD35DCF797697C2CD0320C78FE9CB4D68513FEB9BA,118,138,20,0.2112995473337106,PASS
BF3BC3BF0186AE1D520450C97AC82DA595A6500031E7B47F58E5FFECD280EF69,127,129,2,0.9005235503397743,PASS
C49FF667BE2C4FCE58B78BC952731C704CC829B921D5AC8B2F87F62F3C8BF1B6,119,137,18,0.2605890342736178,PASS
36E3EBFDCE1DCBC273173EF50344E7012CA34F9DB8519982F29B4807303A8128,131,125,6,0.7076604666545525,PASS
9CD311029679FCDDB23070DD7A6DFBBFF863A430246F94BBA578D101B98075EB,123,133,10,0.5319710580974012,PASS
FE596DEA712457D83E70B599A20F9BDC77938090411AC775F2ACA4DE516FB9FF,118,138,20,0.2112995473337106,PASS
DA1D5550AB60494EB17498D2434FB72CC1F5E4278667CEE0FA8FBEA25C21C292,130,126,4,0.8025873486341526,PASS
3D98ECE2F711A5C50D8E1F6C582F2C49B65446F9E3D97827F934BA7070A4140D,129,127,2,0.9005235503397743,PASS
9A3C872808A24D4A5D2772B29C2D4B280D421F7960FDF2A9CD4108E306D175C5,139,117,22,0.16913144470267139,PASS
D694E85ED4EE794819C0CFAAEF7C3787282BF34A34AC614B2229C9EDD637EB1F,121,135,14,0.38157390570502125,PASS
C031F4FB4E6AD166A6F229B8CC6A65989725D7913EA8481FD8E99F7F2533F975,120,136,16,0.31731050786291404,PASS
10C5C4C6D773332E8E86264268FE5C1382D9B5F138C94FBDB09593C555037322,133,123,10,0.5319710580974012,PASS
4173E73347A3C46DBC023309727A0A2FE33AEF3F0C1147F87AA37BF08D5BCC07,125,131,6,0.7076604666545525,PASS
F65FAA0270380BEA28617A4FA771752764B993F49E24AB1657391CDB9F09066B,127,129,2,0.9005235503397743,PASS
CB04EE89CA87FD23839F6C403B1C2A8A95363816F90407B5FFFCBEC801FA0110,134,122,12,0.4532547047537365,PASS
150329DA4BD4C3FD56D13E6131F16DE0E3B9802907A84EF1B433F93C13038D3F,130,126,4,0.8025873486341526,PASS
3DB22A8F88C71E3A3183F28EF231A77B43649F10E519FF7750A9570F13C8EB91,125,131,6,0.7076604666545525,PASS
54D60CFAB20B958065B328581B8592B46AA95D9C49F4AD8B1D7740AFECCFB514,131,125,6,0.7076604666545525,PASS
CC21F680E2CAE8AB712D78F0317A8F2DA14DAF79D1DC07B4752A5238593B03DB,128,128,0,1.0,PASS
CF777B26DDC550ED95B6E205FAEFB0072D2B33297DEDC4A72D5CCF4249EB8CC4,117,139,22,0.16913144470267139,PASS
E588839E287FFFDB206A723E534D710DEF674C787AB8DA21F162CC0B6CD23DF6,120,136,16,0.31731050786291404,PASS
B9D790DE6296A2E68389F3941C22DF95030A5F035246B390DD66E2917038E60,138,118,20,0.2112995473337106,PASS
A00B007326C948CF37C885EFEDC03A69AA9938CB790CE315B730DC03DB75C5F9,130,126,4,0.8025873486341526,PASS
35CC0784E6CA767D88B9F7D5D058ACEBA84117DF1570A41C6A1285F618692601,135,121,14,0.38157390570502125,PASS
32FB86A26252E0D295E310B7AEEC971466562F79F0B1DBE3189D051799AB1310,131,125,6,0.7076604666545525,PASS
43BF1A946FEB40EC1E75E5597409820B4E4FD84C25A681EBD18B35BF5E008534,132,124,8,0.6170750774519738,PASS
79634B7A63DC7DAC68F5BCF753E913F7C4D82BD3FA0A9ABA540026F1EC9981E8,120,136,16,0.31731050786291404,PASS
1E54BDECE1F4E0E693002E1A5D3B687D22E1292CC92E370364BC8753A7B64446,133,123,10,0.5319710580974012,PASS
DBA850F9A4C315D3923EC752D7DD9796D291AAD60FCEF1900851763C9D9B8722,126,130,4,0.8025873486341526,PASS
19329DAFDA1A4DA9405E1DD309F8665218017EBAF91B3F5FB62ED57AD9DEAE86,120,136,16,0.31731050786291404,PASS
C57CD656D5F8A8A9501BE894132D11C53099B12ADD9AAA4F8C96E8C0E6372241,136,120,16,0.31731050786291404,PASS
94CD21735A692473E59D6F358D66F4DB42C563DCAD2FBAC3729EABE652ECB07A,118,138,20,0.2112995473337106,PASS
2F5653915079AAA2D2A602DBCA7F19DFB9E43363C778E021BC8D473DFEAE16F2,121,135,14,0.38157390570502125,PASS
EF51D2CA5975BFAA310387CFB4DA4BED02FA1418EEDEDEBCD37959EF8418070C,120,136,16,0.31731050786291404,PASS
ACE8BBC75378FFCF667BA6DD770314B02FAB98FB903ADE815353D599EF4DE179,111,145,34,0.03358661289689768,PASS
7C22D37317C703697037D5E2F4725927C1A4DC67E205EE021556C1AFD93960EE,128,128,0,1.0,PASS
C9ECE4F4CA89362A43A353872AFBD3FB7090E84BF201A2C6BD8C36A3BD8DA4AA,127,129,2,0.9005235503397743,PASS
E99121DDB5A3E9E8B89F3017A95205DC277C6FD44CE10DB1518017D59E5B4053,131,125,6,0.7076604666545525,PASS
1475F037F1E496EDEF5BE75609043911C983DF66336CA51F5181DE435DEF339F,119,137,18,0.2605890342736178,PASS
58B21AC243DE074FD6E45BB429DB2700C9F3F55F39225DE381C976FF38E69BEC,120,136,16,0.31731050786291404,PASS
6EFF65D5E8754A97B99848991B915505A24EEC6C64639F1FD6ED76219D6090FF,121,135,14,0.38157390570502125,PASS
798DEB8110875395A53208BE1B83BF8414FEEBD67B3255059DBF262A434D5905,130,126,4,0.8025873486341526,PASS
6CD50CAAC51AE5DEA32414EEE2A351DBC83F63F31D3F15F55FF1DD6E5BAEFE8E,111,145,34,0.03358661289689768,PASS
789F0BD7E97377E30C685F6921B3A402E7CE6D3F31D8994981B61E44D8B15417,126,130,4,0.8025873486341526,PASS
1F66760BA33358F723303F19B0C7FD8528B83E5B99B7EC7F07C0B5C774C8913A,122,134,12,0.4532547047537365,PASS
FF698F5DCF4F1AE1840093972EB081BB9EE84E12621B88F6E72B545293FB5A32,126,130,4,0.8025873486341526,PASS
BB59B7244FB9A3F0BE6059ACDE1B42EDDA17DE46162592C592D7CEA835C1DB7,122,134,12,0.4532547047537365,PASS
3C5E07E4D3087CFF01087237116879B9FE6B0116695F909465F5A08BBBCB7998,129,127,2,0.9005235503397743,PASS
FE0BF0C08832AA1EE339F97D7B94ACCE412BDBCD5BFB246021AD8A4EB6B40CF1,125,131,6,0.7076604666545525,PASS
4B2F9479EEB8F28986D3E3BFD1FF5A978BA4E788CCA5E93C341A461E0B868A8F,121,135,14,0.38157390570502125,PASS
8B80DB36DD2AB280494730305A9A0B6B6518AF7148D3DCD84528AD6316E2949E,139,117,22,0.16913144470267139,PASS
19D67F664E9CD3EEAE74DD0654DE2BED777F1B9077BD0AFE72452489EB1D79E1,111,145,34,0.03358661289689768,PASS
2245956DBA266C7DDF3F2684DFBD1E12A52713D417C9E1E65F613DADD841F5F6,118,138,20,0.2112995473337106,PASS
B291FAD8FFD5F75DC0C6D1048CA70F217947C8BE6648405A678D6F8EFB566B50,123,133,10,0.5319710580974012,PASS
2B53D4886AC5D160119CF6A9F9942782C0967FDFB98C1E8BDA49BE0FF8F3F1F5,121,135,14,0.38157390570502125,PASS
10177D1F3123495CDA3800BE2652556250B7E5529DC9A97D22BBD70233ECA411,136,120,16,0.31731050786291404,PASS
21CA67FAE082AAFBB8461BF06416D55E10DFD3A5E246BC0B83711AF387B99931,128,128,0,1.0,PASS
A04C8899CA3720233287AD7AFC70F9DD19899DE1AD9AD1598FB1443A47D02DD4,132,124,8,0.6170750774519738,PASS
6AEB9732E5458A9A2503A8D8C84A10F15EB03FE766988B7B5794699CB241E866,132,124,8,0.6170750774519738,PASS
F2CED15B8AFF46FBEFF59EA8D6A0B1758C5DF473A491BEF2F848FF149124D9D3,112,144,32,0.04550026389635853,PASS
B6FE984E89203ECF9AFA5E76591323F42A8B31CE68AE5EFAB2A9C402654E9357,124,132,8,0.6170750774519738,PASS
38700F51F937AB9ECEB9264018ADD54718738E9496F34506C9E683ABFA84DD12,130,126,4,0.8025873486341526,PASS
DEED5C59A39F9B6AC941F23F17CCBBB04983E953E5C2A0A9300F4116DC7ABE19,124,132,8,0.6170750774519738,PASS
2F904069CFBA9243A9F118BDFF3CE66F8496E838A4106EB5B45811151E8497C6,133,123,10,0.5319710580974012,PASS
172AB6A556249DAF9931F9B98523AE141F43EF8ABC8CDF01F61561A940811F20,133,123,10,0.5319710580974012,PASS
BC63EB49CBE3FCBC81E716892DE906F6F28D6FD9A924EFDEF1CC193975F7DBCD,108,148,40,0.0124193306515523,PASS
85E03C105E5461849138E20403649E6ED2793029A69C81703D07CBEDB2B3AB5E,141,115,26,0.10416255883043901,PASS
255EC609A165E4C804C8555F953D6384C002A9A4DDBC4D650D9659E43C69A32F,138,118,20,0.2112995473337106,PASS
3D0A92507FB28544A9881AEE06A461DF7D9125640D3253812D3A170DF8D49C50,141,115,26,0.10416255883043901,PASS
B1F83BD89C3492FE5B89C84CBBF43ECE8F5E90913F5E219FCE70B1CC2EC937F4,118,138,20,0.2112995473337106,PASS
E0B247CAB8D2DCC0742ACA6C9940E09D4846EF7F714B9E440E8D968E383E4992,135,121,14,0.38157390570502125,PASS
248F8B5241791E24BE5E5F84302554813364BF79EEB03DE8EE9B5E51FA016EF7,125,131,6,0.7076604666545525,PASS
4EEAD245ECC2DD5731462AC84F8A196D2A80BA5D0C802BD2B49DC447E8CB7352,135,121,14,0.38157390570502125,PASS
3F1C0C1693974C1DB55918D3C91941E0D758615399774F347402C4A297C41BDB,135,121,14,0.38157390570502125,PASS
C479A527E670B8F3F54BED979E2B45F1F0FA17588D237B1EAC2D7B4FF0B93EF1,112,144,32,0.04550026389635853,PASS
549038A0500BABBBAFBE2E201F4E4D46238D3F8BD29CB73FEDEDBD3602381E3B,125,131,6,0.7076604666545525,PASS
9B6609A5B6B27A3B05C371D32C58DCE8AAFAA8298802B80990FA61FC7A7B19D5,131,125,6,0.7076604666545525,PASS
2A071DF5F4A3D5B7E946BB2F8786135603505AF96AE1A7B1C515AE5C0F141DE,127,129,2,0.9005235503397743,PASS
C912D5438075CCEDE9DB4D22FAAF13BFA4CD8D5A006301B63D77DE3B4FE3EBFE,116,140,24,0.13361440253771617,PASS
65A73F7CABAEEC3CE4D405CA20FE176F166906357FDF4DC4191273DADEDE7BC1,115,141,26,0.10416255883043901,PASS
9132DC8D63D9F6832F4EF441D030215D2588BC1AA75CAECB699BF0429FF15662,130,126,4,0.8025873486341526,PASS
CBC2786B44292D91EA174FD2D0A5815AFABB46D212AD4755CE986B67DB32DCE7,124,132,8,0.6170750774519738,PASS
5749D51CF4E2D6C3E034767B7F97437E6CE09D8E3CDFF124B845190C6BAA1093,124,132,8,0.6170750774519738,PASS
AF9FA6E77D797DF83657B6EB4674694FEBAFDF78F68D7B21146ECF0A3759264E,104,152,48,0.0026997960632601987,FAIL
23A06A6B00987442A6E79E6EEC0278EED1A675F64B0C78BA8B114A942DDC9279,134,122,12,0.4532547047537365,PASS
BE168D55C130CA1C8702670636E35F1B97DDFD26CEA817D7FAE8F712100222B5,129,127,2,0.9005235503397743,PASS
B0B6174D653AF614C3B2D3C514D2183586B8C1013B5C5E434D540C87DB3FC9DF,131,125,6,0.7076604666545525,PASS
260A9F4FC147FC475129EEF414CAD1E96A32B66B5DED39EEE37697462EC9874F,118,138,20,0.2112995473337106,PASS
25DA210ED58161DBCCFAF6C776958BEA833D8895DD8CD21C6E77AA01EC48BB50,127,129,2,0.9005235503397743,PASS
951C5BEF62A6DFFDE6C4C4EF670334D19E7D63B346E737FF91317831FE043845,115,141,26,0.10416255883043901,PASS
1A78838A2A17EBA41E51D9CB72F27835C94BCC3BE388EA0F27735782505E72C,131,125,6,0.7076604666545525,PASS
BCB4317B6BD6AE3C8C8501BDB2D1DFEFD77F97877CB0557D3CBDCB93A829BFAC,108,148,40,0.0124193306515523,PASS
4369C84718C285EA263DBC098648CD61A9242E80C20F875AAAA79F450422D023,148,108,40,0.0124193306515523,PASS
BFBC7C23BECB6281827E7C763894467C9C09EF3B422FB0BB303B0EB7778E8EF3,118,138,20,0.2112995473337106,PASS
F4166D0E5FCA492E26D3632BE52B0CAC8B6E8B3A357D2B1D3686A20E58E432F3,128,128,0,1.0,PASS
AC18310B4A70C4845512C223DBD53A017A54CDDB9193FCD996304575AD1E1598,139,117,22,0.16913144470267139,PASS
CED0F564783E1E01F4B045B5D2550BBFC88952CB94BA5F784C68221DEC40D2A8,134,122,12,0.4532547047537365,PASS
E8B41B7CAF77E1A5FF4B36C39AB8780C71A9C414DF181CD97F78A1F315D02941,124,132,8,0.6170750774519738,PASS
C5E38AC66886D676C67CBF10AF81521166256B691B243381F1F6AE76EC045F4B,129,127,2,0.9005235503397743,PASS
A5207EB83BAE0E3C398F64D9092E1E9C9A007F4BD8468B5E855E0D8A24D807B5,134,122,12,0.4532547047537365,PASS
42F5E7DDDFBB47010D9CCCB87B370BBA6A29B65A314183093F1B10845DD1AA28,130,126,4,0.8025873486341526,PASS
B14C783DA6BD11FD0069E434AD47EF7BCE167AEF249A38AAA5136CFDCF55DCC7,117,139,22,0.16913144470267139,PASS
51E19048B3F2A52FC90AF89CB7C230CC4938447AD84BD2FB00FF4DE5AC633100,136,120,16,0.31731050786291404,PASS
E21074451EF7A0921F2F8686C1C72EF8D0C87495C3A80CD120CFA0FC64FB41ED,135,121,14,0.38157390570502125,PASS
AD3ED768788CBACB26F43CB731E932FD3314DAF700A4E75378FB3917BB8CDE38,116,140,24,0.13361440253771617,PASS
2FD1929C5DEF3552D54DDD7DC6543CB59CF3A7B489806ECA25CB4695227D38FA,120,136,16,0.31731050786291404,PASS
204271585E4B9A31F549DF5CE3D1FA2ED3D76746A6CCCF251BB84FBFA3B92704,121,135,14,0.38157390570502125,PASS
FC2BB5E46965F9E3D9E326D1D1EF8C64EFF3D7AE7B3DBBAFF88CD88347502234,111,145,34,0.03358661289689768,PASS
BD97FE94212679C3AE38DB971FE4B94EF23BCAE80861F325924C9DE8F28EB7B2,119,137,18,0.2605890342736178,PASS
F7508C3FBACB567C8A5762BBAE52FFFEFFA622EE3BA6F6CFE3F73DF1795B9500,102,154,52,0.0011540500847815347,FAIL
4E9BA105A05F8DEAEF6C05DBBCBDEB6C9C7FB9E3902B3E3E417EA1BA8221F991,119,137,18,0.2605890342736178,PASS
F70666B75D8307955DE29C829A4131782ECB9C3B51B14B24B69A5406ECC3F19,133,123,10,0.5319710580974012,PASS
122DA69515257C5603EA6E20409F20819972795918198F52BFD6C873D271AAAE,137,119,18,0.2605890342736178,PASS
455C9B7276F6AB6F1C3261D9328424E9673EE6B47D32DA4C4E0335F864DC7AA,126,130,4,0.8025873486341526,PASS
6E714D52E070CBAA4FA0FE921E3C1F84AA4A505832D112FB8BACDA686FF8E226,131,125,6,0.7076604666545525,PASS
9C8190247C63ED186B770A979CCE37DF48E0C759B1F515B97C19C0C3C26EBD60,128,128,0,1.0,PASS
37DBC2937A092DEEC0FEA1071D5A4D564F23F84C1BFBA239B8310EB5E6588D9C,125,131,6,0.7076604666545525,PASS
9DC423A894868A0254B2FD89B2430B861C7A1C55C0AA9C7F53B84F301E811E90,143,113,30,0.060792723530522785,PASS
46A5BAE749FD68391C1712A11B063F800973D5BB47F158774880B51DF550F0E3,131,125,6,0.7076604666545525,PASS
13127A872FB902D4B95F1BAFCC4E79F60B28EFF265F180626DCD68C6AD2EDD95,121,135,14,0.38157390570502125,PASS
6E603BFFF6F26A254AF138EECAFDDEF75359C07FAF877B8ACBEA94B474AB442C,110,146,36,0.024448945310089426,PASS
F8D6860F9D0E0DF3DD52F51C417D5B61FA54C96BAE7F11EDE822FF3BF3E26E09,114,142,28,0.08011831372763423,PASS
66B881C205ABC9239B5CC6925B6F797A76A472BCAD9D370B6B96BCD953442CE2,125,131,6,0.7076604666545525,PASS
1437857BDCCB94284104730ED965B223FAE42B67538987026A8C75938FBF3677,129,127,2,0.9005235503397743,PASS
1FBB9F1D19B4A76199925C8C9A266F2A94F09D95150AD1C24C96F3A8846BD861,132,124,8,0.6170750774519738,PASS
EFF6B6192D6CDB67720F5558277F1EA74135946D4B9B3F76E65E5EB38F819CAC,112,144,32,0.04550026389635853,PASS
981A405312DFDEC4316D121414D75EA00ADF79E11E037318C0EB86C2390EEE2,141,115,26,0.10416255883043901,PASS
63DD157D0EE9C1A15AC6E4488550A6947AE4821D5D5A09409BEDDA040E09E793,138,118,20,0.2112995473337106,PASS
51BBACB450EA2F0DEFDF1F6EAE751E2B7FAAFB3345A180171FF5C772F93712EA,111,145,34,0.03358661289689768,PASS
89723B9BB112A92AE98B247BFA846776C8394ED8EA656FCB5ECC9FAFDF3C60A8,119,137,18,0.2605890342736178,PASS
3E6E54975A3E5E13C9960417C376D7562D480DF86E5466FBEF8804CB062549A5,129,127,2,0.9005235503397743,PASS
213012D0D6F27B06244A7256048C9AB2651742C974CB3DE941E6067412B7F9B8,140,116,24,0.13361440253771617,PASS
B2798E294075D67F85FF97647FE6D10CC17697AF450B28CDE6442A6DB6EB948,123,133,10,0.5319710580974012,PASS
855232CA1D0E152370E2BA19985233B8C959F2CDFF121DB20874D8D3BE0CAEE7,132,124,8,0.6170750774519738,PASS
FA0B62A6B3273BA3666C3EFD5A562ADFC843D02E8CA530072B6B6F7F2325C55B,122,134,12,0.4532547047537365,PASS
8CFEBABA8E8FB39F79FE0481BBBB438987B9A0F884BB278465CB1818DD54A53D,122,134,12,0.4532547047537365,PASS
FC2564F2251215AA297CE8A91EF8BEA8C7E5B4EDC606FFB1642AEDA6419CB1D0,126,130,4,0.8025873486341526,PASS
4902CDAF01C2C87E516EF8E62A2BFBA35EA5D811D56BA6A9899AE543C79947DA,126,130,4,0.8025873486341526,PASS
51DB9AB437A48FAC0E25B5830B5FDCB9423EB589EEE25D1C2D874DAB81A10E8E,127,129,2,0.9005235503397743,PASS
F5AC56F40E998FB399D1E819461CC5E77E5DDF05FD71F98336E00819FB7CA8C7,118,138,20,0.2112995473337106,PASS
210E71668F367E68F65968F94B73B72CCB28524CFFEBB77137F988121F2B1385,121,135,14,0.38157390570502125,PASS
255CE787878C9B14942A8B30D225FC64E65CF23CD92CD57A8FB85F60605023EA,132,124,8,0.6170750774519738,PASS
91B95560B0A3D69FC53C6EDA6A4C2BB7E3B2AFEDD1A8065C56397CB2F1EAF243,120,136,16,0.31731050786291404,PASS
E3D0E4FE3858EC3F0D02C8024B59F4938328F0E660E8DD02A7FF612648762C1,138,118,20,0.2112995473337106,PASS
6DAF96149DC55CB00576DA8AA668FF544C4C9F0A2AF1F8553218E1972A1725D1,131,125,6,0.7076604666545525,PASS
53D929140195B21A1C2B1FE87F087885B418BB0B8F9988B92D739A9385552BEA,135,121,14,0.38157390570502125,PASS
251242103D9BFF687226A020BD2AD41604A4AE81E043A30DBC06DB318A09A1F0,149,107,42,0.008664896726025117,FAIL
28E3A631F5DD4F6953F97B275DC13E10C9FC89ECBDF8B073C0CF1710D375DC4E,118,138,20,0.2112995473337106,PASS
8270F701AC392B8D3E5DCC8D72D61B571AD82641BCC3ECA21F9DD33B7723BF0A,124,132,8,0.6170750774519738,PASS
498891C96A1BCF108DEA0FD35F284DAB9CDCC75CEB0E7CEE327242168DD24D51,129,127,2,0.9005235503397743,PASS
38BE9DB8D7C951FBC797D58699A4D402FC2F0EB2EF967F87704E3AD1BBD2983D,115,141,26,0.10416255883043901,PASS
F3C3E573B6A676ED6A0F0AB91A1F570B754612DCB5A03CE188271AD0F0AE8487,128,128,0,1.0,PASS
2AE93A969EDDFF7CE1E47285521B8530F9536B18EBF18EC2E4C307EFE0936D4D,120,136,16,0.31731050786291404,PASS
20D9AAEBA0508253CF2DDBCA283B2C55438D92733AC1820C750E413A6D3B46FF,135,121,14,0.38157390570502125,PASS
512F94EDFDBB96AF6266C440CFF05F57FBBBC9B5F952A828F3BDA3529FD579CB,108,148,40,0.0124193306515523,PASS
D4477C2497FAA1014511949038B6FF041154EE3E30F55BF3FB44868263FFD794,129,127,2,0.9005235503397743,PASS
5F8804FC992B13EB50941CF2A2D09597ADA90002ED78A78FC77FD7ACF49B8827,128,128,0,1.0,PASS
6E68316025F787C7ADB9785DE383CC865B23E66779E25CBC2F2B83643DF70A91,122,134,12,0.4532547047537365,PASS
C19EF7E2B3128B3295DAFCEDB0198F23BE055AE8BA258061BEFC88DE2EC3764C,124,132,8,0.6170750774519738,PASS
364EA6762E9A491A294693D0B8113C85C27D19DDAC2DDA4AEDDE0745E94F870E,130,126,4,0.8025873486341526,PASS
916902AD00F8E7474D50F370AE01924AF7BBB8A94BA7C25247FDBBACE69F1B6C,125,131,6,0.7076604666545525,PASS
77F58B40231465FCF5F82F9D3CE78DAAE5B2D7B13F6DD36F59B71AF14BA1F366,109,147,38,0.01754895019147673,PASS
F9E49F19EF9F3C385F38FD79EDD7E34344276400CAECCDBDE51F093A955351EF,113,143,30,0.060792723530522785,PASS
C0A2045A60697307B55A0D5C4DDEA961092B14574CB0BAFCAC628E3A39975CD,138,118,20,0.2112995473337106,PASS
747189DCD6637D50E87995E325279ECBD5FE0DA940B874C5337952FF1F7E7DDE,113,143,30,0.060792723530522785,PASS
831289558206650E99424B46BCE24672A2E0408DEAD4042AD208360B68C46050,158,98,60,0.00017683457040160787,FAIL
9908E973645BCF4EDCBB29785F928532CD6FFEEE63827AC363302E3863FD74B6,118,138,20,0.2112995473337106,PASS
3FC8E4427B4000EE1EC7223B3E0DFFDB6070574408DF9089361368B190ADBB2A,135,121,14,0.38157390570502125,PASS
84D58BC4B3F23230793842983B3633D93D059F3D83B7A8C49BABC259C95238D4,132,124,8,0.6170750774519738,PASS
876DA9D9399A97D7D0666A6F905FB54D8B9643AEC4517BA4DA1DE9E07B8FA8CA,119,137,18,0.2605890342736178,PASS
1B15BE2E39E029F84D51C51949DDE63984288A25C4972FC1B994CFD69A4B4233,133,123,10,0.5319710580974012,PASS
5404C502DDB9A7E5E947B23F6B97D7D85931DFA2DEEBA03D1724E9879596C107,122,134,12,0.4532547047537365,PASS
E08F2F41E5E7E762CD53AF282A7994630DF70E132DE732B41803165EBCC55756,126,130,4,0.8025873486341526,PASS
6F100883225453050E90D628AEC551B5348EFB49B6281B9D8FFC000C5BBE8F17,139,117,22,0.16913144470267139,PASS
FAF956F20834ABDA8A4B18D75E152B7217F97E6F01856EC349F5B0A28DEC025D,125,131,6,0.7076604666545525,PASS
AA59FFB63DFE5ADD88AD88B767730CE5A63A0558EF8E62D03CADA3DAA1DF7488,117,139,22,0.16913144470267139,PASS
4024ABE3814DD254534B4C3906E7E86E2ADE09818D5C628D84AF2DDF40DEDD2F,133,123,10,0.5319710580974012,PASS
2CC82322972CED64B0197ABB8AED840E313771DC162F565C89833D49F05DD8F5,131,125,6,0.7076604666545525,PASS
505262ED535551E0107E68A2A5C88104075F5E353D0D55D7F23772FA60DE3EA9,132,124,8,0.6170750774519738,PASS
309CC0484AA0BE85A8D67D26BCC7BCCD3A2B74B86B3B0F49C31A71EDD8216484,134,122,12,0.4532547047537365,PASS
66AE21780A12FC215DBDE5FBF81E0CA24021B29D40ACF0D08CDEC3936D60CF0C,136,120,16,0.31731050786291404,PASS
5D6C4353F428A2868C8FD4919933CF20E184FFA0AEB273BBD31BCA1050839CD3,133,123,10,0.5319710580974012,PASS
8B70C4E11D0242D346AAAE009AE91F019C646CA14D27845E834463A1B620F81D,147,109,38,0.01754895019147673,PASS
EA97FFFA480E61BEC2A61AC36A28A9372B96AAB53199832C0F990CCBD276B942,128,128,0,1.0,PASS
A0445B0C6E681EBFAC5C3C0C667A594AEEC861067E670FC1FA81EBAF77E109E7,126,130,4,0.8025873486341526,PASS
31BA926A9661DE6DB19DC8D62CB29068BA074E2E0A58CE315064B27391017968,139,117,22,0.16913144470267139,PASS
7094A6A4F8F79655E7B58423B4C0E55C3509645E4B974E1CDE56D111DD75D67E,124,132,8,0.6170750774519738,PASS
A9C27C4AB1F3DB1E2B94962375B9850CD817002D7226EB9E205E0AAEEB3E84C1,133,123,10,0.5319710580974012,PASS
46D095FAEF5089AFA34FB60195F2FC9E0F93BA9D88BD52EDA5AC972F9CAF435C,117,139,22,0.16913144470267139,PASS
FE66138A726CAFFB0F0DEC8E25B65623D746DDC7A58FE62ABF46BB5C1DAF9262,114,142,28,0.08011831372763423,PASS
52A788D1A45CE31B8947AD277095E5C2AFD0AFBDEA408BD156F6C8B53629FAC7,124,132,8,0.6170750774519738,PASS
29F94BFA5C628E9FDC329184993345E920222B43853E189D444F2F94734BB9B4,133,123,10,0.5319710580974012,PASS
25358338294F131AD4077A223706A70ECF693B4577EA1D818B06AA19E15FD9E8,133,123,10,0.5319710580974012,PASS
DD1FF03AD6207E77F8B169D29EFED118C5A919CA0C009C8CAD58D8B91D3E3D9B,124,132,8,0.6170750774519738,PASS
16BFE70044D91C70219B6796B7858A2F9C6D46A6B4C035CDD4016DBF6A81E7CD,129,127,2,0.9005235503397743,PASS
85C29ADCB37F10F9E6D8E01E65B327E4522FAA0078FFD33C133BDCEAD2C6374D,121,135,14,0.38157390570502125,PASS
468FB2D0132EDCA0F4786B57982E1574F8946B84CAFC3C63CEAB968359CF2C8A,128,128,0,1.0,PASS
AC4A75AF7FE548834FD6CA27777728663FB81C0A5C9F4ED2A1B88E1AB94CA231,124,132,8,0.6170750774519738,PASS
7A6AC582F0E17F6193D5FE9ADC71D5B5EC15AE1BE97F5E5F958D37405A976393,113,143,30,0.060792723530522785,PASS
A1E239178B8520667A34F4FBFB261C85EAB6D63086FB5460D76FD20343F33F1B,124,132,8,0.6170750774519738,PASS
F3ECB30F30740AA4399FA895399203C0DD62AC58FB069829FED17FB1E9C683FF,124,132,8,0.6170750774519738,PASS
2F52592383F3EA16A85FF1085E25C064A6DC9FDA2117D4A2C3D2205A93EC38D3,133,123,10,0.5319710580974012,PASS
523410581DE9431AEFE3F633DF1DEA474012BBE8F717800D814C9B689262ABC4,134,122,12,0.4532547047537365,PASS
CC619BDE0381AC4B45B324C99DA25D04327C52F7391DB6997C62871365263E55,132,124,8,0.6170750774519738,PASS
EF90879B893F5BC737CA8F247443E7846A2C6E4D06F42E907EEE52B325BE06B6,123,133,10,0.5319710580974012,PASS
963DFCE88C00FFEB76DC653DD4C5167BC3C7CA1E82F00CBC65BF2FEABCE3E804,118,138,20,0.2112995473337106,PASS
4EEAE2D061DFEDC582808FFC3A6F7DC6174BC0B521F5A0FC437277F3E930DA9A,120,136,16,0.31731050786291404,PASS
2B46D57B68787D72CF401B3B78576CC5E019D7BD92CA8A81836D8EBF2491A4D5,126,130,4,0.8025873486341526,PASS
7090E346D6FBABE9FE555363C6233BAB77C28DA8813C69598FFDB5D9BAA9F12A,116,140,24,0.13361440253771617,PASS
2A94816EAC6FBC396CF567568A1E92548FB407F43C9A5A71BFBEE0C44A7CA27D,123,133,10,0.5319710580974012,PASS
D8E5F39BEAC1191452316A5D5E38B69889E2777E606B32B02152435287F03A74,133,123,10,0.5319710580974012,PASS
66162F731FF53131DB0EC021C24AB4B138CC4E214429F9708878719207CA6A2A,141,115,26,0.10416255883043901,PASS
1C77BF50BE4E16673FC6FC6701369C35847C4B0E09624A6C51E536FE44C0C58B,129,127,2,0.9005235503397743,PASS
10750F46ABFD3A615D0B1D5FDCD293A06D6C2F1B2B0143A397433E42F2F58251,130,126,4,0.8025873486341526,PASS
ADB893B26BA5FFC922F7B891644F4F986AF79BDC2AA3DC41D3FCB3C621740223,121,135,14,0.38157390570502125,PASS
9B09C00D146EB97DAED2C39579BB84D8A88C970E1FF4CCFFBD20EE9839D4BFCE,120,136,16,0.31731050786291404,PASS
E126927880066ABA0AA008A6866142982FF8FA071CDE4730EEB316C59203B777,141,115,26,0.10416255883043901,PASS
61106ADCA3953EB6146DD657295519B5BD16C9382F3A5A18E5F6BF374E60C616,126,130,4,0.8025873486341526,PASS
C36CFDED0EDB8A1D86DC238C0954D17202FD4B4EFFD9D9DBD338BE5CC5DB067,119,137,18,0.2605890342736178,PASS
AFFC39BB8A5BC86C1DC23D7432E2AAB1551FAECA5CC7A8BEFB73A7ED22F61D61,114,142,28,0.08011831372763423,PASS
E5AC1EB6D10F5E74B49F6144EC9573FA1B90B78092B7BD92C6D4FB6E49ADDA65,118,138,20,0.2112995473337106,PASS
A1192798E7E8A7E3F973B16452D89A8087A2171B26D446E15040BA28750C77F3,135,121,14,0.38157390570502125,PASS
6C7EE250DBADE7F873828DCD3D9E77752838DCA6B041CC0C466BF9C7BB8A5001,125,131,6,0.7076604666545525,PASS
5C84D39916F84DD56F1A43E51E90E7F6ADAF8A2C84FF704679A85379FAB29C49,122,134,12,0.4532547047537365,PASS
AB9BDFDE0091495C9ADE222933FDD18C598C4500E35704D7ACB6EBC423C547FA,128,128,0,1.0,PASS
B67DEC78438187377BCC1835742D028DCB1384225377F618E5FDA0E29756653,130,126,4,0.8025873486341526,PASS
441F71E422313C07BBE235AB165B3F7DFAAB0602173587C8186A5B841B7A3513,132,124,8,0.6170750774519738,PASS
414769806E45EC263ADC5A2AD96B0690E586B6A38426ECE02EE95CBB25BD33DE,131,125,6,0.7076604666545525,PASS
FB3402F23B64E653FB8B3BE608E7032F2059902D911B2A4F11B9DE1B8B7C78AA,128,128,0,1.0,PASS
247D9291B6F5690FFF9F4A149CA9743665A5B5602EE741BCD536E9BC0904ECD4,125,131,6,0.7076604666545525,PASS
BB5DF1ED2FB2B0D23AF9DA728D8E035F530BF1A3BD84C96CB0A3BF4B74DE4A81,118,138,20,0.2112995473337106,PASS
30AB8996E230B6D403160613302EE3F1CF0144D7B57505893ED6321E4D79B29F,135,121,14,0.38157390570502125,PASS
225DB4063913C7EF0B501DAFB79015B2B4429F67216EEBF8E5D397A692683F39,124,132,8,0.6170750774519738,PASS
A6D37C3A8434AAAA26EEE958EEF3B347B9537162BE3D3A1A15823C72216CC6C,128,128,0,1.0,PASS
3EADCD63709AAAAA93453B3D143CC3C2FDBEDA79C8CEBDB890830C733181DB3B,123,133,10,0.5319710580974012,PASS
19ACDC402987E0918FE48F6757F541E4142D60CA991576B320597562CAB0E8DA,136,120,16,0.31731050786291404,PASS
CE2189DB5E314DCD69D756AD6D109DBCFC8C555EADAA8B01A3885F2E97C142FA,124,132,8,0.6170750774519738,PASS
AAFC88DEF8C9ADC2F580A0285665C9E23222048FCF79DBE7FC557CD3D83916D,126,130,4,0.8025873486341526,PASS
DB7572DFAF39E7D1C1AB672BEE1BEE739274E35963CAA4289E405FC44BD85F44,116,140,24,0.13361440253771617,PASS
AC079805BD6EB30D4C3A33BF9978B6AEE843C698F262B1704C408FB2FC6670F3,128,128,0,1.0,PASS
D32AE4CF7BF27B8A123E170696560ED470EB168B2F01BD268EEF96EF64E52A83,123,133,10,0.5319710580974012,PASS
4D48424F165429C2D9646A26343733C14B9F8D211715129A6B510E5393106F9E,141,115,26,0.10416255883043901,PASS
BD763CE13DBF43A747ECF73B95EFDFECD1096CFEAABE17B1B99C7C324741F653,105,151,46,0.0040402749798920095,FAIL
AF55545FD2ADE6DE55E4724E47C75ADF5B855167A93E9A9213EA098DED0E3629,119,137,18,0.2605890342736178,PASS
A8B623C1057730FB25865EC4E9106715088BEFB69C126040A5A7782EC93ABC92,138,118,20,0.2112995473337106,PASS
61C5487BBFC54B20A4BD93B3E4FAD41399A55FB52C62BA9C79FF3387B44FA5CB,117,139,22,0.16913144470267139,PASS
6B8C9436F6D86422721344ACEA30A9CA6C84EF2154F27E4C08DCC2E77D7B15AB,131,125,6,0.7076604666545525,PASS
8B2693F2CF83228D25106519DB84B126AD7FBFD8399BF5A25F3FF6E988F134B2,121,135,14,0.38157390570502125,PASS
E4D87C15B7E544D012C99EAD520424E104AB78789CF40F508B4ED486CC4C6383,140,116,24,0.13361440253771617,PASS
31B580F53B3A2895EADE3DDF5E345CE533084D0624C4BD22390042EFEB5D2990,133,123,10,0.5319710580974012,PASS
945B096F4434126EBB0B9222499D1007840F30F03ECA68583BE77184822D3A43,145,111,34,0.03358661289689768,PASS
E4F040D7228592819CD0E615C71565CEC1353031D79DA41E4381C410C374F929,143,113,30,0.060792723530522785,PASS
CA94A05024AD5ED636B66720563A06852FB55102C998CD942A71E8F15FB3CCFD,133,123,10,0.5319710580974012,PASS
2B9C6D14E92EF273287FFD643FA47EA72C1FB421EA047A23C0FE0DB2C0E3546,127,129,2,0.9005235503397743,PASS
575EC7D5A6A59F45331BF7919DAC9219533305E05A3BC7047ABF8659727812C4,126,130,4,0.8025873486341526,PASS
DF3054305DC336354DA9EC4DD6FC76354F6A000CDC60AE3C947809CA16B739FE,128,128,0,1.0,PASS
1032C2ED303947F3330AE6BC6456E0797B459C3CE4FC93BF5A683842EB2D838D,129,127,2,0.9005235503397743,PASS
96595AF0805580E65D56326B76C325686FF7E43B60A7B187DBE1C70A3E245D53,127,129,2,0.9005235503397743,PASS
E9D6293660B6A1A2AAAE40278ACAD08BE17BF018E3E676BF8748189BC6E82220,136,120,16,0.31731050786291404,PASS
2A97EC10FDDCD8FF4F276D8D958BFAC81D6797054F7749A827BB445D24F7BA38,116,140,24,0.13361440253771617,PASS
CAB12247E63C5135153EB5736B9F2A10EC53063988BBB14375653F62ED159854,130,126,4,0.8025873486341526,PASS
4F178A5D538D0987259D8F582A4BB94AAC7992047789B273F92E04168BD08894,137,119,18,0.2605890342736178,PASS
1BB2E16A5BF067C19DE6CA7F31DB1EEBC4BF721068A18C5D92DF02B69D94CD2F,120,136,16,0.31731050786291404,PASS
76ABE69BC0EFAC76F2A38FBBEB41369EE874E8D4FBB3121C4149728AE8F2162,123,133,10,0.5319710580974012,PASS
4F549D5D3372EE8CBD2D13B871758CCDC57AE5279FCACF8552E837A5BB7B657C,113,143,30,0.060792723530522785,PASS
DC3D5316F1009366BDE4E0A17183A27B68422714D6EE49AC3A351D7B39DC3A69,130,126,4,0.8025873486341526,PASS
721335BAADF36E9D5EB3F20A8CCA332A617F6D5B8C099733E9CD03547F250CD7,121,135,14,0.38157390570502125,PASS
12ADC6ABB7F8819E5285F0A4E86FF5725CCFCA8EABE27CE47F4A01CCF04ED3C7,120,136,16,0.31731050786291404,PASS
841281EEEAD6652156E2172413F2A8415E3D7B063C4A7471D086D0E949B97B28,138,118,20,0.2112995473337106,PASS
F03874EF36D2A4205510CD3434B50F18C922FEF0037652DCE5892C665A80DF8E,136,120,16,0.31731050786291404,PASS
E6F64B580FDA45FEF335EE39A3715D82D8A9B79A146288D96B2E691BC7BE0437,120,136,16,0.31731050786291404,PASS
DBF6518ECAEE8DA35954D8CFFD4F840E35512EE5E5783336C64B2217A477C3F3,119,137,18,0.2605890342736178,PASS
E00AF622298675048B7F0055EA4BB67FCFF9A1DCDA783487F5DFE019F55A8F65,121,135,14,0.38157390570502125,PASS
6A25100974E436AD61FA9CA8D80ED709A4E88C91B6879A8476636BC7CE511A7B,134,122,12,0.4532547047537365,PASS
ED43CAD52A23BC5649BE19158B1675D764963F0BFF375BBCD41227FCC33F74A1,118,138,20,0.2112995473337106,PASS
8EC191418DD3146E3A80839E3EAFDE5315C144C699D91ED4ED8E08193BBD760F,131,125,6,0.7076604666545525,PASS
D54B82000485D5BA19A4D2FD9DAF30EAEBD19636C8BAECF3DEFB8CA9FCB5114A,123,133,10,0.5319710580974012,PASS
277A863FD7F60ADA59829963A7E19FDEBD326BF2505381CE34EFA2543E42E229,122,134,12,0.4532547047537365,PASS
9274066D55AC2B4ADFA25B1CF209BD7051951B320F0D67E2B36E8EA52DD06D3C,129,127,2,0.9005235503397743,PASS
215B31416C3A5959510C616C287B597985ABCF726CF565A0AF6B68E2AF239753,129,127,2,0.9005235503397743,PASS
4F9DD7497B4ED7F5F730080B0FBBA5DB82E46E132FDF12C6152BC8E00A72B317,122,134,12,0.4532547047537365,PASS
A5546D81F053084EB8A81AE864CA332CCCDCF9A8CC54330C53B629D1C7B90488,141,115,26,0.10416255883043901,PASS
27260520AB8F4866E78FE2C9CC3CAE383F90913636BA1E1105231DD6625ACC49,137,119,18,0.2605890342736178,PASS
,256,0,256,1.2777508801076536e-57,FAIL
7B3AB03E777948A3AF9B5FC8790CED9E8228747A2D59711A0F0F6B600D83F00E,127,129,2,0.9005235503397743,PASS
2DCFDFFAD23FDF9601F39543FC01823B41677445E118DDC02EA9F433FA810EEE,122,134,12,0.4532547047537365,PASS
4D90BD81DF25C8405C06D50831865A0A2340D43390E9F11B146919CB2D79CAF4,144,112,32,0.04550026389635853,PASS
C0A28063C0B3C3B7573AAA2959D7FE991F1FCD4958EEEB13968953841BB8F90,129,127,2,0.9005235503397743,PASS
B5FBF8F2A58C3609BA10EEA0CDC90149CEEE0073B8810F41BC826AF8BAE9BA7D,129,127,2,0.9005235503397743,PASS
980FF2A8F27180DFDD7D05CDAE4C09EFB0B65CC40CDCBF384E76B64428F31016,128,128,0,1.0,PASS
C0E9F1F39E1A93D362E4BB3E42FD6821632F0854DF73A9803609B61E99851ADD,128,128,0,1.0,PASS
6F90B6C71C8252414D2BD291ED7EA2F90282CEEBE69942771E340FEA0B499EE4,130,126,4,0.8025873486341526,PASS
BB367B43E61B0F5113C3148C27D955D1646F461E0C976ED8595223D21A8A692F,131,125,6,0.7076604666545525,PASS
53B4B8942BF9C4C7101428F71B8D27EDE6143D3478AC01413FE08D5C456FA340,136,120,16,0.31731050786291404,PASS
AA7C1788928A94C8491E3773D12FF1A3FA4E788F502AC862287CDD9A1E47216B,132,124,8,0.6170750774519738,PASS
CCE859B1AF8CB9CBB047FE9BBEF004C1FFFE21032C369BAF191807BFC59F5720,120,136,16,0.31731050786291404,PASS
121D80C2271FFF8C6B2D45D49E5F07354D166E6B198BF7F857CAEA9B2FB138D5,120,136,16,0.31731050786291404,PASS
18B38A2377E1D1A01D6CBB742AE939940ABC98023E8C4825D86905DA207F6821,142,114,28,0.08011831372763423,PASS
7B524B3EA7FE00DCB72CEFCDC261A9460C589B9B90412E1B0507D15C3725AAED,129,127,2,0.9005235503397743,PASS
80892FF32F3FEDB32C93015C051C1DA01660A286C967A621FBBD863343114475,138,118,20,0.2112995473337106,PASS
3C5B451826CE191DB001877C868FE21738B99D2015B61F0BB13DB0D7B181D68A,136,120,16,0.31731050786291404,PASS
85832010AE8A10300C1D707FFA058760CB4FA50165853729F49C96F738B3F00C,143,113,30,0.060792723530522785,PASS
C96761198878D2E6F8030A9157598A66E83F32A32D7A3040C404D7D38DD8865B,138,118,20,0.2112995473337106,PASS
96835316EDA3D8CB21B1557AF3668A5397F013C00435643B81FA508D0AB5F0F7,132,124,8,0.6170750774519738,PASS
2796E2AC1DFE7D18F684E452B83F6F735EEEEC98E955B15B61055996E650C8E5,120,136,16,0.31731050786291404,PASS
5ACECFAAB2FF9E1B12370750F72E46A4CE1283546273F760F1858A3CA236060A,131,125,6,0.7076604666545525,PASS
38E4C0997467B55E7F52239881CC9FC23C3A1BE1DE4DAC5FF4023E9363F56410,128,128,0,1.0,PASS
7F707D744042D1D4D67A88457FB3AAF41593405C49B5360ADA70FF125933F97A,126,130,4,0.8025873486341526,PASS
D54B2436C8036446E03D7E212F2D60525A51558BC7CE20AECC1F0BEB2276D706,136,120,16,0.31731050786291404,PASS
9EA8215EC1EBCB22006BE1CFEA79CCFDCA78F6ACA2589FFF1D7BC7BA7724FBC8,113,143,30,0.060792723530522785,PASS
7AC11CE4FAE410592410704C9878F969CAFE85336237399ABADE697D891CF10A,132,124,8,0.6170750774519738,PASS
19EEE90BFC4E0BDCDBD0EA2D92C9F14D7E77A69E658B6CC939AB641AA2E79694,119,137,18,0.2605890342736178,PASS
E3A901F14A059DEEA789EA352194F2C361D05FB68CFAC6E1BACE5D3C34CA0F29,127,129,2,0.9005235503397743,PASS
CECF240D525D624C95F852ED4267FC8E90F4DE5339B2B8F13ADFD0D669168456,125,131,6,0.7076604666545525,PASS
43862652B830783788ED51143A4BD4C24BA6297808B311F624A431A1A381A949,148,108,40,0.0124193306515523,PASS
1FE5D6F363FE80A94829FEBC4AC2C94B7296DBDC63D189D412867AF3F4CC8E4F,120,136,16,0.31731050786291404,PASS
67CA2947161F8EC6583C2DB823DBF0BED8DE71CE699E62929D4BB8A2AAB0B258,126,130,4,0.8025873486341526,PASS
21B2FC3743B352A8E02B633FECB6AB3CBBACF689867DC5667DF72BE331BD3E37,112,144,32,0.04550026389635853,PASS
65A781FE7BCA74F424A016041EDEB561B24118FCA95028EE03548753AB457B01,137,119,18,0.2605890342736178,PASS
67C5A1235D734B520A0E676D4DD3F9A4A74B3660D3848AA7657E7B435C367DE5,123,133,10,0.5319710580974012,PASS
5884FC723E1BD2F04AD87378B050C57735B246E49BC874F1170034318E128637,137,119,18,0.2605890342736178,PASS
D289042CAFD24FB40AF0D070818E9395E55E1A8BE290627C1AD484D97215F311,140,116,24,0.13361440253771617,PASS
7EFD3F448184E341685EA90A0D3B7E0E4ADA80C708854EB55846FDF8682974BC,133,123,10,0.5319710580974012,PASS
28A386FC57C9BA1B06FC78589B955A88BB4F675343B4F345AFDFB811B8E13A89,123,133,10,0.5319710580974012,PASS
95A69123E18C9DF421AAC4FBC1AC0888A1E105BBC26FFBA4F1BB9FB568670E00,132,124,8,0.6170750774519738,PASS
B93B2A85A4BF17370E855AA3B16737FA83595CABABFF208C584015B7B31BB3AB,122,134,12,0.4532547047537365,PASS
7C2D2A92F0B0632CB6407FFC954AB7092B4442D40C7A03BFBAB1E9183FCAE33D,129,127,2,0.9005235503397743,PASS
BF3F4DA8F25B92734B40084AE1330AE2FE0395CACA93FEBA14816D4902833BB0,134,122,12,0.4532547047537365,PASS
BD4D6E257C00B05A7E0B7F8D0C466AE73755B86EB5CD14DF9183C35EE5E7B06,123,133,10,0.5319710580974012,PASS
620EE064A96B43B080BB9DE58CEA898F0A9CB70E8D4F98F1D8C2F5873C732193,132,124,8,0.6170750774519738,PASS
542DB5C2181E3DFA5C52A8D27ED65413D4A0A759B9876D4FEEAF5D5DE872FBD6,117,139,22,0.16913144470267139,PASS
39B4C0E20B54FE6E2A941FC1F665EFC3029525D057D2314272EAC086AF999E59,131,125,6,0.7076604666545525,PASS
4DEA690A1F704E5148AC3F857AFE9D2690DECDBCAD4992C1851698707AE6A50F,129,127,2,0.9005235503397743,PASS
B0449CD6E7CA75FEEAE56D679031BD0D29E9C548B4EB0F3746C2BD984D4C175D,122,134,12,0.4532547047537365,PASS
BC4534309C92DC7055081C56B6EC2E8DF2E2284473E9D0841AE20FC663FEE0B6,136,120,16,0.31731050786291404,PASS
910B8335C1C749B623C28871B585D44A43D4DEF4F05543E44FFCDD2A3F7B34A8,129,127,2,0.9005235503397743,PASS
EF2A80E0CBD83BE296114A03F1D2201FB28F4127BB9BAE3FAAE80418A354E005,138,118,20,0.2112995473337106,PASS
CD63165ACF550AEAB2AB2E4E17AD3B46FFF434CAB645DA4BEF0E0FA4D76030BB,119,137,18,0.2605890342736178,PASS
EB9F7FC030772C9F851541D5F0B8008C57133A5363B1B01433A9ED2D07D98320,135,121,14,0.38157390570502125,PASS
6F375715DDBA6B8B450A2644326BBEA4A82CCA730F3C6B0C0412D8A7D3B3D77,129,127,2,0.9005235503397743,PASS
B0A30FAEDC67F0FBCA4A66A7778B48FC6E5944BA5DBC5BEE6794BCC28B6AA976,115,141,26,0.10416255883043901,PASS
1EAA88BB3DE95B85E4DB16401522C8166F1F4BE07064CEC0F1C6333D04B7639B,132,124,8,0.6170750774519738,PASS
1983A28262CDC788594E318D3B2D4BADC384A24336FAEDEB86BA09CA7205AB43,135,121,14,0.38157390570502125,PASS
8418BC3F836FC1A4947EBFE0497145EC2F4965BA84C7E8E64CB68686D4407D8,133,123,10,0.5319710580974012,PASS
909EE3F3BFEB25E008595185FD30DFF7D0FDEA326FF164A342184DA1C3527E5F,119,137,18,0.2605890342736178,PASS
58EDF869C18D8EF82EED7E91E05069266A89B19EB9E93FF91AFF7D931F7F1DB7,110,146,36,0.024448945310089426,PASS
75C60BA3265AED6C9FC82A6B202F8EB6C8EAFB11B5507E83BBE426C883880A2B,131,125,6,0.7076604666545525,PASS
C5C39DBFEFEC2976DD5E3A3822A27661F618CEAA4D6662E3E33E0FE914D7011C,121,135,14,0.38157390570502125,PASS
16DC4C38979F41BEC3FCA8878E39C306116F9AE9FD22E88C6B0DB0ABA93CB822,129,127,2,0.9005235503397743,PASS
8440F09D98012E30A767F3B7AEB7AAD0CFC24B3303037AF8576CCA87153DAEC9,129,127,2,0.9005235503397743,PASS
88B1CC959021251232653F8E9469E7BA1A00162244AECB211BBB93B5D80106B0,147,109,38,0.01754895019147673,PASS
7727806BC9777320ECE31A6CF34BDE6616334B6F00559F58485B3BBD138840A8,130,126,4,0.8025873486341526,PASS
57FBB99ED7535193A17F281EFFAB7BAEB522EA467F80DF68EA6FDBBD5B395704,106,150,44,0.005959526470109114,FAIL
2AF8C090342CC4961AB592DD0AFB673C222D7BB4854AE645073DEFB664BC8418,134,122,12,0.4532547047537365,PASS
2D9D1ED4AB31CA656A8D1DD8F4D86173315375E2117F28B17E532E23577E0618,127,129,2,0.9005235503397743,PASS
159AA80C26692CCB26757A3ED3B95B17C1F278B8974D6AF9D987DF5B2F6D54A9,119,137,18,0.2605890342736178,PASS
9CF3FA3A265DE77270FA5245B3B961D1A56217B1E568D4726AE662856C908781,128,128,0,1.0,PASS
2F2A6CA89D2EA9C763C27043B3313E8BBEA4C8640FA80FD8BFC5C04AE0586F02,134,122,12,0.4532547047537365,PASS
43066BA8669A973E32199243588C81499C1081E2724231BF0462BBF4D6B19528,145,111,34,0.03358661289689768,PASS
9385B7D8D31230EABCAD5B373F76722B42148062435A26235474F73AD78C84EC,131,125,6,0.7076604666545525,PASS
21558F936376DD3F5EAFB06DDB9C21E62B0EA7033C931BDCEA8EB08EC7287074,123,133,10,0.5319710580974012,PASS
C6F37E41AD205ACF843D1AE47522A635BD8ACF4B0BFF16994F5405A396046455,130,126,4,0.8025873486341526,PASS
9FB15569965B3663425396227ECC10505B7CD50D335DAFB9D88C5EE3BFEC7EFA,117,139,22,0.16913144470267139,PASS
8A2403D64812049E3D965E93ABF1B540F0658221122BDB7E465912377182407A,144,112,32,0.04550026389635853,PASS
4762B83A1025727C66DB292AC66426EC5447B1F52C0A4B73EC48A2166C575EB0,136,120,16,0.31731050786291404,PASS
1CA98C617579D05782168448622A412CCEEAD8B5B2AEA03C26C4340F64C26A82,146,110,36,0.024448945310089426,PASS
7CE272630C8262ABEE4910A25A8CC2A70E81B8682E629C0BF3B5BC8A1FA5C86F,136,120,16,0.31731050786291404,PASS
F6520BDC666A1D2E33F8D387624D5C9BDFF58F842F943E0A1C0CAAB0019B4FFA,125,131,6,0.7076604666545525,PASS
900178134892C2DD93CCF5AA27F29872FB72AD3CF47020FB18FD3282AAB49B6B,130,126,4,0.8025873486341526,PASS
85DF1C8E3BAA931D77E2BE849CC05F4F8272900956099CDE69D5EB8BBEE99195,124,132,8,0.6170750774519738,PASS
B6A1C8FD4A443096B27C278DC1CE2EEA27BA5937E98759AF745861010B3709E0,132,124,8,0.6170750774519738,PASS
A8E396F4DB5F7DA0A137A8A559A62AA7F92D8D2293D9B1D39D01CBCC458BA670,125,131,6,0.7076604666545525,PASS
9D53AB705FF39818F6C576258F037FD224471D746B161F6629980182ABEE8815,130,126,4,0.8025873486341526,PASS
2A0D8632F1CEF65EFA8ACC3B3BA83A3ABA63FA85535D6F1093158BB163B7138F,122,134,12,0.4532547047537365,PASS
7902B99E7BB6AD889626DB219E3C40633612052B52B305B5046AD5D1B22E1E58,137,119,18,0.2605890342736178,PASS
1555FE99F5508A27E01C310D18E9483D21FBFDF492E25A013F6713A3C4794C46,132,124,8,0.6170750774519738,PASS
44BCA1B1ECFBF87ED40C9B9FC9F13F2121604E675C14C0D0D95926BDC84CF38B,127,129,2,0.9005235503397743,PASS
7131657EE7AEAFDE2094B8C041272C58EC396F5423AB2331BF367092A69714EF,127,129,2,0.9005235503397743,PASS
A1FC427FFB8657F2A36E58B4B0B547DBDA179E6230D6F35B31C4609C65FA0CB1,121,135,14,0.38157390570502125,PASS
AAD48D12E333FEFDCB0165DFE8B8A5EF5ED3BECE5DD1D24E1BB2778250303E50,118,138,20,0.2112995473337106,PASS
3A084D616FE243EE324C463E27B0E0F2FDA7524B379C928B7E071094D611AA3A,133,123,10,0.5319710580974012,PASS
D1AF492A23BC2087B677C4318944694B0309AD6CDDFFECA501FB35B59EAF53E3,124,132,8,0.6170750774519738,PASS
F3F07D0971342AC5DA3D1B35904864BE81B53F1A3D0456C65664AE8A826CDFD3,130,126,4,0.8025873486341526,PASS
89DAE859C86176844B48DA1E95FC9C8A93E45CF8E9BF0790A902ABEDE84555B3,129,127,2,0.9005235503397743,PASS
F6298FB789AA6EC0524161869B1ABF8BE8803973B83B39237835B41CE5F69358,129,127,2,0.9005235503397743,PASS
20626AB8B86F2E9184A1D40491314EF5021CF767FC9ECB0BCBE735B5122F720F,131,125,6,0.7076604666545525,PASS
91372E848577A02AFE2D17C7846D82BCB7E666577A8D99358D8DF54046E79B14,126,130,4,0.8025873486341526,PASS
FE4DAF10155F3CFDF9DDF4C867D1D9A200C1DD0D6DA4C91937C8A57B9E637FD1,116,140,24,0.13361440253771617,PASS
D3CE279466B0AC4CC6A498E0BA2FDD49DF6219E41C50F79D511AEE4C12C2A944,133,123,10,0.5319710580974012,PASS
161A27805F4FF357C570A28F04F36D889A65D49145358F08D879F110825494C7,138,118,20,0.2112995473337106,PASS
7B631F75F2797BD4910E48572BBBF1429B60800573F034B371B91C386188211A,134,122,12,0.4532547047537365,PASS
9A3FCE094F41F3C47617DCBAC36F48DD4FD709574163D964B994CCDD23DCCAE5,119,137,18,0.2605890342736178,PASS
5EBABA72255BA69DBCD5ECED2CB2C6FF1A6B5FBEC9791A6E24374F92D76F028F,110,146,36,0.024448945310089426,PASS
78411C04A913E1F96FF32AC5CB5FB48A1CEE7AFF582578E5E595E3D80AE540D4,125,131,6,0.7076604666545525,PASS
EE42190F11C0DCAF4AFF49FD26955CBCCCCAEBF4A3AF4A52E0D56412E83A57F7,121,135,14,0.38157390570502125,PASS
B3AD809A95932B11F2F761CC920A7A5A6B1DA80127645BFFDA98645EAF7562AC,127,129,2,0.9005235503397743,PASS
3C3A695962F2C6B3CE3DE7D10C45FB9A003B52A67393853397A0090DFB553793,127,129,2,0.9005235503397743,PASS
5E7369D1A1349DC937316C990A9881F84992D80CF083DCC4C471E3FBFD34C302,134,122,12,0.4532547047537365,PASS
AC254FC6885F178DF2759629C74B604F73C9F9704EF35B5E7DF060AA812F39A5,122,134,12,0.4532547047537365,PASS
7359342F059777704D592A33F84F86A942BB6AD6F3A15C812EA75AE5B909916E,126,130,4,0.8025873486341526,PASS
2919CCFBBE012F852F84D1EE272BDFCA7FD4C1606979F244205538DE9CC19589,128,128,0,1.0,PASS
90FC06A8AA906F0AEAC86D998E17A936254624238D8BC0C5F8AAC2FA47D94F0E,136,120,16,0.31731050786291404,PASS
5A88D893F9F6BACB210BE54D1DB6DB64C3FE71EF4A3572184A09389E082D0B9B,127,129,2,0.9005235503397743,PASS
80AF12B8C89D9420499F0A3F5CC76FA78406AB58CD167EBBD40B07E024D911B7,134,122,12,0.4532547047537365,PASS
594146A241DB423E7E62A3858AD3BCD473E26A6F847030C563EE4D648B68185F,134,122,12,0.4532547047537365,PASS
2F0D9B6AAB681ED81B5802F625B0B27EFB00365404FE050C24DFC7383DBA8EDF,129,127,2,0.9005235503397743,PASS
56E94396D2256FD061A73E76D1A6CCD823FFF10912AF57A30BBBD8889B6FD33,122,134,12,0.4532547047537365,PASS
6EADBCB0E200F15372BA078AFABAF6CFB77F4238D528A162C10ED401DE3FCFF7,120,136,16,0.31731050786291404,PASS
25819211785B8576D3AC635B8527B3B8F3CA2A2DC2C59DE1B11D1D5A8EA74E73,128,128,0,1.0,PASS
C8EB53BF75D6D351A19FE0A74CB529B153C09519C00E2427B80443AD9D5BF0FF,127,129,2,0.9005235503397743,PASS
871B524987F6019BCB5C71022D21AA20BD59E602B6EE0BE55106C8AD3D2F070C,138,118,20,0.2112995473337106,PASS
E81A9F13D54502125D5AC2A171FDDA8077A749FF44DC83AEA553492AA9297DB3,128,128,0,1.0,PASS
CB9AA065CE20EF447CAAA85CF6A9374D9FC1DDB89664B5039A1F5270F66FA9BF,120,136,16,0.31731050786291404,PASS
4981190304410887A56E6575B8DA2F7A9CFD8F98D346DA4BA77BA93CD22FBEE0,128,128,0,1.0,PASS
6F0286592D2E7B692E839C91FE2525E8F597155258BC6A50215482C5FD5CB0A5,133,123,10,0.5319710580974012,PASS
D54252B0A4C8CAF01D24BDA55362B7F990C10BDA974514B81D8C0BE9AEA9E04F,135,121,14,0.38157390570502125,PASS
3C757E3EBA7AF152811A8A57FC4BA85ACD4582EC70E744309A4E9814CCD6BBB5,127,129,2,0.9005235503397743,PASS
86B74AF01A27F43C0314B7D6D2A695CD3572DF4C92FF82005654502A212C47CE,135,121,14,0.38157390570502125,PASS
D194D5CB7814A073885F82079E3AFD692C53744BFD4041DD9E2C0CE7E9B78F42,128,128,0,1.0,PASS
F39B5F958E576C577D2ABB0870FED5F45F67273C3E4B85E785058F6C4935378C,115,141,26,0.10416255883043901,PASS
,256,0,256,1.2777508801076536e-57,FAIL
F0B043F9EDDAA6FC8DC63F6BDB7446F074378F0D98193BF5EA66067855F40126,121,135,14,0.38157390570502125,PASS
AFAACFA2D9BF32060EC88C5EB968B61EDD3B4DF202408BB9A3C983E91A9DE060,129,127,2,0.9005235503397743,PASS
23516CD7CB8CD4FDA61FED8BD2EB591B5459E35D3923FB07D535E76B62E77736,111,145,34,0.03358661289689768,PASS
A1585327B7ED0C2FE91A7149A93131E16A7A155C202F390157F966960CCA8590,137,119,18,0.2605890342736178,PASS
F2287124849D5023B07D0F423095744B15AC1B301B99ECC8FB52B68F6A6B3947,136,120,16,0.31731050786291404,PASS
7ED6F822B2854CFEF151FB074033F9474A88E75C26193C188F26BC1A560A8EA5,131,125,6,0.7076604666545525,PASS
3EA6740902945E52A5C880421408451280C94CA7D944AB1AD107ADF70FA26C77,147,109,38,0.01754895019147673,PASS
B790EBEE13575DF615918E25F9DC37D2A9034A4D5B7110557E5EC6331F60E72A,122,134,12,0.4532547047537365,PASS
C720935D001F1EAC07B70509C005F6F7CA125C496AB6C2BB73193F013F353D70,134,122,12,0.4532547047537365,PASS
BEF7E7EBF90C0EC5C066AA3348ED844D7C31EDBD09ECB084425FFE60DF77204F,120,136,16,0.31731050786291404,PASS
2C750E9D6A2874EAFE7244530618F21624FD76CEBAC7B4828C073D0D043425CD,135,121,14,0.38157390570502125,PASS
4C5A0A3621A5655C0FB2B5C4347EB672BE7978C1311833D3985FA87E05412877,133,123,10,0.5319710580974012,PASS
749082A17EFB1CA6D3D8A9A64E3F40204DF653547D899E3095543A42EB468A74,134,122,12,0.4532547047537365,PASS
47E0A3C603A6D911553C6EB852A163496DDA5832FA739A84F4F8F3A3010A08D6,136,120,16,0.31731050786291404,PASS
67661F93AE498206466E4A5A671C6C03AB3B2B19E3D099F09247E433C65FA7D6,129,127,2,0.9005235503397743,PASS
FBC156915C357CA8D3C8322DE4AB3AE0732818479DC3910DAFE4515814FC2D47,132,124,8,0.6170750774519738,PASS
38399A6E0C010DD7D2EC0CDE2EDB0EC3D6D16DAF8F590AD7C1F72370415B3FD,125,131,6,0.7076604666545525,PASS
45F1DB17C712A8FC5591BF66DEAA2C328D9C3FB10C0C4DE440233F65E9B6409B,128,128,0,1.0,PASS
E488E12EABCFBC34DBEAE40B7DBB0233D6AAF3AAABD4AF2C25057BE2717A834D,120,136,16,0.31731050786291404,PASS
3488D61494F9D3B84264B786DC16912B01298B8954F421822A18072FD64129D3,146,110,36,0.024448945310089426,PASS
767F27074470B3A027444A1569A4F1EE7A5F6A6E6FA0FC6BECDCA0BC491F21C0,127,129,2,0.9005235503397743,PASS
DA88A1B9882558B4C8B29E04D7717E5FD433A29497FAD8FCA050F26B1124CA0,137,119,18,0.2605890342736178,PASS
B9E6528B2CCC5435F040AB15C004CCAD48C1B0F65B915AF4A17F7BE316101CB0,138,118,20,0.2112995473337106,PASS
7A03128EF0DA6ED62C97C664878C0C114B0F8DC47ED3A6A5C710E418C78B182A,138,118,20,0.2112995473337106,PASS
9A6D0E66ADE131C03B6BFDCD1A2D26716BB6DC90ABE1E3C5E0AD59D18506E65,127,129,2,0.9005235503397743,PASS
653EC1648E4D6AB268FF03F57544BFA8062405DE7C1F072275ED80D10773CB1F,128,128,0,1.0,PASS
AE46C1325AB02165A7B18EEAA9157393EF02AF9FBDFCDF4E16B7457EEF4245ED,116,140,24,0.13361440253771617,PASS
73B8A2246286E1A6384FA9F01FF4219929AE0988DACEC81E9B37D8816E953317,134,122,12,0.4532547047537365,PASS
E02AFD9E8D9E521970D3B9B8829D9A7645B46D59426758094F2267AC67ADCBBD,125,131,6,0.7076604666545525,PASS
BEDFBADB414A8149CAD871ABBC40E0ADF38FFBFCBF50380C3E79F8BF10D4F907,117,139,22,0.16913144470267139,PASS
739AE92C204E3F437D14D0BCB990AC83E153431FEC244CE1370ADA0EE5B57AA1,132,124,8,0.6170750774519738,PASS
9B02C76293AB3B07D9D9F5815E0890929E8995A8A5E6FBE2787297A314F432B3,129,127,2,0.9005235503397743,PASS
EDDC72A3D96E9898339FF6A4061212DDA62604D01B5072F5C802A8644FF6EB30,134,122,12,0.4532547047537365,PASS
751FD278CAECC859149B08D3197F3F20D2AEC7136625A1AE20F15C91CFFA576,128,128,0,1.0,PASS
76F2CE07DC77D72D4FE8F083454556C6317B59F0AD3BB88E70E2B796FE5EFD39,112,144,32,0.04550026389635853,PASS
E5A372A147330C4CE1D44F326ED9979CE2857E39461C85FFFA116B0B487B4943,128,128,0,1.0,PASS
DB9D790DEA492CEAC1EAA1644393E787603CA361AB821E489993AED90E8C776F,128,128,0,1.0,PASS
4A4DAA88371D853E511CD9EBB3BE639ED5BAE254FE5B5FE27BF7F83F761E7D1A,108,148,40,0.0124193306515523,PASS
5972BAA2BE9DD963F536FFE22EB9C7CB4204250F52E8AF9D140A28183CDD538,128,128,0,1.0,PASS
F2466A25119C7DF27420C1E875E7CBE019E1AB49D8E4D58F627ECA43F3D5574D,124,132,8,0.6170750774519738,PASS
6F5D0477E681EBEE49E8B7EA6C07D1B632B96BEB9EBC91BC2C6B856A1D9D0D8B,117,139,22,0.16913144470267139,PASS
FCC82BE0140580111893E3B622085468D4AF897D1B49358593948D6BFE5BEB8B,137,119,18,0.2605890342736178,PASS
8807C3DD98DE38B8BA3ADB5844D915C4DAC3C4793FC8F5887834F3DCE51F3337,123,133,10,0.5319710580974012,PASS
F411262970FF182FC4074C948BEDE4AB93B907E40B227A802D8C36368F841311,140,116,24,0.13361440253771617,PASS
D9BC952BC5F9BC25302BE56DD20178B1B018ADDE69DB7CC42D79E409C64BC24C,128,128,0,1.0,PASS
51C5C8879720C06A8BCE657218326B7B9085C9E3258EA11097FECB99709D9C72,135,121,14,0.38157390570502125,PASS
384F6FA2FA7441168D23C21D0A58194B29970C9D3FAD0E697ECB31115C908A8D,136,120,16,0.31731050786291404,PASS
A3D81BA9ED2C6A24FDE661CA774BE717CD91467C85952251C1B2747E6B7BBFED,117,139,22,0.16913144470267139,PASS
C5F13DA4C8B500D1F0132FDB75ECE0385C35755200F28FBCD1E4228951360FB,135,121,14,0.38157390570502125,PASS
BB3FFF458ACDA1A0EE28269F0681462E5C30297D0515B8B25D756429CEEC3CD2,130,126,4,0.8025873486341526,PASS
4430FBB16115EA8C8DC673BA787079F0E05802F10C26457FE068594D2188A597,139,117,22,0.16913144470267139,PASS
2139862F3A8B18607F9AF6A7B0B2F9ED33F15332916408F451EA00DEF00CB8D7,131,125,6,0.7076604666545525,PASS
,256,0,256,1.2777508801076536e-57,FAIL
9B2093B599FCF768E9F5011AD242AADC5DA720F2BFF60CD5898A2FC7D87F567C,119,137,18,0.2605890342736178,PASS
D550A127BAEFF4466198E2362AD546616B374FB4ABDF1F840BB994815A15E5AE,126,130,4,0.8025873486341526,PASS
CB0748939A8C4148B2EA4644910905B823607A302689317DCA3EA40054A97038,154,102,52,0.0011540500847815347,FAIL
60D09CAB8271874628D3ED71B22B894B81814BD3B0EDF04C5E125CD6E25DD496,135,121,14,0.38157390570502125,PASS
6FC281B4E1C754692EF421DAD26DA312EF46B6551F4A721B37153D79C61C2FC2,126,130,4,0.8025873486341526,PASS
5082C0915438A94EF93BADDA732F5960337BF46C48997971E35F5A76E09B7B1F,123,133,10,0.5319710580974012,PASS
7993DD5C6ADC3130C61C61E5CA4B79A65DA31E00C590FDA96E4E090B6BDD0C5,132,124,8,0.6170750774519738,PASS
A934CE1D6D94AF16FAD4A423B073B926C4669521F53CA9628D570AAE83542E26,132,124,8,0.6170750774519738,PASS
A269F92F16BF37C44C86FAE321F869ACFC3F6CBA3E142DC56359AB49E3E77F6B,113,143,30,0.060792723530522785,PASS
2671ABA8FB80B34101C04874C98DFD1B9DDAA86241779EEBC03691447DECC1CB,133,123,10,0.5319710580974012,PASS
29D8F64BC6CE1E5D6482A8D08CE8D22777AA79B603938A2A36CAA38250F604C3,136,120,16,0.31731050786291404,PASS
44647ED0069996433B727A343D057405B15D9AE6AA5598AFEA300A465C47DCA,137,119,18,0.2605890342736178,PASS
55576C8B9343BB054898F67F381CBC0099498E54A9D9FF674D01DB5A6E91D278,128,128,0,1.0,PASS
83CD1CF3093C5EFA310F4BDEECE2330A896CA9D62BBFE4948439DD6264187075,128,128,0,1.0,PASS
1A12AD9295F20E4D2A3D5F98136A914D3788FECBF5E5915C3D8C943C76101F4F,128,128,0,1.0,PASS
1EAEFEC5785464F4F8EA3938AA10B8F51A9108EEEB5CF84742A460950C575065,133,123,10,0.5319710580974012,PASS
C0FFAF0B90B463C0D9DCE333E53D22DF18B6A437CFA0F44441853679994915EA,128,128,0,1.0,PASS
BC6F973B903D59A7A6815330D99E47E39E3B3256B68B6946E3631F2E099467,127,129,2,0.9005235503397743,PASS
55AD0EB2787A8FFE2B411C0B35EA5771CA804EC6774C643A46FC0056554BF11D,130,126,4,0.8025873486341526,PASS
35EE77E55E8CCB5A620B9708335AD6681199BEF28BF676AD252C72A7007121E6,127,129,2,0.9005235503397743,PASS
81F637A8F9FD5DCD45D99E4AFADA152A1497C62D8000E2FF30267184F3E540A0,131,125,6,0.7076604666545525,PASS
52C12DEE34980D8C1C700ED46B7EC499D7EDDD41C334E8ED5406078A0D49F4B8,134,122,12,0.4532547047537365,PASS
6CE2EF4F3A3C29FFB66AD17ABB2D1283F03FF8D1E8C78602F8EA4F04A1874D48,123,133,10,0.5319710580974012,PASS
18252449A4AF4EFCB7CC3000887C8DFE9B737E5C9531BDEA1AD90A868D1D2B9B,129,127,2,0.9005235503397743,PASS
4F63DD30C914A300B37EB66340D949C9AEF7BF1A041F8E2485C214BF5427F2EE,129,127,2,0.9005235503397743,PASS
106D97430AED108A18097E9828315B046B74A12F07EB82412FDDCD0E2BC0A55D,142,114,28,0.08011831372763423,PASS
13855104500592160C79C630216B200C9FD18A6575D77F0E4351A12E77760A61,146,110,36,0.024448945310089426,PASS
F0E8D22E629BC513FA993FE646791BD6F67ABB833F6145E9199DA69245FFAC6F,114,142,28,0.08011831372763423,PASS
A12639DC48216F4B3B1875E7A04C1E605F9544538C3076A2DD59BA39C2D80568,138,118,20,0.2112995473337106,PASS
DB2AF4EE355A16F0400AE2E50EE3F512ABBA1349693A31F7FC21E17079056939,129,127,2,0.9005235503397743,PASS
306071539D3107B2B4C06823CF2FA820E3089EA4FB624954055B7EDBCEC8A734,137,119,18,0.2605890342736178,PASS
6DEEA44137D14195DAF677DAE1EE9409F2056D71FFD36B3D7AF29A34BDCDC84C,115,141,26,0.10416255883043901,PASS
4A991314EFCF1C104E202955889E19F2EC14DB95210B061E8F1FDCD71BD045FC,135,121,14,0.38157390570502125,PASS
77CA45071988DF77D3F20408B3C5A148511F18FF0A1D98268E0CEFA2173E5EF,132,124,8,0.6170750774519738,PASS
A57EF4DB036938E664910003E602731FD9348BF822386F616553B80371F86BE0,135,121,14,0.38157390570502125,PASS
186A193DF39860D0B4BF2282873B63FF07E5FC65CD824BB97083A3A31D277BE4,126,130,4,0.8025873486341526,PASS
2BAD4817BE721791CC34F55F31916AC9AEAFFBA20B28BA339E3AC3672F737100,124,132,8,0.6170750774519738,PASS
7D959E35E8ADA0DA9EDAFE6DC222A91096AC7A8A6919CC7444A99DCC78B2E111,129,127,2,0.9005235503397743,PASS
F0083FB1FFC757CFD1595C83F50026C4D5229FA47CE59A658E1B6FBB02378727,122,134,12,0.4532547047537365,PASS
D80BFE682630BAA5B3E76DFB892C054AFE28D9C0D7A66833E06E99FD82ADA21,128,128,0,1.0,PASS
219C1FB3D4F63422B7E6A57D4C37A31B9B2BE8DA3CD06DF591AA7B1A5B09A4EA,121,135,14,0.38157390570502125,PASS
19B3072C3D72FDA160F1EADC0DEF965C9C1497CB82234F11A3B75345EB474B8,128,128,0,1.0,PASS
1608E1D1932E5BC38785D4862F2703A7D199DC4E9501321B8CB3A590F4601F94,139,117,22,0.16913144470267139,PASS
F8B85CFF4C0D42EFDCE33EB4843D6BBAD338ACDBF0D9C4DAD40D44707C8B7A07,120,136,16,0.31731050786291404,PASS
C019C1C8CBFE0BBC7671343900CC53CE7E5D879244FEAC7F9D8B20C6BFEE0D97,123,133,10,0.5319710580974012,PASS
B4B29DDDB4A5AC902D15D0E7F661038CB98A4B7BED3A7FBCDF17D1F5C3A5D519,116,140,24,0.13361440253771617,PASS
75154753A2B776FC7F0674656F3EF9AA985070D1486DA64D03A78C25EF1FA9B9,121,135,14,0.38157390570502125,PASS
EB49E5A63BDC4B7F8F47B1D5367B6F8FA76C269C4544500701F6A9D5A85E9B6E,118,138,20,0.2112995473337106,PASS
943BABEFBFF1D2FB3AED41A463880FBC2AEBAF2E2FB7AD14B39BFC8A1D8E0EDC,111,145,34,0.03358661289689768,PASS
B72B4A83B070911EAB4B11F93EED2974D42116FF43D9B20165E60B0CB4E20912,136,120,16,0.31731050786291404,PASS
44B477EF9363411FEF1DB751BE461E3C2AA8A243CE0D1F00760FC2E08E396664,130,126,4,0.8025873486341526,PASS
87FA14B41C042159B171072912EC22649A6B95F78A2F4D20A10557B731DC08E5,141,115,26,0.10416255883043901,PASS
25E940683FE7565049AA01DD5A8A3A207305A5F0A58BCC38C8A1F2E77C16C445,139,117,22,0.16913144470267139,PASS
B534F3B5F486A8219ED00118419A4BC2385DAEADAAD17C2EBB60E6C1CD64F428,134,122,12,0.4532547047537365,PASS
A57AE5824A6DB7D4A38773D604CB43AB28F92655011FA07996F62A6479612811,134,122,12,0.4532547047537365,PASS
D9860B9108371FC385AB31B0767D5ED0B405CC433B9381EDB52C0EAAB6D021D3,134,122,12,0.4532547047537365,PASS
64E91AFAA6165975E3F62965E463625492E933A6D5C4A3ED6C068982FB49C8BD,127,129,2,0.9005235503397743,PASS
225D52608579FAF86245056E2916D107334E54F4C4A69EE44CF90FA33F79BA4,133,123,10,0.5319710580974012,PASS
FEF0FEAB5A6689E47F1E84C5CA7281E3B84691C4BDB0AC2A97B6D3CD6569967A,120,136,16,0.31731050786291404,PASS
140A7E961E05B378538553B9029C4A9899606C78C0838B002E33C84DD7A058C3,147,109,38,0.01754895019147673,PASS
77B70EF39F1979263149E4DC3C013B3F205CBF06E72458D6DD4B21D056121075,130,126,4,0.8025873486341526,PASS
E885B60442044C68D5506E7B0A003A344C69185A0B258C9F9633BAAC5B76083D,146,110,36,0.024448945310089426,PASS
36DEAA429DC83A28020FB75EB3E497CA2C9634F9827B81493E8F9F8DEE340BE3,126,130,4,0.8025873486341526,PASS
5AE7650808868F053F304EC56A8B439166FA6AB66B42ABF7004FE6417C9CAE48,134,122,12,0.4532547047537365,PASS
9DF3B8EC713FB2A8B4494667B9B4F8D8CB17745A5CCB7CD8A470EBBD8A596BCD,116,140,24,0.13361440253771617,PASS
6347675059CFFE6888ADE9F00B67AABE0193656F9D7A4D8DC9C7B9B3CCCEB19F,116,140,24,0.13361440253771617,PASS
E37EDAD0C5EEFEC380EE505247A7410A06666E4A6A61761B22BB8FF455CB331D,126,130,4,0.8025873486341526,PASS
DCE1C8D0D4D43B55EF9A4429A50969D5F6839E5FB2BE67A5F4068DF77E126FE2,118,138,20,0.2112995473337106,PASS
504AAE9A4E1AED6D9C0F767E34AB9B62C91C70EB27A32651A61236CA916579D1,129,127,2,0.9005235503397743,PASS
AF11DE0ECA130AC3C71FE940E33480329F2BAF5607BA8328A80281A74D822A1F,140,116,24,0.13361440253771617,PASS
8394342CB7A883A9AC117061DBA37907795AD734D5BB71C8331673104EBE4BAC,131,125,6,0.7076604666545525,PASS
BABEC49AF242AFB83A4DB15E6753F4046E5E40DD5E069CEC16D1772762B63791,123,133,10,0.5319710580974012,PASS
575241B1151AF8761231B13F5C0E595BD1E384AA1926D14A1AC726C59436D6A,138,118,20,0.2112995473337106,PASS
59A6823DA94B584820779FFB064BF001C9F40FCC2EF46715DD9ED42EBF153C80,129,127,2,0.9005235503397743,PASS
65B81FF6C78048DD063D83892F7EDD523ACBEAC00C38FDC3DACD2BC7F35442B0,125,131,6,0.7076604666545525,PASS
403412EE5042B9082E0264D78B46F8FA97E237E478DC788A92C7E8E829CAB86B,136,120,16,0.31731050786291404,PASS
8FE3AA96452DA4CFDA9ACCC4D68C99060D3B5517BFBC985ED5C8EB41C3FE8FE5,119,137,18,0.2605890342736178,PASS
67F4DDC14D28A01CE429E584B7B605A8DD16C3F08CB32135CF63607CF7D3E8E5,127,129,2,0.9005235503397743,PASS
2DFB65DAE22DD1B425FF3C88ECD536870D31052C1E1F175567C46C96925E32B2,126,130,4,0.8025873486341526,PASS
783A9D981C1E84046842200B2A189A2BCAA795F399BC2B844C87098D658A9898,148,108,40,0.0124193306515523,PASS
1AAC94CD4654F532F0D4C6837736AA935D08BAC410EDE3A1E8DBA5AFFBCDB70B,123,133,10,0.5319710580974012,PASS
9AA9700EF685B224DE66A2108E6468EDE95CA93BAEFD1746B0CD27DEE3B84B93,125,131,6,0.7076604666545525,PASS
F3F10221367D7C41C44A1F187B5ACC2DA6A7DF11071605BC0DE7F87669BB5FF9,122,134,12,0.4532547047537365,PASS
8E288D21872311C0B0A69AB1221C7F8AFCAE75D7BBD7AEA13360E8EA20DCD88E,132,124,8,0.6170750774519738,PASS
2E477E5F678D45A7F28662FB544EFA9941EE47D04F67ABB062E1232AF1B00826,126,130,4,0.8025873486341526,PASS
C776035F6F91A08D6FB45BF16B7DC6D563AA42F8EBD1D6CF104C087A42660A4A,126,130,4,0.8025873486341526,PASS
1B59937EF5C196DE5A34DEE80BA2823A6B8A575CF07443EB3A0F37437C34D01E,125,131,6,0.7076604666545525,PASS
909D12A2E458F679381D1F56E636BEA1EA138E486516849513A5C23E07DD3487,134,122,12,0.4532547047537365,PASS
165F3D0A85053A3EF0B1157B65B67E4C51A5295A21016B69523EB426D7B75C5D,129,127,2,0.9005235503397743,PASS
3BC8F3E870CD41820601D82EB5AB45C45998F3A1C2A44BD7138AE2729CB138CF,136,120,16,0.31731050786291404,PASS
315FD70FF527B630366362294AE3EBBD29022AD830B7406736FD16CC044C7F7F,125,131,6,0.7076604666545525,PASS
D9375424285759225FF4C0F44A4D91C85F2BFB0F815B86C26CDBBB58AD0661AB,129,127,2,0.9005235503397743,PASS
393F1853F28BFA8E508BC0E6E6423100005237682262102EB362423FDD2662D5,144,112,32,0.04550026389635853,PASS
B720BA055A6C3285328B8FF7E12B318053EDC893D67BCEFCE56C2A2ECD5D988D,125,131,6,0.7076604666545525,PASS
D2567ADBD4600DA335B00856145645590CAA92E63F1B4C0CFCB1154F9015100B,143,113,30,0.060792723530522785,PASS
7447DA9B98382CA6E1A3DE96914F6C7A280D116575DC547EEAA5E8974CF9EC46,125,131,6,0.7076604666545525,PASS
CB979C8C2F473A342C679976F90D7887D721DAF6ACC854464AC81272BF0801CB,131,125,6,0.7076604666545525,PASS
7FC677BDC9454F95AB7494BC0FC416EF2CC5628AA4B20725315066D35CD608C3,129,127,2,0.9005235503397743,PASS
8B11363516079F7A023385A6ECFC75AEDC8AFAF8728D8CF54239ACFA85EC4BE1,124,132,8,0.6170750774519738,PASS
B336083EE04BFFE283D5B340A0DD4770BCC3ECA2B5F5C93B701767658EB294EF,122,134,12,0.4532547047537365,PASS
FBFF6146D23D561688BB50FD2A5E945AB8FD39207C508866C5F1FBB1C0D1E92A,124,132,8,0.6170750774519738,PASS
E29B02028F9E2DEC7D4A71D5208E7373636BE3A5945B0ACAC9B74ED340DFB5AC,125,131,6,0.7076604666545525,PASS
499C47BE6375DE3AB3FD4DC048BC1116E740A9BF50C5AA20F8DF506FE480425A,130,126,4,0.8025873486341526,PASS
FD80381A592F0DED46D2FAD71D4B46EF3D3A2F263D27BC3D93DB6768C4D446B,120,136,16,0.31731050786291404,PASS
7379DC8AB7A16CAB8595D4D99779B11AC6CA466D53B441E6DAC8B41B6E7B1456,123,133,10,0.5319710580974012,PASS
FB764C1251517213A256B9A41656E92B9B4BB25B43CF282E0F2168B62E2AC29,136,120,16,0.31731050786291404,PASS
C1E8AAA8782F8D8147D7612E7A95CE1A887E9142FE71FF0E527A10E95EDCF455,125,131,6,0.7076604666545525,PASS
C544612AAB07FE53BBC851A455930096878446570C2105015A9F0C7DB83F9132,143,113,30,0.060792723530522785,PASS
6E8C88C1ED84F0A110D6ED398948FA3995040E8763F4BB72C23EF84E0B51C081,139,117,22,0.16913144470267139,PASS
81B3ABEE4F8A6EFC6F53D8A9BD63D7F7B81D1BFC47D69A3D3059583F19D44A16,114,142,28,0.08011831372763423,PASS
CF4D095DB91F858297330669447CC6F7B4492C58773BF64B6C53EDDA9266410,129,127,2,0.9005235503397743,PASS
2A7F7754672E0AB50DB7F39ECDAFBC43348909C025438582FAB5B3215CFAFFD8,121,135,14,0.38157390570502125,PASS
126D0F441D87C9EA523288F02A267AA6CBD6C38E08315E974CBF856F487D3B73,130,126,4,0.8025873486341526,PASS
867ADADF47F8503A8D9F58F41D20FEF67C31C225526F5EC8079BEEFDFBD4CD94,114,142,28,0.08011831372763423,PASS
C21EFE4507FB1632322CCDDF50B64F90ECBF16E3F69BDB6514573A8880B7DE29,121,135,14,0.38157390570502125,PASS
27F67C489CAF32259819BF6C887FF3A7E6D3E83190E40EB01253F87503DF0760,127,129,2,0.9005235503397743,PASS
2746617461BCD4A8A7F8968035F46EFC07D7305BA0E1E665D315EEA80761C383,131,125,6,0.7076604666545525,PASS
176F50F8E68BDE998EE2F718DAF02520A6FEDCA66028FE370774B8D8690AFF06,123,133,10,0.5319710580974012,PASS
9B93B5779338B1BF21C692F841C188274C851C18E4A425EBC4A5DB65630861E9,136,120,16,0.31731050786291404,PASS
661BF4B1CB63BD390696D43E72A94684D67FCC12DB71170352DDC7DE8BD49A7F,119,137,18,0.2605890342736178,PASS
977D2C68227528EAE299EBB85A14248F710AF935A20CD4AF44DE5A2DB6653F,132,124,8,0.6170750774519738,PASS
43F157190EEFB1EDE7F4DDDF0CB8FCCDBD33090F2CC3C9E6EAF2589B0E1E357E,112,144,32,0.04550026389635853,PASS
392EDFD2A3F95294D058D1CAB68AC62109EAF32D877A58ADB49288D13BA8D1E9,129,127,2,0.9005235503397743,PASS
F123DE96C49B66F85C05456D317C920AEE3FDA28041BC8CF7119CAC8FBA16E29,129,127,2,0.9005235503397743,PASS
F212F11A5743A55034D676BB72E5459BCBC9F1EF1862D4FD918921DFFE129827,123,133,10,0.5319710580974012,PASS
660A0E64E75DCB82ACBF101FEB82A7048CD18A4AA538FFA4BFEBCCCDADC371E2,125,131,6,0.7076604666545525,PASS
3DDC5EFFA54DB440D2297F3C1C1D82B308DC73B80243CD826C29E359EA41534,134,122,12,0.4532547047537365,PASS
865AE72A8C146779C811C91424F00021B2DE7DA772B8F5B1A0B3D10B66F45409,139,117,22,0.16913144470267139,PASS
3A41C6801D51B334DE8D210DBC6B3B6F2684FCCC97CA9875C7F3936F399931A9,126,130,4,0.8025873486341526,PASS
98AD7B985CD2E8ECB1C2E51146699C29F4FEB446CBD679B1F7A2556250643C8,129,127,2,0.9005235503397743,PASS
4A0BBB5A7C89E2BFC7586F79B85DDF5DB1002A46BD4A7CCBB812870C3542B533,125,131,6,0.7076604666545525,PASS
29F575479638E707D5D4B79C3205CA15719BC7786F9C25003D40D26F30DA1F15,129,127,2,0.9005235503397743,PASS
519C57373F9A0F719DF5D51F5616028B908DF373283487EA948EE899FD599B04,125,131,6,0.7076604666545525,PASS
849E00A6E5A75CBAD0F027072DBB43078CB06286DCFF462CF8E2962E36A757BA,129,127,2,0.9005235503397743,PASS
6146BBBDCA72D85FDB8CAFA7D136FECA04F368B5D292C87FAA26B4E27382F878,118,138,20,0.2112995473337106,PASS
D948F2A03173ED8016F7AF1986643A855FA217DC0BE4D1100190EE46EDF5222D,135,121,14,0.38157390570502125,PASS
370EB8E6E0F24ED9314955FFE7C9877FC89B8E7C8215C87695A79544A2E0948B,125,131,6,0.7076604666545525,PASS
34AAA344D9E34BFCEBA7D8C8E83EDE1502A45697B7B889737DA8F0A95F270BDF,119,137,18,0.2605890342736178,PASS
54772ECA99200CBF7350A0519417C0AE9285988D57F83A0923BD3FB21F08F70,138,118,20,0.2112995473337106,PASS
94F5F917B270B933D936B18BC7B645F4C1206FBC3C3E2F51DC07F84881606ABD,125,131,6,0.7076604666545525,PASS
54340334904511FEE30C151C5ED8E9B5E39AE226B970303890206EB4F0D3CC83,142,114,28,0.08011831372763423,PASS
1A2CAE8DED766D3D2B875A0FA71CACE19164DA043C00091F8F65DBE1165582ED,131,125,6,0.7076604666545525,PASS
C8DB7483BD51651AF96BA65AA5389FDF5B0C2E77ADC37009CF1F6BAFF1C15B24,117,139,22,0.16913144470267139,PASS
2FB21A2A05EE996CFBB7B9763D10F2D57AB5DE2DB49AA43FEED692B1E12D9575,114,142,28,0.08011831372763423,PASS
669AB07801C7742ABF9D1CE7CFBA5C0BFEB7C41E18808B48BF0501291E53AE5D,129,127,2,0.9005235503397743,PASS
B66012C6934782A2EE4891FB3EE57857E13900CE125372F7BFF26A0CF598FCE4,126,130,4,0.8025873486341526,PASS
A08A7DD9A36674CDCF80E19ACCBF501FB3820446ADC58E1C719F0A8757592880,135,121,14,0.38157390570502125,PASS
CB358F21084E32E4DFE3860753B153D96D0153A50499E2302FB67F5D7901A099,134,122,12,0.4532547047537365,PASS
FF7334B815C76BB77161637BA9A9A2514CB9EDC50D3C1625F7992B16CD96CC86,121,135,14,0.38157390570502125,PASS
FD3B315C9646BF8D8E118A5F17656F0F61FEB930F835B68E5A4B525690E3567E,119,137,18,0.2605890342736178,PASS
950AD26B289DE163FD8CF2074F43CD010B55332A60ADCD17D99AB5174261094B,135,121,14,0.38157390570502125,PASS
602EB0995D6898CB8844BEDBA25E01E988AB54765F4689618E402E70FC8D72D6,136,120,16,0.31731050786291404,PASS
30E61092ECDC86999616B905085AB1C28F49C79DDE813D71B2710E69F1230F5A,136,120,16,0.31731050786291404,PASS
7EF99A079D5D1B42F8C65505CEA1B230A6B3E49AEAA899EB301DAA0E53CEA98D,127,129,2,0.9005235503397743,PASS
E887ED8508396E0B60F772ECC09006B44E64DA893FC10D13DA761F6A2097BEFA,131,125,6,0.7076604666545525,PASS
6B5CE8717DDAA95C455D30F8F7E3844FFBC36235B726F82762E2A7960CA48A97,121,135,14,0.38157390570502125,PASS
E902B36A1C9D0074C1B0C080752E4351CF9D4F5D484D7C98D49E7F48F043808C,141,115,26,0.10416255883043901,PASS
40CADA1A9A6CDDAADFACA18B2C6D0EFD526695765F97A95E658BDE7E847735ED,115,141,26,0.10416255883043901,PASS
DCC34B460DE8E1FB9B5281897EB5CDB70EFD99368EE7153FC8AD8552AAB06173,121,135,14,0.38157390570502125,PASS
64CA8BA318D40973A22218D91963806D6E5823EC5CCA1FE4DC4D57AD271AAB44,137,119,18,0.2605890342736178,PASS
E24C4A22554DBDDE569E0461EF91CA8ACFFD3FB305A1E5E53A679AC64351A0E6,125,131,6,0.7076604666545525,PASS
BD7026D2E314EB21455D90DAD0E58A147B221C15F24594F39BE015B470BCDF08,135,121,14,0.38157390570502125,PASS
6110E2C4F2E64AF52E854716DA067F8284F9307AE3B874EE68D8AFEF75C778C,126,130,4,0.8025873486341526,PASS
FC689DCAFBD019A8E4D92F642A253B1FB46B50A5D2884B302798FC0B8AC7A8BB,129,127,2,0.9005235503397743,PASS
73106CF5FAD372F9609763D99159EB0A1D4E1D98F8C19FAF919CC4685146DEF5,122,134,12,0.4532547047537365,PASS
6D0D5CD1B22DCCCF29544AB85A036A18AC682C155FD63B00326522939412F1E3,140,116,24,0.13361440253771617,PASS
5A4DFAE7A4EAFBA5D9AA5DA6CE69033FD2FDE51664DAC07A8A92B80DC66A1493,121,135,14,0.38157390570502125,PASS
57C69411B20F6865AEB14EAFE765DCBA85C0CF098CD9F52941D0FD2AC530D8DF,126,130,4,0.8025873486341526,PASS
3D058FE0F2DCEA220F4A152A54CA1852A400F98FC7FCBD6C66E823D26AC6133,136,120,16,0.31731050786291404,PASS
D400CA533D6091EFAF171A419B1278A346C78BB487400E154A6104CBFDB0D5C0,141,115,26,0.10416255883043901,PASS
7CEA3A48517D253B364FD15FB2833E0551ACD5C2C590239CA87047331793BF99,129,127,2,0.9005235503397743,PASS
82B993695905FF969188F0A036697824C5FBDC33CF10A43320A248AF5F3F1025,136,120,16,0.31731050786291404,PASS
4584F023F97AE05AFC29D4D55A7E1080C91433EFDB5956610B4F0419881EED91,135,121,14,0.38157390570502125,PASS
35C78ECDE6B53BE614015E35469BA1C2F38D1DA21A0BB55E3A3B9DD71DA5F2DA,121,135,14,0.38157390570502125,PASS
B7B0F0C58638FCF1D023514D771E9572CA8C82D75687FAB2B90CA22EA8DCF55A,126,130,4,0.8025873486341526,PASS
2F41926AD8AA0D93E74FD13C2A0D9C76E1C03F7D7432475D26819FA714CD0D86,130,126,4,0.8025873486341526,PASS
D182992F4FE731ED9A269D3DBDE30C9681581C0DBD9334478A6F435D21603E57,128,128,0,1.0,PASS
D5B444053523949EB8F0A144F438B63E5D4730043C8140D85D051DA7869985AC,144,112,32,0.04550026389635853,PASS
49F2788218D72748B3588076D5351097577E3180A7E81518E1166A729B4871B8,140,116,24,0.13361440253771617,PASS
B76EB35023506F02E590073D084AB29C0F610E30C508EF5EF1E7DB9B1D5B6372,131,125,6,0.7076604666545525,PASS
283022AB8FCD45E0D565859DB69E40ADD98695C416146F8BFBCB1750B0E005BD,134,122,12,0.4532547047537365,PASS
F30E61A9CBE3EF847DF8C7009739E99CA95AA4EF1D8CA8026879B332DC5C5781,126,130,4,0.8025873486341526,PASS
1CCA697A3F7485FDADCD1A41F93A9AF6C75551D3E4618F00B7A3DCA23ADADEC2,120,136,16,0.31731050786291404,PASS
674EE4FE7C2FA78D4E32004D6F6DBE1F83EF482D89EBD4688FFE285CDEAE5B50,116,140,24,0.13361440253771617,PASS
A8E1A16CE0B8FFE02BAAE87CB7A5C6132B665D34A596F84297B3ABD5B6D78F4B,119,137,18,0.2605890342736178,PASS
38E679F234787252AB156C075EB1843A646EC8F8C95A54CF1C704238629B5C31,135,121,14,0.38157390570502125,PASS
343B51959AC6A44412993E82FA45A1FC13E101479C2F91863E98F5F82304C9F8,138,118,20,0.2112995473337106,PASS
5F35C8C7D62173A3271E1A8954355CBB042A5EB3E8620D547CD210F4B2D4AF88,133,123,10,0.5319710580974012,PASS
F514CF16D40C678478D3D7B4543D048F794C1274982A44B8EE76C5541B6DA390,134,122,12,0.4532547047537365,PASS
D31FC019461FE714DA919839B212C70088491A3F7C7458931473C7EA20A86CCC,140,116,24,0.13361440253771617,PASS
3BEEF714D20D6BB82761C3408C70EC62382565FCCA97771EB897E2284CC26CD6,129,127,2,0.9005235503397743,PASS
2863D2663A9FEA49033E2B84271663B33344D20A2338E8B221B9919A3E52335E,138,118,20,0.2112995473337106,PASS
3DBE0A0791C59B060FD4048EC7E4A8142BFD4678AEA6E398BD4949EF8065F11E,131,125,6,0.7076604666545525,PASS
1F6127599F697EE7541A5E281B63AF4C6A46D9336E5902BD2C718842A615FB66,127,129,2,0.9005235503397743,PASS
68433DDF3F5BDB11A4A902186E819D6C29F608D590E04025FE50335E87F7A935,132,124,8,0.6170750774519738,PASS
F1258581B880BD21F42A889013F888155982A6F3606E63636317DCE8DF9F04F7,136,120,16,0.31731050786291404,PASS
60F35342AD0D35DBF7AC71DB4347654DDDDDC6ABDF0E02800BB3BDC74BB6311C,121,135,14,0.38157390570502125,PASS
938AE9B814CA227A421B9AA92F73EF12937E5A6836AB550D30DA64405ABD221F,133,123,10,0.5319710580974012,PASS
B32E9702A022171502C97E61F9751D4C210A90F92CBD26A22B3696899221D612,144,112,32,0.04550026389635853,PASS
998E0EBC7777333DDC9CB203EDF7BCB8744C95B8DDCBA4E60751502B2D3F4E72,118,138,20,0.2112995473337106,PASS
72CCCC6D6E5E2B009374577ED635F28A06C98A54D34916E728077AF8AAF3E4E4,127,129,2,0.9005235503397743,PASS
8C917FB590362340A45246AC831D899607CD3585B6727C56C0C3EF90BFDBA55D,131,125,6,0.7076604666545525,PASS
C0A57DFF64226DDFD924AC16AAB2A4FE6A1137276A97A358B77CA88B49E9845D,123,133,10,0.5319710580974012,PASS
E32C352B8139337588843D5E1748F69EA61A159872FCD63E7CFE572B0181EDFD,124,132,8,0.6170750774519738,PASS
C7105796AA2F7A96C72BB30AA7E1793A38FE16C8F05AF3A9918D86B5128B2C28,129,127,2,0.9005235503397743,PASS
335E861E076C00A2C8CC20F4E4E020DA94210925DFAEA75032F7C6E8A3654AFF,138,118,20,0.2112995473337106,PASS
85FB3773F218A882ADA71C3E2C4A555D8B6AFB49E6B52C6869B251EBE09FFF3,121,135,14,0.38157390570502125,PASS
A492F87395F87EFF5D74554CF30ABDF72E70ECE3667E822FDC84511F08D72F0A,117,139,22,0.16913144470267139,PASS
DB3F3F8311CA78B16F406ECFE8AA12695A177B919F485F0B61FF2E05AC2CD7B6,120,136,16,0.31731050786291404,PASS
,256,0,256,1.2777508801076536e-57,FAIL
C7030250920B396947960AF621DDFF2F202D2F1AB05C1851CFDCAA6C23BC5670,136,120,16,0.31731050786291404,PASS
7A276D81A6C5CDA483811914810D7AD09D38BF914AF5D05A9F11A688B15FC356,135,121,14,0.38157390570502125,PASS
15388D5C74E37AB797124FF9B22449E4DF188ED2205C799D1BC506F4366CC978,128,128,0,1.0,PASS
F8CD0CA34F6AF46D47FEEE6DC4FA4FFFC11A5061EE618E0CCD84458A999BE,126,130,4,0.8025873486341526,PASS
FA9DD0078A4F007BA5D95F166B8446B8D999201342A5F8EF83BDC12B5DB3434C,130,126,4,0.8025873486341526,PASS
AC3D3AF40DE6E8709721A772F40909F8230DAB59119AE3E1C1CE0C43900BFC8F,134,122,12,0.4532547047537365,PASS
533F62413489B7450F7287FC5EDC8487FE8FBB237F060416DCF91F066AAC8F71,123,133,10,0.5319710580974012,PASS
356E5BB81F0BA43EA829AEE15182B6121F370C8417387B7CB159FE542885B8E2,132,124,8,0.6170750774519738,PASS
3C7525F35C6D39454F1D91C8EF7903CDE556C9EBAE1FCDA81E8A8A6514C6460B,125,131,6,0.7076604666545525,PASS
79C49C84A094BF3D853E91F1D670AFDB954D4F6D7FBDE0B32C5D3129129DB26C,121,135,14,0.38157390570502125,PASS
94B6F78D9452DC92839810F679CF36F7F4A9852C86666A07C6966B46BCBF2E1F,122,134,12,0.4532547047537365,PASS
A82B53B5005B795CF09AEE815F7EACDEE8F4D5736AB9B1F88F11DCB7FC5CB473,114,142,28,0.08011831372763423,PASS
D06D55A46ECB86CCB08FEF8A80E54FE70F4ABEB7BB396E7C65FB156B333A57DC,113,143,30,0.060792723530522785,PASS
3FBE458BF18B88D54BE81021A0ACA3D5C9ECD876B21A83075A90AA0EC1CD7CCA,134,122,12,0.4532547047537365,PASS
7EC3B804877FDC80EF725161B9C95EE69E7630497FC79320F6E11BB0ED64513F,121,135,14,0.38157390570502125,PASS
FBB67070C49EEC27AA09E12751CF9ABD56D46B6EAC3B0AEC412DAD8E5AE38E3E,121,135,14,0.38157390570502125,PASS
56984E178442355811919C093658F48127645DE731335DF9F5964039537F9EA1,135,121,14,0.38157390570502125,PASS
7592A616964F4CFF5D1D5C4A8EA37D6E806695020BA9CFB12A58B41ADE7863B5,127,129,2,0.9005235503397743,PASS
E2A3B8A6FD6C44E058BF33F91527C416B61015691ACC2BE4567B2C4D224CCA21,135,121,14,0.38157390570502125,PASS
D261F49593A3419E85B3A2D53B8D737084D8AA93186687DE994FDC571C75D921,128,128,0,1.0,PASS
13CC8C818DF70546D27B164D17C0EE2BFB59ECCBF8210D0A39A7BAA7E2842711,131,125,6,0.7076604666545525,PASS
2C93B819BA0DDF456C5B2A2DD44D52654C28EF28CF6C3BBF0B9AA928207A2C8F,130,126,4,0.8025873486341526,PASS
B118A9A12E816E51DC2C347EB26F83B4240D1004E78EF9963013D20545C06A1E,144,112,32,0.04550026389635853,PASS
5B5EC5C3BF10B17B352B34BA449FC50AFAE7FCBC66D9231B186FCE5CA53A84D0,121,135,14,0.38157390570502125,PASS
E5338E2B7386E9D6C15F3AB2667DB5A4391E9515AA235E843CFF357EE84F15B,120,136,16,0.31731050786291404,PASS
9461B85BDBC862E5E9B71ED45835145348CD1686ADF673CD6728C17255040338,134,122,12,0.4532547047537365,PASS
96F0727320AA106D5A52E59AB676D9435BFF7EF53509F3BB03FB78F39290D13F,117,139,22,0.16913144470267139,PASS
5EB19CB816EBB0F49B950D2EA707C5C6B328DFEAA48C810B4B360CB22FBF7C55,125,131,6,0.7076604666545525,PASS
F3A3030E7D05239B44E079DE28A62745418D49B5766E85CE7C4781DE7F2ED396,127,129,2,0.9005235503397743,PASS
1AEC36C19DF9CA6FF050A2617F8553FC2D6D5028601D67981903D6A61FACB4DC,129,127,2,0.9005235503397743,PASS
E968B00B7E588268F3CEC9FF689A7D77474FF4BB9A9DFD4A95433A5E443C8550,120,136,16,0.31731050786291404,PASS
E0803A22A82A09BDA534FA3382AFEB6503F45500BA6FC46C4C819E1986C063E,143,113,30,0.060792723530522785,PASS
686BB965F09E8C3F7F41EC787C525051A867C18E31BD2CC57B29BFA11EC13BB2,124,132,8,0.6170750774519738,PASS
E3217DC28CE164FB365904960A8AA4BCA55E565C93C575374BA42ACCB5D5AC8B,130,126,4,0.8025873486341526,PASS
D0F1E187EB1D01A8883E4C07870CC7AA76B00C9ADC6E57A168FECB133B689AC9,132,124,8,0.6170750774519738,PASS
AD76056C7AFCA38DB6407189CC9BF49F3E5E22E25DFC7E861535D3A4CF00F37B,119,137,18,0.2605890342736178,PASS
200F23F7338057F2793799BE563BE147BB087352C6D3140C86406EB91A1B2B30,134,122,12,0.4532547047537365,PASS
AE3FFA516CD1AD2BAF44E1CEFE8136F975FBAD775388935B8B7B468A1485DDDD,112,144,32,0.04550026389635853,PASS
CAD607B56E8A0E61470BCD9FC66EDBB7E65C98AC62CBC872F33B0BCD448932D9,123,133,10,0.5319710580974012,PASS
344737191FF5D65DAAA184FE1BF93A4644D0EF9897C87C533CE1EE1AD7C4E2DC,120,136,16,0.31731050786291404,PASS
827861D78657FB3B636530558258283D2D313BE08A2E0AE7FDADF5CFEC5C47FA,122,134,12,0.4532547047537365,PASS
137DB2079217E4B6B132DC19CC709022CE280C22597918E80A763B9D80FBF698,138,118,20,0.2112995473337106,PASS
DA304F4F60D09CA3D750EB42CF2D22642384C366481DDD09537E7642E1F93468,135,121,14,0.38157390570502125,PASS
9D91F0D760BCADEA8EECDFD1482BDCD37AFF665208C43632006084BAB6785911,130,126,4,0.8025873486341526,PASS
B8E372297D74974F406D8BAF9EAC43E3CCF461635984774875D62222042F8936,130,126,4,0.8025873486341526,PASS
A16FA0D7E7A28382155A69126097A9697BE3DA79E847D8E5DB9D873ED9635082,126,130,4,0.8025873486341526,PASS
BA3203EAA10187FBFD6FB3CBB28A4249E582F45406DD6BB638EBBA20EDA8EC63,125,131,6,0.7076604666545525,PASS
9EF80CDAB229F01107EA835A16E1EDE6FD0A78F972054F2685EABDDFE40808CE,128,128,0,1.0,PASS
64B937343FFB097A5D288A93436E761BC6D1FD5A5892EA57B39EFA718754CCAC,119,137,18,0.2605890342736178,PASS
20DB748EF22046D8190C9784CB18AEF7E7F3AD91F0185F5E52438F67147B2EC0,130,126,4,0.8025873486341526,PASS
E9F014FFA9093ABA1F83A27EBD807D4A966F428A5422697D743F734988DACEB1,125,131,6,0.7076604666545525,PASS
1AFF62025A5D866F2BA5E0C66EBF2773DAF85F703062AEE38FFD4762974723FA,116,140,24,0.13361440253771617,PASS
B7E19230E3AC75413E3701A53FD42A6226BD0CB87519545240D2033A6539AE69,137,119,18,0.2605890342736178,PASS
65C72F1F3632C4EBE8462F8D621E3D07E4E73631F9F3DABA0D3662BD92350437,122,134,12,0.4532547047537365,PASS
BAFE2A752E2ADC14F9299AFE8BE95D3F1D389E1319212675B5149F6E8BE5D246,120,136,16,0.31731050786291404,PASS
CBBA6B974712297B333E5CA02D53E079E647EE3764E97BFE44C27CFF84503551,120,136,16,0.31731050786291404,PASS
182871B019ACABC9DCD352613104C8CC54A02A07397131F9FDBDFF2AC8643111,139,117,22,0.16913144470267139,PASS
8B82BBA4C5AA1C14B22ADDFC318C71B14FC791CAA5A647D417E5AF8C064D20E7,131,125,6,0.7076604666545525,PASS
6305F53AA81C7FA4501772B771DD5184B4ED0E38678953D703E4E772CBBD6CBC,123,133,10,0.5319710580974012,PASS
C80CFEBE0EE04E20F01697354CCB4011517B5B6DDAF8CCB4159A7D15D6E11980,134,122,12,0.4532547047537365,PASS
F42003B9949FA4774DFBC4A09656A0E26DB4F13ADD82795D9ED89BB01CE60FD2,126,130,4,0.8025873486341526,PASS
4DF99BFB925472DAABC1857655D42A31DC305C3EF85935233E10DF8E46E52E14,126,130,4,0.8025873486341526,PASS
4FC06FE27D995016C54423F2E5C498C2FADBAF0DBAF4A8100F673A85B3041DA5,131,125,6,0.7076604666545525,PASS
2076DD0948236245D70FE81B6CDDF384743519D2D02B8C88AC48EC18934DB7E9,136,120,16,0.31731050786291404,PASS
3E6692C68F21216B2DAF8450D4E0BFCAD39CAE5768D993E49D51182C8CD658AF,129,127,2,0.9005235503397743,PASS
BC891C3C09967C640A5809DCBC03B9C05C1D068F333681E7C4FCDD2FE81EA535,134,122,12,0.4532547047537365,PASS
86B3DACB1A59027542F1D095C931B58DC46EDC367FA68A2F96DAB11D494A5511,130,126,4,0.8025873486341526,PASS
1A016F87C1FE015E332E45ECF76D2D5D2CADDB55D2C789C1848C499B7DABA179,124,132,8,0.6170750774519738,PASS
A45A3827F40F92FB2333D0962163C6A8E7398461FE3605B802FFB509E1A9856D,132,124,8,0.6170750774519738,PASS
9FEC411CEC6F2FD080E21700C079DA75131A9595987F4113AF0E5B8E17A4DD96,131,125,6,0.7076604666545525,PASS
41A95570CA9E1F1F2720AE3188CF7D8AB52E05FFEE7F7F24C230AF32EF8D45E8,121,135,14,0.38157390570502125,PASS
6DC4F0F81A7BE59C5638B9A767424BB9652962DB305FBFD2409A187E4E251569,126,130,4,0.8025873486341526,PASS
41F6463FF972272931E8190B8ABBFE962EBCB2743F0D3240554D605454B70DB0,131,125,6,0.7076604666545525,PASS
F2ABE0D19778073D0013FF4BC702CD7F4FA39BE590C225CBDCD0E3BCE7C669C7,120,136,16,0.31731050786291404,PASS
2F6FBB7C0CAA605BB6D986037C4E7D74D30FF8377334B58241C9EA4DF2ABF59B,117,139,22,0.16913144470267139,PASS
325265EBCF27D2BC548ECC9323DEB31692C34C9F7401CF5354F5C7732076B0B0,127,129,2,0.9005235503397743,PASS
BCBB0D8F43CFE8D2BAC89251A122E84A9E580AAFFCE7116EEA4F9989B5CBC34B,124,132,8,0.6170750774519738,PASS
7910D2669A289563DFF742B0C606B392597200122DEBA6BC5B15E783D11E0ED0,135,121,14,0.38157390570502125,PASS
3F9F2545FDFE519A6907B6AE09B611CB2C629A5248FB71FC79A190F0288F7911,126,130,4,0.8025873486341526,PASS
10AA6BFC50071EAF82E28B957C351EA8C73C3DDD91AAB1A2311A7E717F2DF35F,122,134,12,0.4532547047537365,PASS
6DF517324C8EF8AB162B3A6937F8C7639EC16B399590A0B750078F8B1F9CF3C,125,131,6,0.7076604666545525,PASS
FCF5F2781F0510F31C6E7C8A6C78495FAA8107F4CCCDAC231EC7E567BE383017,124,132,8,0.6170750774519738,PASS
515B962FA8D6F35B0EB7A404AABE5028F39CB7091EFE64FB7C086F9986364583,125,131,6,0.7076604666545525,PASS
5FC2C2B53FEB0589E5E6B539B131AC62693477769BD7EAD0CC400E1BABA8A1D8,125,131,6,0.7076604666545525,PASS
6B748AC9928E7E271CD3D51DC052C32FC822AE3CD5E02F32934638D0D62E044E,135,121,14,0.38157390570502125,PASS
36C18130E2B29AB5575B417509559B25372AB4D755B00B3BE7F6CAD55D1A8156,129,127,2,0.9005235503397743,PASS
9DE2B7A0EDE3C04DA3F3B7B8D6F513D0113619C368FCEF0017CD45BA9DF30897,122,134,12,0.4532547047537365,PASS
D00A9349D29301F6D025A734626CF4A8E065B84C18517B0C59957BF3AECD1441,139,117,22,0.16913144470267139,PASS
195E5B7A0C6DF12471C04306683675540929E7FCF436C75B8D5019D0A6C52E5A,134,122,12,0.4532547047537365,PASS
772D1ADECBAA7CD43E5503D307ADAEF984AC6E642A7941438983379E76A0CA31,127,129,2,0.9005235503397743,PASS
8A58A6C99C736F1678B130B098BB3D39CB1ABB2397469282D0B68DD79D77CE41,127,129,2,0.9005235503397743,PASS
6EB26E44619831ECEF69FB1CD709D9840C621E1117CDDCAA88BBB7BC7330671E,126,130,4,0.8025873486341526,PASS
E83163545F414B62FF85C290A6E28CC97F032333A90B299377FBE324D06F292,133,123,10,0.5319710580974012,PASS
3A0B98BC5B445D6592B44A18B3BD508D2903B5CF9C1917C2E7CF588E1DEFE89B,127,129,2,0.9005235503397743,PASS
E00C4E74F96835E62EDEE9A2E1643358AF89960F34916E6A129B0848F6F386A7,131,125,6,0.7076604666545525,PASS
E26B8EF762B7BB4CFEAC753EC67DB210A58DF46060E13AE194918EF54DBF1BBC,117,139,22,0.16913144470267139,PASS
32E7B02D4AAE1C2045F6A03E721758723957CF63AB7BC515117337F1DE504F1F,125,131,6,0.7076604666545525,PASS
2CEB304C3BCD3DFEBE925AC06DF63C0AFE00F2952E3680122A4A7145A9BCDEA7,128,128,0,1.0,PASS
FA95A05B022D72BACF9EEC61F89347C4AEE9322374EA9BB60ADF1C65A98D410A,127,129,2,0.9005235503397743,PASS
C7B3095F1A31A43C3BE6BA33ED7F644D26E923EF94FB1B3141CE89440036C9A0,129,127,2,0.9005235503397743,PASS
E5DBCCBA3D8AD028FB8D4E8BB74143A4208C1C58F19D845669F2CB6E1E1538C3,131,125,6,0.7076604666545525,PASS
E70F8149BD256E6EBBFA03C4796424E1117BF2CBD9E997D5371BDB81C4A9EC81,122,134,12,0.4532547047537365,PASS
49B63F0243339C7BAD82AE2E0741EFBEF132C115EBE61695713A527877851FD8,125,131,6,0.7076604666545525,PASS
D2DB0F5F7C816ADC5C87952CA10082E29663A90EAE0FE7D213F886C1EC17ECB9,129,127,2,0.9005235503397743,PASS
3383D98C436033459CC5D7E042E12134CCDB5C8CB98EE15D62A6058677C1BE64,136,120,16,0.31731050786291404,PASS
DA4AB9058739B8903F310571758F5FB9D6AE77360804C1D2178658FEA963BB12,129,127,2,0.9005235503397743,PASS
F8712AF88C6F16EFAF690E5883844917E9D3340A636D8B5C2C4C3AE6DB8D1635,128,128,0,1.0,PASS
ADD7FF74F1C1DC5C935CD0CC2D3308487250E505D3C194A171136B47B2517D83,131,125,6,0.7076604666545525,PASS
87C21E3F80A1F18A9C23667DFA0CB8DF07729689A135FC6B08AB2B60AEFD8DE3,126,130,4,0.8025873486341526,PASS
B44D8550A2364CD4FBCA67CD019A90B82C3CDFB24D6A37501101B855E66D1630,138,118,20,0.2112995473337106,PASS
57B66C32F9403C5C4F8A6015EF1AC09BB44B5F87E5398FE4B78512915675B2E7,125,131,6,0.7076604666545525,PASS
8660BFB15D6584F4262E3E65E98094A25EDD57C6CE703CEBCBA222AC85625098,133,123,10,0.5319710580974012,PASS
58CE4D27F0126A508827C40954851621175650292BECECF722646B76E54E51DB,139,117,22,0.16913144470267139,PASS
7662069710C2D266AF539B39B797284E0A6B661100C3CF0FB9FFE3FDF233E552,124,132,8,0.6170750774519738,PASS
196659810B29E691FD0F3C85EC20EA5E5C58B7893695EF0C019307E7538E127C,133,123,10,0.5319710580974012,PASS
AE3C96750E981B5587F4B1C6B0DE5F2EC3EAEBD9455F091D6355F1738C2C498D,122,134,12,0.4532547047537365,PASS
F45BEC9D3F1AD3DE215445413166555FE87E7940CB9868EF9A76984735E8E13D,122,134,12,0.4532547047537365,PASS
C2B05AA19B7CF35C75DFA663CFAC4D166F7A9E2C77F7598562D024D2AD605931,121,135,14,0.38157390570502125,PASS
B8F033E92648B315E415E96AE19E5747036C952DC6CB2ECB64032E5FE662C3BB,127,129,2,0.9005235503397743,PASS
F533994A62A7DFB4629D0EAE4BFA1DD4A30ABDDDFCB9E91972A59C5F60586401,122,134,12,0.4532547047537365,PASS
1B808D86F8864003B2E59CA10D205A414DEF38B4014593CCAC9776BBD8CF95B5,138,118,20,0.2112995473337106,PASS
998802FD9B1B5124D54F012A6C7DD8C8F9301873F086AB32ECF7815468E5A99D,133,123,10,0.5319710580974012,PASS
CC3CCB8744AF2D727952F2D708E982BEF283AD03A25ECB7DE45B27FB0FC456E6,120,136,16,0.31731050786291404,PASS
D17499A979F029765A58D90A1D3DF007804059CF6A5D05F48420D1A7C3B72292,138,118,20,0.2112995473337106,PASS
FE23A36D0FF75644D61A655C482CB5EE9DE894E2BC9F47892C702287BEE45DE,124,132,8,0.6170750774519738,PASS
EB821C246B9698AB879689D222D138CB01836D7E8260A5CB10A76B753301E2A5,140,116,24,0.13361440253771617,PASS
A8C6458AEDBF9652C80E5FE0CC23A72272C0FBA71AFDABC8035535118A79C879,130,126,4,0.8025873486341526,PASS
CA84F320BE20C1FABC9F1D85EB84B8291CC47E4A1D181A2BD393FA80DC1E4C2E,134,122,12,0.4532547047537365,PASS
E2011814DD39019D7A1C52A94E1F72AFC3E3AAB10EB7BAF15D872ECF8B8920BC,129,127,2,0.9005235503397743,PASS
22A01379A8CDB4C2BF4CF868E66F1B34F550BBE90F814B77D87986E5F51249C5,126,130,4,0.8025873486341526,PASS
F43DAD22CDDA1187F4757E2B90DE30DBF21DB39983B5F7BEBEB21035AF8BCFB8,113,143,30,0.060792723530522785,PASS
AA16D21A7DDF0C86711BF27A321A03A04E53B83D8D574B8BC5CEDAC6E552C1F8,128,128,0,1.0,PASS
837A76332A7E864D67BDA37044482D63FE5E4E35CA34F33FB1F0C6075CD6CBD6,120,136,16,0.31731050786291404,PASS
2D20274806265B2F7E809099F48015AA4C48FC5FF910B9E237341BBE568D384B,138,118,20,0.2112995473337106,PASS
D39329E229821AFBE6823B4C1ABB7AE1FE5D5B73E1801FB5D8CCE8BB1D3DF7B7,115,141,26,0.10416255883043901,PASS
1D5BEB8B58F44576F78215B453D1E121BF73B07566BC686F26B2C9BE895165A4,123,133,10,0.5319710580974012,PASS
3F27FAF2F3170980A49C7C45974D63CABFF5EDB1DB01E22F48EE1FB7FBA156AE,113,143,30,0.060792723530522785,PASS
DEF40F6D69E142D1162822691484098E4F7D3E8BAE63AF03FC719733D286ACD0,131,125,6,0.7076604666545525,PASS
65CCA9D22B28EA7C0DA8FEE593DE95E234F1D1000A942CFE208F7DA044FC4D22,133,123,10,0.5319710580974012,PASS
5EF4B467DAB894135FBE6C70DACCC5A6CE78E6A35B25AEA6A77534FF8A676E59,113,143,30,0.060792723530522785,PASS
D0DBAFBE67DCA5CDA93F5BD7F87E81322C240B9994DA6496AF49AB7245441963,122,134,12,0.4532547047537365,PASS
397CD21C58286E65A9B0EAEBBD4A2728985BCEF9D62330FB6EC5F0B2CD12A3C2,126,130,4,0.8025873486341526,PASS
B8EDB4DF3644C4309B6FFE8A2401634DDEE857DD6D353E49F32F58A2B2071506,125,131,6,0.7076604666545525,PASS
F5FE9BD9635ECFB31E79E219A0E6D7F64C8F6B2ADB9B01A18011D3A98EC76A33,118,138,20,0.2112995473337106,PASS
F2CA433B87D65CBD3599EED79F7EF8FA8F01FDFE9D8FCB8C89CD4C0D11FF7DD,106,150,44,0.005959526470109114,FAIL
83AD64763371A4EC0EC3E062B8B6B47A59E8316668EDCFDF7ED192DDD1768025,124,132,8,0.6170750774519738,PASS
271A3F9026B94A55B5975BCA05874D625CF484AEFB6905D6B48BD1F25E1675B1,126,130,4,0.8025873486341526,PASS
BBF79BF54F0806865A606930BB3D53102E1B77A330B3EB02ECF5A4304A621712,133,123,10,0.5319710580974012,PASS
2B30A16064B0FAD4D3195B658B7F355F7CC8866AEFE1D376A61FF69DC972340,124,132,8,0.6170750774519738,PASS
EAD26030C0CB78EEDBEBE20B0E51C8DAE7D771114766B45C0F28646781730C3A,132,124,8,0.6170750774519738,PASS
2AB8A4C80A2DC9D0582E1E8ECF37708F1AD1249C1758DA8514E403D792D8FFD7,133,123,10,0.5319710580974012,PASS
1469A317933AFF75DA9F818E30883D560D3443032361D5CE626D4AA02003D00A,143,113,30,0.060792723530522785,PASS
2E6682C5F77116CF67C90A870F67354937F0B489D9CFE49781975F1C1D1EDB77,119,137,18,0.2605890342736178,PASS
77831B44359B9A9CFDF3A112B145E80D8DAD055A442F6B2AE4DB59C00785099A,134,122,12,0.4532547047537365,PASS
DC91BD17E761C5B31977855DB439DFAD5C676A68E6A057D2C6771B9E56E1CE66,115,141,26,0.10416255883043901,PASS
14BB1B6C542B08C0DBA4EE89DA5F7C51A696BC507EB30B555DAD373AC34B24C2,128,128,0,1.0,PASS
F562AC6FA84A3AD36CBCE3BDA65B3938E868D0F9730BE0610E6C9B42F9A7BA67,121,135,14,0.38157390570502125,PASS
1008838E621C1EBD792BD2D631C00923AD0965B07B34635DC517748ED7198EC3,138,118,20,0.2112995473337106,PASS
4A880823F62EAB64723078264AE24EB7789483B0D88A24EA066AB379B263CAF3,138,118,20,0.2112995473337106,PASS
CD5540B072489A06820105B831A58D2C34401C833679C019DC63D33F26E6C7B4,147,109,38,0.01754895019147673,PASS
64C69B60836DC219D4E55BBEFD77BF61772466541A2496428F956B4EF10CC785,126,130,4,0.8025873486341526,PASS
A412FE0B6AFB1C45088B31846A5E3F3E38EC97B57E94B8487BAD429D9DD4795F,123,133,10,0.5319710580974012,PASS
A8D977850E0750B2D44ECEEAB53B207778F39378107FF193538B0C80AE4E5D76,127,129,2,0.9005235503397743,PASS
6B240A15A98BF0B980BD348CAD40339506B17812166B3922A51A52011F36C546,147,109,38,0.01754895019147673,PASS
CF885A06EC11D6774CABFCB43C9F31734F11FBC954C3451BF77F9B8F739E38A3,115,141,26,0.10416255883043901,PASS
9E927CA2AEC68A9424BA35E6771260078174B0A0D0DB1C00A67780507C632472,145,111,34,0.03358661289689768,PASS
98B9B31715962CD4BA66F1A96FC1E915DE755765194271A55011000C74089B9,139,117,22,0.16913144470267139,PASS
1134972EE435BCA02B3EB5EB76D7FA18D0FE819D98AB3767B38593A66D233F93,119,137,18,0.2605890342736178,PASS
98B58E64B267464C7672B725868C926ECD04EA4D18D65A22ED5DA12386F72075,133,123,10,0.5319710580974012,PASS
D736A22214D8246D819C172C9522BA8EC9D853757FD4F431D685E6ACCF6C3214,132,124,8,0.6170750774519738,PASS
DA8C5700080DD915E3A7230C001567408C8BACAA602F890E6CD7A65E8120FCEC,146,110,36,0.024448945310089426,PASS
4937439A6E46264294EC0FF33ED1F7AB6C67143B5BD9F234ECA930528994EBCE,124,132,8,0.6170750774519738,PASS
D2C8940A0FCF034EE399853B61F271B1E7ABB856D1AF69A0CF7E0950F2A26250,131,125,6,0.7076604666545525,PASS
3FAA91246CB91B8A17DCB1A999BDB8177B8FAA1233CE4C73C5A3AC03744386CA,128,128,0,1.0,PASS
BDC7A2509CB6CFE5258A3182293F7734A9BF368E34A4987F80D32354FCB9EE70,124,132,8,0.6170750774519738,PASS
23E5BCD5102F2C3D12F7BD69514D9641516B489BCD7545DDF86A38A7EA4FD017,124,132,8,0.6170750774519738,PASS
610100A69DB48D44CF1D3D8C1E8C7013EC6E233838F754EBB1B4754A258AC2D5,137,119,18,0.2605890342736178,PASS
7CA7E5234CD96F9C6C0259409038B88B315F1898FC7357E5F49E8AC8CDEE6C4D,127,129,2,0.9005235503397743,PASS
1DF720F2BF10B29F1942672A902DCDC7CD2A64D0095EFA87D95A3091BE73D273,127,129,2,0.9005235503397743,PASS
C461311E9109F650225D0CC869FFF98AF82B02E11AFE9A7E3AFEE098EEF15D38,127,129,2,0.9005235503397743,PASS
598A7572E5069CCD713AE95BAE1C346DB03FA7F3AE1789B373AB26020D8649AB,125,131,6,0.7076604666545525,PASS
835D10549F8FDCBAB17606B3F6299F7162B418C92938305AE81900430718438C,142,114,28,0.08011831372763423,PASS
43F4693F7867E4156E809D791FBB6E23B31B5ABDBED5D794A98FB75C6A6E0CAF,112,144,32,0.04550026389635853,PASS
1886625419DC591289622B4F713B673A2C6EA3AA6213BFCFB44B1165F30480E,138,118,20,0.2112995473337106,PASS
5503D9A569CF880DE22BDD46EF6BDA23068B63A4780B602CF827B5E37B54E321,129,127,2,0.9005235503397743,PASS
F7AEB5C23DB53E7991D0FB1010B12C4EB4D0484F312A6D9E74216DDBD310FEB0,127,129,2,0.9005235503397743,PASS
45AE39A93B041E4A17EC0FD9E68F8E62CABB1873255CB285B55261E7EAF1B476,125,131,6,0.7076604666545525,PASS
D45D7EA3202C8846A01F364C958DA455AA4927E96D7A4EB7E5A83A49F29A56F1,130,126,4,0.8025873486341526,PASS
B619A3E912D40E8D648E68BC27A9D73D0BC1E2E32142D58D0BF9022DA50598D1,137,119,18,0.2605890342736178,PASS
5D895D92065366728B8DDCE34EA0A3AE12230F816D09390B6EE8FA62317F7E71,130,126,4,0.8025873486341526,PASS
E82A3FBF7D2644B5D8B0DA428D1A9B913DDC6463220D22A525A6D3A1354814E8,136,120,16,0.31731050786291404,PASS
F24D89DA770491BC22D54FEDBE2621F96D1513C159408AD36F1FBFC89A8E8DB5,124,132,8,0.6170750774519738,PASS
665A0BC6D7E8B5651B9AAC5D2D6E7F4644BC3D2BD7C39FE854715EFF4EC2F06F,113,143,30,0.060792723530522785,PASS
1E6253DBD025E4E6C467CBFC2CAEBFDBBB288264D074C4AC8ACF968DD566BF9F,118,138,20,0.2112995473337106,PASS
F50345F5AF48A20AA3AC6EFE1922A38C0A6DB4748B552832531B212E18B9E015,139,117,22,0.16913144470267139,PASS
605155A2ECB45FCE6294FA060114AAFAA0052DBF6A36D40D23EE618444A58179,140,116,24,0.13361440253771617,PASS
48114B4183E410B255099B77B0C5BA36E9E03B14772D474B71C90AC112B214A8,144,112,32,0.04550026389635853,PASS
AA312F601D44DF4CB6DB603CA8E5B11C29316BC8F6D5C95487829F03E25831CA,134,122,12,0.4532547047537365,PASS
2BAA553C88346094C317A48C2A020F0F5C23285B5153289C1DDFAC40C980CFE3,145,111,34,0.03358661289689768,PASS
94D7F55B1585E092C58050382919751DF75F4B822B1EB6DBD34E71490CA25D9D,130,126,4,0.8025873486341526,PASS
4DD90634B7323BE2AC71DADDAFBE7224AC54BBA0AE7B16949611E6C7F6EA36AB,119,137,18,0.2605890342736178,PASS
7668AB4A9B86260C6750850ABA5E1769C62141546D566F7ABEB51F814DBC20FF,130,126,4,0.8025873486341526,PASS
B18DABD6EA64F08A46CB637484C7B575D9ACAF31C56D240F1E8018426B9DCB2E,129,127,2,0.9005235503397743,PASS
112222681017968D317DEA7E5445A766DFC529347CF87E13E6B7783A6EB1FFBE,121,135,14,0.38157390570502125,PASS
8EBAD1676F2F97871E03BBCC47D50600593686B530DABCC347BF114F38D49BD3,124,132,8,0.6170750774519738,PASS
BA11BBCBB8F7DB383BD3ADE422D8C18519BC7C3D0C32664448217E61B3FC092E,128,128,0,1.0,PASS
98DBF2D98B6F3CA56966EE504357E49475EF60B84D24AEE5DFD14113786A1606,125,131,6,0.7076604666545525,PASS
1DBCB633E43BAC0E022F25E4AA7B468B77CA191D48FE14610816E888FE9F6341,132,124,8,0.6170750774519738,PASS
1A0C20A6F28A42549710F9CDBDEF64F89455E5EA42466E0F9BE0275A9DCDDA3,131,125,6,0.7076604666545525,PASS
C260CEEC77F9B8A186671623E939D73D1E32DB1B6288F6B23089367C0583411E,131,125,6,0.7076604666545525,PASS
2AF1438F6A5300684566589CB0ED0709CE6C1441B916913058C2A5311671CF98,146,110,36,0.024448945310089426,PASS
BD088DB6809289398F6BA511F8B339E89B7C481E3060D53B9C06D2866F97BFF7,127,129,2,0.9005235503397743,PASS
272E2174DD7F1817C206445383B6956E56DEB464F8515DABCABE4B5278EE33D4,125,131,6,0.7076604666545525,PASS
5715A104597E44F1724D9D6D4ACCC0C3DB150A15B63AAC30CDD34C9A73040320,141,115,26,0.10416255883043901,PASS
E04BA01F818F776DDB7E456B35FF2536CDBE82504A363A897DCBF337E9558657,117,139,22,0.16913144470267139,PASS
33DA97FD881A9A06661E90D84B36BEB25721D87DA3244A5515E6E589B86696AF,128,128,0,1.0,PASS
57D6FA3A3BE323F60ED3521561FDD3D71A0CE4F6D3D3304A137CB14D08BBC96D,120,136,16,0.31731050786291404,PASS
86E5ABE9C13D75965F06EFA843CADB7F0F685E291FD1FE20ADD62B6241DE87A6,118,138,20,0.2112995473337106,PASS
75768D2C0BC9B63E4E10D73AF52E40174337FA1ACA58CCD107B9F64B387E41C6,127,129,2,0.9005235503397743,PASS
B12EF5099F73131FA76C64105ECDA76AE277CA253844A61BBEFE618A49B41A57,125,131,6,0.7076604666545525,PASS
EC05B67ACF322DF2463FD74CA9381DFC75E1798CFC5C997BC13F9B01C1F3D72B,115,141,26,0.10416255883043901,PASS
CE20C57877690ECF129F198B6BCAF30B8A3D7D1E948714F92174900A7D034292,134,122,12,0.4532547047537365,PASS
A65D316222205B56B086FE9ED278B2A3051BC7A5A4BB8C1BA5D7210B4BC5FF37,128,128,0,1.0,PASS
8E061CE713A788A623B25E3A3BE818C02EEDB49DA776AB627CBC9BF546EE97BD,120,136,16,0.31731050786291404,PASS
6063DAF9C4E23AAD7D35A311A07CD9B53EAF990B9C10EA27E4B4FE9C1AF519A4,124,132,8,0.6170750774519738,PASS
16FADFBD184ADFA153ABC0A6F29A93A96DB82316A3519926AA726CD37CC8CEAE,123,133,10,0.5319710580974012,PASS
51CC8B02827AB430B11B5D4E30649E9AC2AFC889F72C96C2153ABD3B46D747FE,130,126,4,0.8025873486341526,PASS
F77203C597EE89E71684E1657B14E2CE09C23AF2A44A557D78A05172029E7B39,130,126,4,0.8025873486341526,PASS
9966CDD32EC4491F3741A3BD20CCA2FCAD7DB785AF2CAF9053C9276689FD6CC0,123,133,10,0.5319710580974012,PASS
4F428AB431BC15EB0192FBB5F8ED23CE3EB090F308DC059B0D05DBC2724D07DA,131,125,6,0.7076604666545525,PASS
AF0A703992E226429FECB3C12A04CF6F7393FC456B9036CB0E23333977122B68,131,125,6,0.7076604666545525,PASS
6C44E4AAF321DEB9FEC9BD2FF005E55D275C51C17D145044746C0F3E7416C0B1,129,127,2,0.9005235503397743,PASS
1B30AB1BB85AA33EF99281C36B7A3FA0B5823CC3560DC85D5178136FC1615A71,131,125,6,0.7076604666545525,PASS
8226344EAD656A910EA495E27A995F06FF8C7DDEA790C519EB9F2015F4FF019B,125,131,6,0.7076604666545525,PASS
358F606DA0D19FBAAB35AE0DD18BC7640B0C13BE7ED539C240FCF000757A81F2,130,126,4,0.8025873486341526,PASS
25BB27C7BDBA053E29E23F27CB845F270F661D66D67EACFC0F08F6ED2766FE72,113,143,30,0.060792723530522785,PASS
C6BBE7001D024A230641B8009D2CF9C80F3711A4100052178251E2903CC5BC2D,154,102,52,0.0011540500847815347,FAIL
2EABFD55D34E7166E1102D6C79782F0E9E2B0ABF93F63C9C062700AC59395AE9,126,130,4,0.8025873486341526,PASS
4BACEE3C13EB1B344ADBFF63AB6E6FC9AA492A6A1A4E445BD33C86659516EEB,121,135,14,0.38157390570502125,PASS
79CE0262CA8A2454C207B6F3FB3E56B9D409426EF35D56368EA7021F9F1F4A64,128,128,0,1.0,PASS
9B8E6E68F8E87383AE8D3DC7F3A4395DF2940B391A4B47B01C17423572A2A72,130,126,4,0.8025873486341526,PASS
471008C8B80CBB83326247A2C8529448DBF306B21F470CD15019723E63A14238,149,107,42,0.008664896726025117,FAIL
9F17FA2D5EACF5668E5CDF21102FAA1BB711EEE29A25F5A0A76D30D8628CF73,122,134,12,0.4532547047537365,PASS
18CE2983A7D077BD0A278FCA0CEF4C867114F5EC2924B719EF998193A5669DF1,127,129,2,0.9005235503397743,PASS
7AAC0979049EC24770D4FED9DA66A681F76D2465CCBE365457A2DDE1382449B2,128,128,0,1.0,PASS
E87A07FF87BD1608BD4A716FA8474CC882B1DAE1E0B5B331AB2C3A0696208DE1,132,124,8,0.6170750774519738,PASS
4C4B726A67140C81751D3FEDBADA8C3F5E15404054F44E304F5C7893AE955742,133,123,10,0.5319710580974012,PASS
B338E93AC4CEF659BAE725081AF075A9D8BA8C5859CC8A4CC8ED0737334E7B1E,126,130,4,0.8025873486341526,PASS
BDC9A7895EEF6317EC7AD2BA47D30A274845243B850E7E6451EAC78DDD785595,122,134,12,0.4532547047537365,PASS
2D5D6298ED8BC2398B2173C13748B037A08511A219D92F44AFE233AC7D425E1C,136,120,16,0.31731050786291404,PASS
1AA276646C3BEE82B7DFF6261810739A7BBD7B4D1A4FABAE5B57BAF2CCD2F401,117,139,22,0.16913144470267139,PASS
64959A0CFF2DF997F1BB96E41BA64BC5C6590A0DF7F8CAE572A2F25FD7239B6B,114,142,28,0.08011831372763423,PASS
4894A040162D27C5721EA0A800436CA9C472E2B407CB641993B1FB1CA035AC88,150,106,44,0.005959526470109114,FAIL
F6B13C44B59ADBF3AB402B5ED4E3133D581A11855EC076F863CDC0FAA6A8C1C5,128,128,0,1.0,PASS
2C5E2B77FB0CE86168471A5D104E8DA6A3AB7333D8EB3F0129B95BFF26908057,127,129,2,0.9005235503397743,PASS
F3B9612550F1B24288736E17A59C6BDDCF079DE56B69C08EB5363174A6E7431B,124,132,8,0.6170750774519738,PASS
6D3497D9009480A7551CF7624E9FA595295C445DC54601766D04541F01FCC7E4,137,119,18,0.2605890342736178,PASS
8A3980A6843C04B29E03939AF124F0B05F89DC45664F3BC352CA3741485FEF81,138,118,20,0.2112995473337106,PASS
C689ACC48F9F7762C0BED40282B2F12839C8CEDE14C76DB8E5CB3BE6F7140EC2,127,129,2,0.9005235503397743,PASS
725290D7B337DF4CD8E791D63637D7ABA319C9C4D5D97891637E23EF3658CEF0,116,140,24,0.13361440253771617,PASS
E07FE9D7DCF327AB698991E7B847046B9D0BF7DD5FBF976DAA9DBA97C21D25DA,107,149,42,0.008664896726025117,FAIL
FC6422ABC67E519E16D42DCE539DCA3979A0D1987E47843505D4EC21596AE78B,128,128,0,1.0,PASS
99C36CE4B630B71D30363CACB81F73F3672828C3C9E80BC9F2C77A3D5844DAA0,129,127,2,0.9005235503397743,PASS
97A37C7E2842E2457891773F883C8F7EB1E7F8C6E68D988EEF9F9E4C63823B1A,119,137,18,0.2605890342736178,PASS
CC929D446AD3C04305571A72DA1F0C9DECE8CF9CBA2FA66B9AE745241B30ABE3,128,128,0,1.0,PASS
5CE030987176F32910183CB3D799A86D193B48BFB65984C9A0F1F2A245B42D57,133,123,10,0.5319710580974012,PASS
E0DA00C8ACDD08777F4C2ECD89520CE65D6FB15C5C40589286A45B4D369D4A0F,135,121,14,0.38157390570502125,PASS
1F5D8E63223E962E3FC273B0E66667DA0850C6A5918CDBE100A203914712E9CE,136,120,16,0.31731050786291404,PASS
497B396256F20C31D1606723C1492C9EAAFF0B8AE192E3543A75F20C80717072,137,119,18,0.2605890342736178,PASS
5BFB5291788091C84C23E6B14ED03F1343D3BD1EC6CA41EFC5EA58A2742F30EA,130,126,4,0.8025873486341526,PASS
42405803B9954E890C013931DB4A19B04CF278763CEE877E687699B5B896F58C,136,120,16,0.31731050786291404,PASS
B86B04BDFD9FA35D969C9C6DC391F3BEC2BEDBBA43A6F22A53129ABDDB9BBDEC,109,147,38,0.01754895019147673,PASS
79CEAA4E8EDC3185C62CA86E11080E9BCFA3194D520AE1E90D2782C7D63B8942,137,119,18,0.2605890342736178,PASS
C1D0B69117A0BC53509235CF6ED1A3DDDF4383F4AD92303B4D9E5631A9DA609C,129,127,2,0.9005235503397743,PASS
5812D8BE44310499BDC06F9395F4D20A205BBCE96F57EE1A74E0F5C774991EEF,125,131,6,0.7076604666545525,PASS
D7DD22FE2839EF104AD4B0C351280AF0378F3DF09A9A7F256D8EDA4B619D63D0,126,130,4,0.8025873486341526,PASS
C5F0D3CDA39ACB846C2B27C23BADC705547E8EDEC20932A367341071FC76F538,127,129,2,0.9005235503397743,PASS
A0CD401CFD761AA59ED44ED21DE39AAE7E1168E2C45C083BB647A017D20A12B2,136,120,16,0.31731050786291404,PASS
BA1F416C6FF1093FD1ECF4FFFFEEE1C3EF52A88465FF72292B8EECBE1E5EB1FC,105,151,46,0.0040402749798920095,FAIL
5664542D3FE50A82DE41AE0E1A206650DEFE68EA8B390EA97A1DF89AAD7ED253,128,128,0,1.0,PASS
917808E116F5DACB16FCCEF9772D8FD033386FDB5C6FBA6B27C72D4186F8EEDF,112,144,32,0.04550026389635853,PASS
4E68070A16B40B284F2102CA9B692A386D93769C5126ABEBBF4BF5C476C5BC19,133,123,10,0.5319710580974012,PASS
853F825E152081D5243A0C46F2E5252022C0E5B0F7C3ECA12DE57A9080452A13,147,109,38,0.01754895019147673,PASS
7D98AAD61B0E00F73C3E3ADCD1805E9B9842DE3082410ACC0D61A4F38FB65BFC,132,124,8,0.6170750774519738,PASS
41F44E052D8B1A9D913E68986508A9C5F8E3C6231D16615AA3F0D9BA90A7D2A1,137,119,18,0.2605890342736178,PASS
7864D5B145BC68CEE9D54CFC03DEB44BE8FFBA9A98027820205334505441B781,136,120,16,0.31731050786291404,PASS
877FB7D89DCF9CA407C5D5C12E5C3971C9B41D0D6A096AB4EE25C6657E8272F9,122,134,12,0.4532547047537365,PASS
98E830E545ACD37FE598C8F7BE646A9E91A92729A6807BCB4DE9EDE20B48913A,126,130,4,0.8025873486341526,PASS
8764ED03AE8184D71FD1562544CCEA688366C558DB993B9D3A13ADD226ACFE77,126,130,4,0.8025873486341526,PASS
3242EBD0A3FC203A05B1B73515E513CFE12CFD8DBE0B205C2820A4CDC91F55AA,134,122,12,0.4532547047537365,PASS
BB5431CCC2E65CBF2E9AF726795FECE39898FC50681CC7F9F5577C6BC3CDD4C9,113,143,30,0.060792723530522785,PASS
7B66B2ABDBACFD4E8300C63F031BE874AAACF73999B063DD04B522822D457B3F,124,132,8,0.6170750774519738,PASS
C31D048ADEBF0C8C90148754D85E9766365397D1B2752DBCA61EE3CB9836F43C,128,128,0,1.0,PASS
F67F98CEEC763CB8F682D700A50D7DE9948F8E220055B80EDD34004649505792,135,121,14,0.38157390570502125,PASS
BCD2B5752C15F0C460B60CBB8381194EA5996CC53CA86FF84F3120E4BFA7AADE,128,128,0,1.0,PASS
264B75DEFBB866462D3E74A4949E6D8F01E233EE47F43B97A0136B3567E19C3,123,133,10,0.5319710580974012,PASS
E13F403510B5C82A11F7B622EBCDD95E54C30A06D58630C025DA709D5A0C3887,140,116,24,0.13361440253771617,PASS
5781152EB2D6FE2904B7E40651947EF86422EF2287BA55943AB83D9DD870C452,132,124,8,0.6170750774519738,PASS
892D909E6664CF80311DF126D8439CE9A71AD2A0C2A8663431462FC36247E01B,141,115,26,0.10416255883043901,PASS
AC97F55DD5DF203627AD0DC2BE9A2C705BB482372C62C369D344811D3DB716B6,126,130,4,0.8025873486341526,PASS
C33424FC3EBE442A8831AACA6D8AEAB0B50C3F29BE8BE5E078E8E2CE25D2E8BE,128,128,0,1.0,PASS
AE69822FD49AFEF0F976424F8DAD3F476CA6D067A5D9E050A0736D939E6175F2,120,136,16,0.31731050786291404,PASS
C20A5A72D8AB4ACC95F734B9363060DEA294FD24714A1F0D311A78A26580A15A,139,117,22,0.16913144470267139,PASS
9CA6E669E42540AC170A70C500AEEF4995525E494C06614C6E21CA78CD9C8DA2,142,114,28,0.08011831372763423,PASS
94F88AF6BA4486D8B05EBA634FFA7ABE25683173789AD3F100250B6B43803B90,132,124,8,0.6170750774519738,PASS
4E1519B8C08BB3C582F3ED3F259B74C9D0D425FCAA94353B2A2CC185C0CDFB52,130,126,4,0.8025873486341526,PASS
46254E0B4EA23C4603FFDB06EDD58AFF8DAA47C4E738908E5143694EB29FCACC,127,129,2,0.9005235503397743,PASS
3DDEBCEBEE50E34BB20CBFFD85CAE908CA5B66C85D428BD05815E642A5594158,128,128,0,1.0,PASS
56906EB2191BF239074BB21E3E59BE27890EB088D0401B97CD83C163CCB265CF,134,122,12,0.4532547047537365,PASS
FD29D6DAE9D7A020B6DB842DD67FC857A737ECD50DEA7E2F42F5E326F3AD60C7,112,144,32,0.04550026389635853,PASS
D9CBB313E811FEECAB7A6AC005EE62BEC36E4FDA63A2AB52B93331B23A324CB7,121,135,14,0.38157390570502125,PASS
A59281BAB0EBE79FBC4AE130D879CA901C549BADFAA0AE19EE71F55DD65B5940,124,132,8,0.6170750774519738,PASS
87BFFC24BE627FAE0BBE4ABBC6111142C609C37FD2B92755C8FA20CBA741D2AA,124,132,8,0.6170750774519738,PASS
6CA9E1E0848244E069D17FEF136325C3A5275D31653512A3F5AE8854C521D8ED,134,122,12,0.4532547047537365,PASS
86FC5D068160B0E583E632CE1F0FDD745BEFC125C5C97D6D8302D1E1E86929E1,129,127,2,0.9005235503397743,PASS
4F015CCCCFEB02EFB9178E2486BE84173BB69AB09BAD697C68FD40414395FD90,127,129,2,0.9005235503397743,PASS
6D7F34B3AF7B77090DAEE2E8554B1D8C4CCCEC564B4AD27225921A323BE01D9F,124,132,8,0.6170750774519738,PASS
3986145A4ECB72396D22DB1AA5B538B19B974CACB4AB98DC9F04A7956B34DBA1,127,129,2,0.9005235503397743,PASS
D477FEAEC92DD021F3E7F30B7ECDC0D57162A19BC26DEA44633129D26AEE57AE,118,138,20,0.2112995473337106,PASS
79B8B81D7C1A21E9BA44E32AEED1363D7170D9CA0DB194C770DA42B37282D026,132,124,8,0.6170750774519738,PASS
B14B0558CC04AB0D0A037572F00C254D83C0BC167850D284BD994A0DF2A668D5,146,110,36,0.024448945310089426,PASS
DBA7B2CAEEEA1B87CC9EFF0B301B78BCAC565627DA6CD31089E4887AD248A0BC,125,131,6,0.7076604666545525,PASS
4EB1F4B82050F54419545FACCBCDBF30651BDD8F63753A27E7BECA592047F2D5,122,134,12,0.4532547047537365,PASS
A9536EC1CDA7208E2FB02FC4F3D203CBCD8BC088F303A090DB108866CC335CA7,137,119,18,0.2605890342736178,PASS
5E8A02E79A9918A411DE657C91B4A89E4483647D5F621E94607D14EEABC6F5F,131,125,6,0.7076604666545525,PASS
C4C83BBA3EA4C225B343A80FC150F8C9CD0B02F90CAE61B052613C2A4BFC865A,139,117,22,0.16913144470267139,PASS
E65E289F909A48ED28B1183618E8377491864CF4ACB0335AE5F7FC91D5B29CC5,130,126,4,0.8025873486341526,PASS
311BCC93A8F2FB080AEBE1ED1EA213AC5E05E18C9B474131BFE455A96C33DD5A,128,128,0,1.0,PASS
41A2C7A3C950A4B2E30448093DD5C270B94418702F9A2C70A3222048260CBF4,154,102,52,0.0011540500847815347,FAIL
6772D0D3945411CE48384F0499B7969ED1E44F2A12F3CC07D5700D1ED8BC863,136,120,16,0.31731050786291404,PASS
959E5289A1203260AFA39A822773EAA6D5321344F6C9901B923FF136EF086829,137,119,18,0.2605890342736178,PASS
49C03C42898601B1F8DEA5C3284719919AF08913E0EBC263F44A0651D65241B2,146,110,36,0.024448945310089426,PASS
7251E84754D0D2DD4B55A264576CC839AFA0FAAC47C49D32830B4581BAB3CE70,133,123,10,0.5319710580974012,PASS
21E00917B1F43C82B0BA3D1DB7A5B5F582D72F067E19ACCC6EB4B58213D5D83A,128,128,0,1.0,PASS
4A185E7D514424DAEF36431AE48355F5F709B8FD1B954C48703A802AAA5FC214,135,121,14,0.38157390570502125,PASS
6F91A25D6CDA16786E62159299DF12B3A6E0DBE1073768D0661C0692E777DA85,128,128,0,1.0,PASS
FC0A1FEC7AE3E9FFFB3DC1FE0F32A76F98AF00F9451767A973A39FA53F29DEDE,104,152,48,0.0026997960632601987,FAIL
4E1FEE835C5A05FAF0BA4CD5BB34377487A8D2FFAA023A356D8BFE7E160B4AB3,119,137,18,0.2605890342736178,PASS
13A9107E2126B40BC16ADAF29EE58238E89873FB4B64430DEF7892AD7C9F3C3B,127,129,2,0.9005235503397743,PASS
A9CA9D05A86EE8E2D8564CE080EE9D4DE382B4BC9CFDF8CEDCAA420EEAFBDBB6,121,135,14,0.38157390570502125,PASS
BD760741C695C405D0CBE140427E06D096DFCD55EEAA4A55BEF1101840251786,139,117,22,0.16913144470267139,PASS
1F8B4635CFC03A025955E648F196D575AA032F82B71ADFEB0F2E849C9127E587,128,128,0,1.0,PASS
4A871FC270ECC8D5B6B9A7E8D30EB6D83BB5286FDEF84985269CDC6A42C6F351,123,133,10,0.5319710580974012,PASS
62C65DE07732E3A897BCE384BA406427BBE233EB107C7FB56DF0E95305BCFB26,121,135,14,0.38157390570502125,PASS
5D55961DEEE476E07F90DC4BBB45B02C709756124DCA25592935ED67A9E555C3,124,132,8,0.6170750774519738,PASS
7B61A78A63D7ABEB1C2CF19A7978F2CFF9A1B9E92C80781307180744ECC546A9,127,129,2,0.9005235503397743,PASS
794A52E2CF959323AF7580A21DBE9C09DFDF3969CFF4138AAF2D968C11CD4E38,123,133,10,0.5319710580974012,PASS
9834F7D57382A26B998974ACA0DB3A9799BBFFC81EED129BC40BCB7E4E1C1EF2,120,136,16,0.31731050786291404,PASS
27790F180DE1F6A8AAAC215746660AE3D72568203F1EAA647867695F4DE8A77D,128,128,0,1.0,PASS
3A2B9A725D9108DCEC0471369FE7B1B9489B04C93CA22957040BCAAD999D4336,135,121,14,0.38157390570502125,PASS
3F3D1062C7F1E3E2E858CD57CA4D0CA3A96245D5916356FD8A6EB8A0DBC4530,131,125,6,0.7076604666545525,PASS
CE1E42F32174574DB7402E6B254FC510306AD0DA5E577DDEE3494D672B332151,129,127,2,0.9005235503397743,PASS
BBC70C5BB082B81CA0F855DC09F1CDB6B826C07ABC1EA4FFC7F48148F955B606,128,128,0,1.0,PASS
A3160E65FDD6B8540D4C5D4471FB62F619F3B81CCCA9EAF682849676604FF22A,127,129,2,0.9005235503397743,PASS
C4137C9257382DFC6192274671A52E5656FE69A8F0717C65D151FF96E3139926,126,130,4,0.8025873486341526,PASS
897509F9F4BC34E69E48CC98343C42C905E9FCE804604E1069FF6E0B97046F78,134,122,12,0.4532547047537365,PASS
8B719B70429DCDB4017589509BD822F8B1E0D4963DE9FD95676302FC4C9FC348,130,126,4,0.8025873486341526,PASS
B34A9A0E313B4AFE7D6D4E472B97F859B8A304FC8A207A3965E4AC8FFF997A54,121,135,14,0.38157390570502125,PASS
A96BEA974B8444A55169E2A73DCBA66EB18AC4C84D222ADB9F306D406A6D9888,134,122,12,0.4532547047537365,PASS
A7F547324B427E9332D0699A08EB5B5A9127C19DB723CC64C9495D4E5F53CF4E,125,131,6,0.7076604666545525,PASS
38C7B945E2F63BD7D5D1FFD7C5F1D88443235EF68837F377672752BB44007FB,115,141,26,0.10416255883043901,PASS
9A1AC6AB3F3BF264C972C6E71CDC5558BF4DC1A9729D38BA1B79552D80BFF48B,119,137,18,0.2605890342736178,PASS
5FF027E093ED9732CADF618566083F0870E3B513E5D407E79D5C105B0A0346E0,133,123,10,0.5319710580974012,PASS
710D53A2DDC09E9F1FE57528A89E8156D85F5B0C5CC6F6D8864D3614AC756B92,127,129,2,0.9005235503397743,PASS
F514A4C4B41753D00896FC2A67458B4F922C6D16A9E2DB4DE6244D13F97CEA7,131,125,6,0.7076604666545525,PASS
19F78D1C1352FED6F98D8E29F58500DEBCA5D6B5DD40759A8CE73B81A409B2EB,123,133,10,0.5319710580974012,PASS
CFA11A12D271D74A7520460B4CF6B81734086F93DEDBAE7DBEC86C80E4B1AB1A,129,127,2,0.9005235503397743,PASS
134E140401E6D3C7B88C4DFF6ABD7F37A40771F8958BCD52D36D2459B3D13D10,127,129,2,0.9005235503397743,PASS
C2A59B321001CD86ABBE7225CFDCD198A6228803FE23281B8D35AFB0E4BF33B1,133,123,10,0.5319710580974012,PASS
75BE8C1C82A7BC97D4559C5F52D351FC62F14F5D8910D730D7572EE0D7901EC,125,131,6,0.7076604666545525,PASS
1AB371A3B618B1FC94553BB2F9CC4EA25E027D1BE93E2FF34F3A883A8A278501,127,129,2,0.9005235503397743,PASS
AF17DBAA8552FBB467722E5E08D3CAFD0C1F57B7E608515B54E3F554D73C7890,119,137,18,0.2605890342736178,PASS
7BF634A43A856B868333E876C20263303ED78BA8DE7EA9BC0C5EF5DEBF887548,123,133,10,0.5319710580974012,PASS
E05C80C9AA2A61808D19219EEF4DD9F7E61AA6F4B400039015F0604F69DA68AE,140,116,24,0.13361440253771617,PASS
B8862AC786E87C98BFCDCA3DD48E67781FFE8B9D563165A75374C1918F01B058,125,131,6,0.7076604666545525,PASS
1AA9D94F0FC1EDF71AC970E0AA42B0D018AD74575CA5BDC655BC3C5E87417698,128,128,0,1.0,PASS
EE340B7903A5B73CE8F7AEFC80F350F2E698B612BB4B9056ADBBDF98C14A0817,124,132,8,0.6170750774519738,PASS
275732C21EE2BD8B3508D298EBD1D0CEE3F9CEA35CE7E0931A7C24D1E8A537AC,125,131,6,0.7076604666545525,PASS
C9DE3428A55E4D31A96EF164CC69B6D3D31BFC229CEE28095174024FEF7609B4,128,128,0,1.0,PASS
477C63D68F0E6D0EB21180D93FC8FB0B13566C60EE739C39D9FEA463EAE6A21C,124,132,8,0.6170750774519738,PASS
1E05299D15FA4317618175BE6796162C48A19F6C335BEC1F1D70699A11623C7E,131,125,6,0.7076604666545525,PASS
60FBCD1F7F01D3E13090E0320DD792DCE3501322E38FB02DED341BC826C2FAE2,132,124,8,0.6170750774519738,PASS
DCFC2ABFFEAFF71F72FC401270C85B8AF2A89984A4D12FD26D728187BF14DD5B,118,138,20,0.2112995473337106,PASS
B424297A856673BB83FB76AE4A35A74E06F0082CCB3A06F18CB94E120D716CBD,131,125,6,0.7076604666545525,PASS
B24692DCC1DBCE2C498EE3BF8DA4C190C4CDD766DFF581A0C03471949FD8F26F,125,131,6,0.7076604666545525,PASS
49B47E54CA6F5154F4ED741F3C7B8A425F705CAAB2E7D29658394F9B71995928,123,133,10,0.5319710580974012,PASS
451C3D408AE673417FC5C8E500F5E16492D5E05D8A1160314323570784983CDB,142,114,28,0.08011831372763423,PASS
6B0863C34B41F8E02BA9E4D41997734E665C63DA740CF345F67B6776A1D8DC67,124,132,8,0.6170750774519738,PASS
22F7EA9EC965E3D0A56C83CC625F85042EC7CAD901F1AC3AD783C4679D734273,127,129,2,0.9005235503397743,PASS
81DEE85C02EAAB9243CB793F073F1F7B875B410D43117C5196DC46454E392F8B,128,128,0,1.0,PASS
61C8A4D9CDB78A58B8B7105443B9E261519DCA199C236994CFC0074CE8593CCB,136,120,16,0.31731050786291404,PASS
9BB7AA5F451590CC6C7B6918EE0F74E4CE4EC909846F61D4EC7CEFF4E8E9B43F,118,138,20,0.2112995473337106,PASS
804EFF2C855C0B68327E61A050279B286A9A4066DB606588909BE43FC6D45AE6,139,117,22,0.16913144470267139,PASS
ACED2516ABE21336AC7063C0CCF66936D95F2D4151E17A3C7B344691D1B296A3,129,127,2,0.9005235503397743,PASS
43BA6833732BD8E1B84DB6B938A82BB7E6B5922305B5B4AF742359BBAA93781,127,129,2,0.9005235503397743,PASS
57AB5F582EBCA7A2DBA303011BED571787C79D06195D0B6B1839BA3A2163BF97,123,133,10,0.5319710580974012,PASS
7FD815CB3F15F8B246E15C052585756422F8924867EBC67C2C49175EE2E4A42C,131,125,6,0.7076604666545525,PASS
B759CBCD6BA5F1C49C563A4D11ADF8ABB2A97ED614D038F59488844FC9993FF6,121,135,14,0.38157390570502125,PASS
819F4EA7BEA0B31C4FC06A0AA9573AB0918766DF6DB5D37ECD0DE992E8E1813F,123,133,10,0.5319710580974012,PASS
54A55496341B2EB7A5A9CAF6EC72810EE7B688621A06508443A73A7B51201D95,138,118,20,0.2112995473337106,PASS
4EC509B4B49F2C8446C8D179A29E223EAC70076DDEC77E995281368497545DA0,135,121,14,0.38157390570502125,PASS
F51CAA277A03AE156830338931C34D3BCB666CCDBF342EA88587AA63110F6FE4,130,126,4,0.8025873486341526,PASS
4F3D745E0697F1A57DF1C1CC4CC657B7F63797E0E4913E2D5657A27EAB070671,118,138,20,0.2112995473337106,PASS
F73FEF09EEC64CF0EC731C207F5941947BABEE4D996B6B13F7EF38AA3EC26A1F,111,145,34,0.03358661289689768,PASS
13F3F60C4B5E5E6366FEFF3A29EA1E952C5FAAE9E0BEE16D4700195A5209A468,124,132,8,0.6170750774519738,PASS
45990F9DAA95F418349F7D107DFD228BD444906716B35797044BF34678F754E6,126,130,4,0.8025873486341526,PASS
14490809017237E71B51F43920123FEACAF671428475C8F70EE3FF121229B73,138,118,20,0.2112995473337106,PASS
51261AA2188638827182831121D4F8CC671584322EA3A2E54363AF2F872635B1,146,110,36,0.024448945310089426,PASS
819C3F3BAA93B7659C6474C8F10E5D5D38DF48E16C20EE3EA563D3B44C5E88C8,127,129,2,0.9005235503397743,PASS
A36846B8DE8E3DD9BAB98B6FB4126D8D98D453756DC59A757445A2EAB4AF874E,120,136,16,0.31731050786291404,PASS
5063F551527DC6FC4C720C41B9F4F731F94C32FFDF37928880BB39999FA58F67,119,137,18,0.2605890342736178,PASS
E45A7CBE33066D6A567224F5E2055223B7FF437F87991441361FA3C0227D7A2E,126,130,4,0.8025873486341526,PASS
328885A2810C8398F6577A30500D025439E4F2BB0435E03B3E7DC40CB2F59ADD,140,116,24,0.13361440253771617,PASS
C9DF9E6BA60FC5586566F709FF3D75D060951D7BD850024924C9FCC8EA621025,129,127,2,0.9005235503397743,PASS
9228CFE0CB0172343D6F032EB147F6A03E194D1888CCE120328694452FEB1F0A,141,115,26,0.10416255883043901,PASS
19124EEF9D238E9BDEAC9E81D30D18549154C4B83BBEA9DD1F96682154ED88BD,128,128,0,1.0,PASS
17ED13170519DA0E5C1A085FB9F334379F323D061F7E8D6F3CFB000BE0EA4BCC,126,130,4,0.8025873486341526,PASS
8F7E1ABF89B2D6F10BAD87517F7F4836C72BA676C73EFBC621693DF6DC7DAC87,108,148,40,0.0124193306515523,PASS
6730363A3BD19FB4AE481739C72849BB2241791A00DEB15E97910E861E6C17FC,132,124,8,0.6170750774519738,PASS
7FDEEB5734100EF5C29FD455F9C48DF83015D3F415BA9B560BFEFBE6CDEBCBAE,109,147,38,0.01754895019147673,PASS
29C55BE2EDF7CFD6888E7FF10D06B14BE4094111A2884C102BBC4E54BA61FF5F,128,128,0,1.0,PASS
2ED3EC18E1B0D56B0DC1C70424B4AE39639F1E15CD44C5C2CB883B1D7C48F6B3,131,125,6,0.7076604666545525,PASS
75474468B638E9F13016A7E3D9CE8A0B1D64C6E36DD1B10196D31F15AA4DD648,131,125,6,0.7076604666545525,PASS
D4B093B2191946F5FA71EA28AC8D7CD1C1B51B140591E8CA040E6CCC1821049E,143,113,30,0.060792723530522785,PASS
F431AF00EF840B9104DE6780C984108D2A40BA07C5AF0C183788C48C1739C696,148,108,40,0.0124193306515523,PASS
EE93BA219C5E39DE08F3272E7627917076A388EFDA8871DE0F1D7BFC5428919C,123,133,10,0.5319710580974012,PASS
68165C4D671EBEDC1E7F7F633EDBB5B3AE4C3FC804A31EA89C67CCBF156CABE3,113,143,30,0.060792723530522785,PASS
1850246F2495F8FD224A53B05B43327A2BF2C4D06469C89116E19873B5358A09,141,115,26,0.10416255883043901,PASS
814E095DA7CA2EBCABF3FB82283C77A499AC2FDC1108814D9EAA45E181181993,136,120,16,0.31731050786291404,PASS
7525497C94C197910F44B8631328649600C1AA0D92EF656C9BB83DC2AB7C8A22,140,116,24,0.13361440253771617,PASS
33BFE05FABFF1A213408E6478034255850AA30787C2939E8E123768D614B773F,132,124,8,0.6170750774519738,PASS
11ADFC97B9113880829CB9575839157C0FB900B101DCAFEED981D56EFCFD65EA,126,130,4,0.8025873486341526,PASS
5E21E4EA2CA585B8D251D33D86BB29FFE258E88769CF39CB94BBB4BBA81E91EE,120,136,16,0.31731050786291404,PASS
A0865A81BAA3B82F722C2AA50CF9372E09BE42A6565855C2A688BAF5C5EFFF8D,128,128,0,1.0,PASS
F4FDC0CC836A962E5990F3DD9838E66CEB425ECCC6F1A202F1DC7E5EA09A4284,129,127,2,0.9005235503397743,PASS
888DFE6C3BD0286E14E79BECABF97F0FF8E1E6DDBE8F33AF628EDB75DDE02575,108,148,40,0.0124193306515523,PASS
8D4EACF42D6F19687728F0C1B0B8F771022375541E62569E7F24823FF76D6F88,125,131,6,0.7076604666545525,PASS
762DC8F975A0F6D1F2651510242BE55C68607F028F9C4F2DDE127ACA6A119C5D,130,126,4,0.8025873486341526,PASS
9A2B8C3231852ED1F3D3A55FB27F34A2D11F495D9497325AACC0F3EDBFCCDC9B,119,137,18,0.2605890342736178,PASS
92719E4C51C80B039504FA8DD1520A61E97FCAF438C29B167DBC1B3F2C28E88D,134,122,12,0.4532547047537365,PASS
2CBA0295EBC469B750E7EDB2E9464F9C59B7C466B71D28197D6BBB4E14C487B,124,132,8,0.6170750774519738,PASS
CC8C5005AC0F48B6C5F507874F228D2ED025608CD43D42B6E754E6398169110C,143,113,30,0.060792723530522785,PASS
CF1EC11F477E1ADFE04C239AC0F5D0E73539399D90DC2DA2A94EFAD3CAB59391,122,134,12,0.4532547047537365,PASS
D0FD5B4891B45ED24687A2C3056D22038A92687086B5EAFEEDC605788362B44C,137,119,18,0.2605890342736178,PASS
76E03D7C5B9C15624C59D7B1D56C761D0BE6E460C49C1739E8B305216D7B8236,129,127,2,0.9005235503397743,PASS
E2BE5B389263BDD9C4C1F83AAB1198F6CA8C90039635DD6BE207D4997E2FBD14,125,131,6,0.7076604666545525,PASS
8C01AA05B7C1230C26A8A92B94DA7EE8D7CBD67475370323391281AD833F21C1,138,118,20,0.2112995473337106,PASS
B5921DCC55B4C9A9A7B35561263C4BC5CCAEEFFAF4DE73A09FEB3702FCFE3D72,112,144,32,0.04550026389635853,PASS
313BA9CE2573790631EA88289325148CE92A040C9A69800E88DF04E1DB0434B3,148,108,40,0.0124193306515523,PASS
6EEB16E41C369DE9EF6DCDDFA8EFEFEA86EAB116DD7D819263B4C3C03B0BBC6B,111,145,34,0.03358661289689768,PASS
D8E937B4A9EB800536D14C4E939573E5BDEE5CED6C77D08D1DD622A42FA669F9,120,136,16,0.31731050786291404,PASS
60372D538273E52183642BC9A60390D31E958ABA4E9EE9D408258C037389EE32,140,116,24,0.13361440253771617,PASS
C0ED2F6864F64D6B3B8ECBAD379F4554084E5D7894969A4BE4D27607F156462D,125,131,6,0.7076604666545525,PASS
B1BA403264B0F6B4E4DDD335F5F7D2F0656CEFB935EC13D2ECCF74E25FE4B257,113,143,30,0.060792723530522785,PASS
9605E373AC58211138DDB17C8217E3CF802C5333EE39CCD6D251738C3ED7E85D,128,128,0,1.0,PASS
48BEA48446085925756B95C7768CA68CE2525EE17DCA12171A5DB6B429379492,135,121,14,0.38157390570502125,PASS
5AF99BC1B38883B647C3DFC2C0316AD28E5BBE4951C400C31D4CFD86CF8636A6,130,126,4,0.8025873486341526,PASS
2B9E603D0254DFD474AD8B366ABAFA5A91BCB2C3A3CFA6C01C7A2CA9AE014D51,129,127,2,0.9005235503397743,PASS
205A715591DF13A0E8D7EB19D0826BFF494A4EF8960BE6796F63373C28B3C324,127,129,2,0.9005235503397743,PASS
BA78EC544C50530CAF4AC3B04815FABF5D6E16CD156F0E3925622655E1DD9DA8,129,127,2,0.9005235503397743,PASS
482FA8CFF9152DB8AC181009C41E439DF0CC8C79A7DECCB5C9F4A3DEECF81C7A,126,130,4,0.8025873486341526,PASS
7C98654662EAD5F4FA86FAF2E87614D436E0030D77F707F38355987168D7AEAD,121,135,14,0.38157390570502125,PASS
39F0D3EF5D343C8E3FEB49525CF062E98CADD26023327ECF079390F8AA097A62,126,130,4,0.8025873486341526,PASS
3498FF5CDD8F44A41D30C9C306BB0D857E0B1ECDFA529BFC836FE83424E0811F,128,128,0,1.0,PASS
1BEB7ED4EA9C9E43851F38488AC9FF2422DB5A0CB1B22AD4605232C1D98830BF,133,123,10,0.5319710580974012,PASS
408408FA774CDAF5905F96DD54E7C3E55AF31BFB3540BB13B759507FE0F82B14,122,134,12,0.4532547047537365,PASS
14166DCEACC865233540EB9DAC1A65D8BDD03D4D82B695957291B338AF6EC6E5,128,128,0,1.0,PASS
89EE98429FA655190CB1275B212158D976C2D562BC84178EB58C5CB016DB7B22,135,121,14,0.38157390570502125,PASS
F537D5E4C8523EF244EC4E81DE26B40E47A8DA3EF44A49F0868589DC60379600,134,122,12,0.4532547047537365,PASS
D70EC0E14E8C37D7D1C323B715C5972D97CFD98148D3B61012F064C1DF2165B7,128,128,0,1.0,PASS
CD51AAD66DBF83BFC9CC748CD88F9AA4872E94A05A056E97230886430260B095,137,119,18,0.2605890342736178,PASS
45F4AF470638F203295959FE6272485E809C2A1DF85DC3B77289B9707592FB87,128,128,0,1.0,PASS
18DFC73570C2566E3FB1993CDB5606EB3E76981FC64D4E0112F8CBE6E2C64130,127,129,2,0.9005235503397743,PASS
9F64ED82F531CA82117702D70C4EEFC2EEAD6F487A70D86FFD9172E1E5959FC1,120,136,16,0.31731050786291404,PASS
B604D87E8E17665DB9AC9D2726CD36A4CFC320ADF7187CCC0D3FD8A5EC0C215B,125,131,6,0.7076604666545525,PASS
440A7B247E8995D72DA0A12A8EF856A33C261C780DE2CF5A3F5A3365659D1F98,130,126,4,0.8025873486341526,PASS
7B392566B98B21226BC190F8F89FA21307FDD5645208EBF53847633E0203760A,134,122,12,0.4532547047537365,PASS
139321C56F6E1E89F857852C41F166FC05E7752F4C5D76A0713F748D79D3A669,123,133,10,0.5319710580974012,PASS
F893CF8A39BF5853965579540874995F6BDDE0C1B1AFC3DF7DCE8A5BC6CC0DA8,118,138,20,0.2112995473337106,PASS
44B0C409B56C944A40FF3AB78FDF13CAB39C2207B53361BC5E6FD9A4FDDDE3DB,119,137,18,0.2605890342736178,PASS
6967CBC56A9362CD7A3AE10D89CCEEB842EB3F4DF7B80C87D9E137A860ED3D88,122,134,12,0.4532547047537365,PASS
F1E3DE1EE351B3282CFF4D1D3A916C6E7DC367D286F5D28434D4C49848759005,128,128,0,1.0,PASS
3EA500634129CA104181C740F03BCD311C2F4671BA0BD89CFF620C9C4C971CEC,142,114,28,0.08011831372763423,PASS
3AADAAE84D90459A8C5BD9FC9F6B3458297D0F7B5B9B17A68DD37D5B3311380E,121,135,14,0.38157390570502125,PASS
2E9192B67086C9970A9212962C4AC2D1B93A10A639F2B70EDC87CE6ED95DD8D7,131,125,6,0.7076604666545525,PASS
A10F37711235826B5718A206ADC286CAC0C5A837CCDAB6502B27662773694C97,137,119,18,0.2605890342736178,PASS
520BF36C8B3EF4AE3D9845B7A022AB918115F5919E618685154725002E8A2ABB,138,118,20,0.2112995473337106,PASS
2A8377CD10F3CEF904465DFBFAAEEEFB95EAB03C2532E2CE3D6483F05FAABF89,115,141,26,0.10416255883043901,PASS
DEEBF4D083998071315BBF24077DC34F53E3758472135EB84EE9989B4231C4A7,127,129,2,0.9005235503397743,PASS
7EF42119FA8F9A327E61DE4F9BB02C78044F17AB0ED388B3078D3EE4000DAAF6,128,128,0,1.0,PASS
833406F7624967CDA6CED6BD9763065BA74C5143EE068FF0743A7FCD21C9E79D,121,135,14,0.38157390570502125,PASS
EDF87D80BD71665BB2DD8B8469EF7EFAC0F56DED259A9EDFBCDED3142541FE91,109,147,38,0.01754895019147673,PASS
438F876DEF1F9100F329EA0CDD1C4B878DBDD287597A2AABCC9CFFA6C5D2A4F8,120,136,16,0.31731050786291404,PASS
B59B2920408C6F92B22D09808D678C3ACB03C55A22B9C94926BBC7DE1C8C8488,143,113,30,0.060792723530522785,PASS
31AA1D4DD215C05CD55CEEB57A837E5EED9C4341E1BB72F875CE7166AAB98C89,122,134,12,0.4532547047537365,PASS
28DE21F26EE4D820CF507A14EB2B4F386AE277FFBB5CCE51330C9BB6B490A5DA,123,133,10,0.5319710580974012,PASS
60409A222415A657E8EE6DBD1C2C56D6FFD2E181183D5E47951D37F77AFB0EE9,123,133,10,0.5319710580974012,PASS
6D6C6E7EF8AA5DF40D53B2751736A11A43B703B8DD58F935E54F4F903ECEA82E,119,137,18,0.2605890342736178,PASS
57CEB7C0A3183DE037FA0D9432E4B606F8D9B0E2B807AB6138EC24D7EF79A8B4,126,130,4,0.8025873486341526,PASS
F033578E82E4B1455EC7CDD40E0455BC8A959E788DF2E1FF37F79A74A69FA9FC,117,139,22,0.16913144470267139,PASS
108A8329A527B14E96ED4A459E3504CEA3008252496D57CEB775F930BAB6C720,137,119,18,0.2605890342736178,PASS
FD38F8BAF264019A7BA9169EE1070F6C73FB0A820CEFF38C8EBF41D7D8332F77,118,138,20,0.2112995473337106,PASS
81E06D1FCE4D5CF07519A583BE8F0D50BE1C35CB1E3F48908892490E90DC7259,135,121,14,0.38157390570502125,PASS
A3925C1AF5A58F101AC8235DBACEE307ACD650CB0236DFC4F3C178F4031C2F9B,130,126,4,0.8025873486341526,PASS
A96E120FC2CF508998FA367EA5B50DFFBC82076D84255E55FA3C92B744EF0FC0,125,131,6,0.7076604666545525,PASS
3461D2973932F481E0D973625A3660BA13A0837552E767FF05AEFE74FDC61004,130,126,4,0.8025873486341526,PASS
AA391EB193D98E6465A6F21BBEBB8276D16C517A36AB5301E625A0F58158B810,132,124,8,0.6170750774519738,PASS
5B6968FCA9A37B15E43291DEFDDA9899544573E5D73E30F793C47327ADEFC275,114,142,28,0.08011831372763423,PASS
B02C57C4E83BE677ED5D3D3BB9FD3E83C1D48EE47603A6C5FC5A10BC69CF3D75,115,141,26,0.10416255883043901,PASS
FE1C38D6AA7FADF1F3EB6CBC811351326F363ADD123F8AEE4743FA6D429B1229,118,138,20,0.2112995473337106,PASS
CC65B7D1E7817F43DEA904FA7620CF7792C815501FE74B858BBD6D3A23D85AA9,122,134,12,0.4532547047537365,PASS
397FA53706872283BF8FD5585225D758FEA62699516D0491A7B99D48DFE6B326,123,133,10,0.5319710580974012,PASS
CA33ABE3CBB2CF80B9867D021125126B98EF18CA2889C7B8C41717D9BF6A58B9,130,126,4,0.8025873486341526,PASS
5FE7BEE060528990D47677390CC070B6F03261A0B5FD2C5CDE088F69B5EBFE37,124,132,8,0.6170750774519738,PASS
60CD7A8567670010542B22D686E5EDA60052DDEEE404685B30547AF54BA9F079,137,119,18,0.2605890342736178,PASS
FF515D3EFD354CE5645E8A21D26E805FB74E355049DD6054232743CE81CD4BB2,127,129,2,0.9005235503397743,PASS
57560AB6AD6FD399876DCBF1BE18B4993886D185D27848E6FD1FD2C29F313F0C,121,135,14,0.38157390570502125,PASS
E6584E55AF307C004298AF843A8C6AC1CC9C3B3DE00892637E9B28E0BCCAB01A,140,116,24,0.13361440253771617,PASS
BB9D36EEDA6022A6D74B2BFCA117F3C49DA46253965B73E45241B05FD6EB92,125,131,6,0.7076604666545525,PASS
2A83D7DC367DFC5583071992E40616012BB57C28B7DE40261408E76817EC184F,137,119,18,0.2605890342736178,PASS
33ECB71323318928DC370BEA75123DE08E88BE4204DDCF9FCC7A381F5BE3034B,128,128,0,1.0,PASS
6E7962649A4101D6AEDDE6A6C787821239F4D74A49CE7ADDC6BEC6EF40A4B708,126,130,4,0.8025873486341526,PASS
6356D39DC932ADFD8D848CB496565DF239EFEDE5789B44B483058DD713591BC0,123,133,10,0.5319710580974012,PASS
FD27F7DBE1AE9559B6DE5BF504B1352C030E7780DCBCBA816EA617DE8987056,122,134,12,0.4532547047537365,PASS
ABC15C2D5A67807B9DABFB78E31D0E7F3279DFF6628435654B191B13FA334795,118,138,20,0.2112995473337106,PASS
8084C2B5EDF892F0E9B1516A2C5689858F89D97C366157C232A06E7EE968EEF4,130,126,4,0.8025873486341526,PASS
54546ECB8DDC60F6172CDC94E2680AE46A15234C452010FCB32BCE3FC6B44C5D,135,121,14,0.38157390570502125,PASS
C61C9D464611A9E8536E4003EF9B8033C93B77514E9D85817B7AEECD8DEDA83,130,126,4,0.8025873486341526,PASS
CD9C6A23FF36DB473ACD4248946B0028B9283DD8C3A30EDE9F07A06A57B8D1FA,128,128,0,1.0,PASS
6680C7CF573D36EAF93AE6F8ECD795D1F539A71833D935689BCE1107063994C2,122,134,12,0.4532547047537365,PASS
2613AB520C02BF21D48E05AF0E50CF81D7314F688238698A25AFB98A7F997F14,135,121,14,0.38157390570502125,PASS
EDDD02988F28BEE50C932AECF217A6EADAF144A323AEFDEA0CBB7A747939FBDD,115,141,26,0.10416255883043901,PASS
4B962DBC34B45390C6C9AA2E9D90944D036BAC97CD3CEF6E83204406AC63D105,137,119,18,0.2605890342736178,PASS
700E179218A986A36E540CF78BC7EACE3AA6CF82A947B6EBF4B140CE48775C39,128,128,0,1.0,PASS
55401EEA9A24A0A0C2022A52CF222E532621DCFEAFCD7506E38942E1FF7980E0,140,116,24,0.13361440253771617,PASS
E6CAA72293895AE3E5FB03E2DC1D39CD5CEBCE6AAA9702A7AAEC2D9CD1517D73,119,137,18,0.2605890342736178,PASS
2843E59744F8601EE9AE896534A4BB0D7F2713DDED9E24AAEE636AE23B5079,129,127,2,0.9005235503397743,PASS
644FDBBDE1C6FD5859E3C6336B00E9F370E994C23CA6BAD55C0EA21BCFC274AD,121,135,14,0.38157390570502125,PASS
3D6B70EAF0A327BA80D4C59B4C5365EEE81DADB7216BEAF790B9FED6091585DD,119,137,18,0.2605890342736178,PASS
233DEF1D1511C2AD10083642B0E6C68FD750AEA3833DB91EE2CA11AD966FDFEF,126,130,4,0.8025873486341526,PASS
D160935A18DFB1D4566A2A7C8B1D11EFC410ED4F0024CC52AF52D8875DFA7C24,133,123,10,0.5319710580974012,PASS
6E2DE9C0C6A1C1A70CEB7F29B730BE607DE22E9BE9280ED039E1DC51EA582C2B,128,128,0,1.0,PASS
8C73B89E6950344DA24BC8A9A985D4B03007A76EF94BD44541A6038946BDBB7,137,119,18,0.2605890342736178,PASS
F0394C8F650F1436C0F9B11E7B73EDBC55E47592010E808051CC5229D20ABC44,140,116,24,0.13361440253771617,PASS
79FA30A4C95C9C05668C38F0477F49296929FC137E45BD984354BADA1487E70,133,123,10,0.5319710580974012,PASS
9EB71781A5AF2ED072D479B93315950DF0CE3C46C1FD28CB549DE4E284E81113,130,126,4,0.8025873486341526,PASS
C63DB4F9F327EA03378337DC43A7E2CB57E93C19F3B5D561E03B7FD882518F2B,116,140,24,0.13361440253771617,PASS
8692AF0EDD94645E39ACAFB7FED0B0A2E2EAC8A57E1C4D9642B1A1232E46D06E,128,128,0,1.0,PASS
9F22C3249884E4B1B7283F3348F9B23FE4F63C4C3B93BB80157F5D63DAEB7999,121,135,14,0.38157390570502125,PASS
24D8511906FC7BA43811ABD2AD38FCA251DD1C3AB926F545B08C1F9281382271,138,118,20,0.2112995473337106,PASS
BC7E7F33184BB5521753220D22AB6E780719292967623D59CA7CA0CA4A4E3410,136,120,16,0.31731050786291404,PASS
4D2CD91EAA780DBB689AB73451B1130EF4A68ED57B6C0051E24C8069C1E1627,138,118,20,0.2112995473337106,PASS
782E1FA05F131980A14DF9072C1C9157BA9069C925D583DF1A93578E3156F579,131,125,6,0.7076604666545525,PASS
BC578FF43631880EB923C6AA5B06518CE5F5094D4CD59033D34C8FE817A9E937,129,127,2,0.9005235503397743,PASS
AB24DD4B5F5A6DFC8FEABC2681A621F90A6A266755C1F60E1B4A2DDB092B37D7,122,134,12,0.4532547047537365,PASS
604478066B4AAB3F6675716FA317209B782F780E726B86B1A2190029F75ED907,133,123,10,0.5319710580974012,PASS
7898CA9B00F3142C01596DFAF9922E23F708502382B87C2192F3F57B0698F6CC,135,121,14,0.38157390570502125,PASS
1BE9E56F8EC75D0264DDC33EC7F3C8E3C9E269C1158B308DD5BEB6A7C16FD014,121,135,14,0.38157390570502125,PASS
CF83C926C4890077EDF15F9D81A270F0400828FA4B66B69BAAC5DB3C911B1E4F,132,124,8,0.6170750774519738,PASS
7178734D5455D2CF81637D01F7317E86C7E5721B2A73D6CB3422E1ABAD477B85,122,134,12,0.4532547047537365,PASS
28C8AB642285E6C03FC54D978BFC19CC357227A08519430CB32D1639CA025D80,143,113,30,0.060792723530522785,PASS
90BA3095F89AE3C3B562A39917EC2A32753F06AC2A98650BE344AE799141F012,136,120,16,0.31731050786291404,PASS
F58352F2641CC8D35741A107C85F27AD4FDCCCF072F7465E2C0BD86EC7EFAFDE,118,138,20,0.2112995473337106,PASS
515E7D8C83DEBDFD54E008CF22C9EDDA9964115EFFD8CF7243DE011810861C36,128,128,0,1.0,PASS
CC74C391FFC15A67E9E3814680DB781D637BF0AE0DA71F4A8E82970541A9042B,132,124,8,0.6170750774519738,PASS
3C21EE17C3F846507BCFB5F8EA8FDD83368E05F9F93D77A09A3B57452A4F3AB8,117,139,22,0.16913144470267139,PASS
881A0774CA7DDDFE58FFF6B129ACA03C648DA8CC6DFE5869A11BF7B525CC10CB,122,134,12,0.4532547047537365,PASS
1EEF7B0620762D5EDF38109388CB9A40D6F925E8263C0855348C00FFCAC00E06,140,116,24,0.13361440253771617,PASS
EF23F723684A3E2850C750C60E21F29AE7795E2F26554E07EEE339C6D3EC4650,127,129,2,0.9005235503397743,PASS
149BD6E9D4F18FFD0A89DB6B8D46FAB98A98EC4C2CD6E709D376900900EF92A3,126,130,4,0.8025873486341526,PASS
6BCE433BE4EA4E2A829875CCFC494566AC18E847F92058EF5CF1A786D08030C9,134,122,12,0.4532547047537365,PASS
6B9EE16C197E058B4EB8D83A644F2AC93CE7C24BA480E473FB54B12CCEAC73EC,126,130,4,0.8025873486341526,PASS
820012072E4F55D434B907F02F08234D71320A5AB1D937D015FEE3E8B70E7CC2,138,118,20,0.2112995473337106,PASS
C68EC516A1202893C0C4B8BB74FE2D03D58893DA6E7B0FEF1211BC3A8CEDC8F3,130,126,4,0.8025873486341526,PASS
B7EF14A8A1C5AD72694964D0A9B5CA6D8884F8D2698A59DD1B5E28B254BD40AA,132,124,8,0.6170750774519738,PASS
5357F2DCE42F684828A71E8F6F1AEAF58B71EFD576A055FC423EE528B2DF63FF,113,143,30,0.060792723530522785,PASS
15AA18730BD1CDD97364B8CA10DD0186FB07E4BC677485EF03F0A9FF7B9AB589,124,132,8,0.6170750774519738,PASS
C5527C5900202658FC9DCE5A946C658CBDD2B1E5210BED296E180B5A5F1AD9C7,133,123,10,0.5319710580974012,PASS
4919E697920DC6C673BC32D1AADA762C0FF0A84EABA1F7242586E0651D13D7AC,130,126,4,0.8025873486341526,PASS
9D66EF938E76A9EC7195112FFFC0AF017D05ABE6357F4402F6D982202A8F7517,123,133,10,0.5319710580974012,PASS
26E94C7081BC050E9102009D0B56BFD4885965D8E9B9034373BFB089F7BFB324,135,121,14,0.38157390570502125,PASS
4E1237BAAC68B5AA2CF43974934E70F32EB6A1F070B168F9705BF69169EFCE54,123,133,10,0.5319710580974012,PASS
27A98669C36BA97328B417C63FF66818EA87E3565FD181460980F90EF81C1436,133,123,10,0.5319710580974012,PASS
F33F45B7F9D9B3CD9E6BF4B403AC4084E09FE01A89AFE40C7E9B7D0AA680BF57,120,136,16,0.31731050786291404,PASS
983C4CBDC0A25B76742AC818A3CF8761AC1E652A0A88B2CEA5FBD4903D294BA2,136,120,16,0.31731050786291404,PASS
BC38D1B221EF8F2098F97EF6DF4F62926EC73FCA8D8B26550EECBA706A43B64E,119,137,18,0.2605890342736178,PASS
765BDFF8028E63578CF664EC0DD4DBCEA7866C66C0A2F19D6A65B8C12AB31309,126,130,4,0.8025873486341526,PASS
CA7A2A31DF559C267F67AEBB3CC50B7873B117D66A2B91F8FA78F2065BC521B5,118,138,20,0.2112995473337106,PASS
8CBBDC342688E1780AC6C837605EB7E16DBC0B0FA6C57A91163982757C0861F9,133,123,10,0.5319710580974012,PASS
810C8566D542A8A10254F5B1BAA8A38EFDB2C7810B4837EA913B0C0019AC243,148,108,40,0.0124193306515523,PASS
B64A5F215D03D94F48224E7069941D1A1F2FB46CE7908DDEAD3A0FFCD4809E1A,130,126,4,0.8025873486341526,PASS
7D92016B3B2AF5C22EDABD196B812F888F3D078655DE261B95F4ECC226438DD7,126,130,4,0.8025873486341526,PASS
60B9B4CFE7DE71ABA6A6EB43C683FADA847ED3CE81503347107B5F6A6D37C64,121,135,14,0.38157390570502125,PASS
F2F948E1AB8A0A2CE216DA76B97749CCD3A23F37E9E8B768945FEEA07CB9E1C4,120,136,16,0.31731050786291404,PASS
A11925D7BB3103CD1E97EB7519DB26D588E70067FA95C02E0AA616166B9EA20F,130,126,4,0.8025873486341526,PASS
10569468496B926A00E3D4CD533F573D3F7DC937349ACC81178B0564DFC015F4,132,124,8,0.6170750774519738,PASS
D00DC35DEDB2290B652969D86EB2EE63F5A27D83BB8E2F277D20B0CACF3ADAEB,119,137,18,0.2605890342736178,PASS
C334E8641EC5B95A317F589F89BADA8F994A7891F0956B079D591F3A0F337213,125,131,6,0.7076604666545525,PASS
76C0178D20F789CB42408034E45B6F75C295B68C3CB1B232973F2BA1A8FE5A5,134,122,12,0.4532547047537365,PASS
1523718C9F474CFFFDAE7813F432A182ACB2168D477A71318F7BE8276FC685B7,121,135,14,0.38157390570502125,PASS
A169A5284B1651ADD2293A7B952B15D6E2174745F9D68027C9D4CF85F8959A58,131,125,6,0.7076604666545525,PASS
F2340BF4395AD347159D8303B38B8DF2552D3540DE93ADB5DC9D8076A08240DE,132,124,8,0.6170750774519738,PASS
B29918F5A979068058CBDDCB170C7DD1129F2661D8398B0CE020701FD5EE66C3,134,122,12,0.4532547047537365,PASS
9966464B1DC80DC2A2A22B015A34A7AD3CB7A2D919DE1CDD7EA232230C7433D8,135,121,14,0.38157390570502125,PASS
F4A2D9E0933555F5FF5129499980697FAECA23E941FC74AEB26A52AC5CA22904,129,127,2,0.9005235503397743,PASS
EA0C0660019ABB1777EFB6B6B3804EA95A64A323C5B5DA25AF6421A9A2A17B7A,130,126,4,0.8025873486341526,PASS
F2427C70A94AE7357E1A4D9600076CCF137626F9CC561DAD42530994D564C660,135,121,14,0.38157390570502125,PASS
C52653F4A31831C838381457DCDF4DF8FF6B2FD963EB3541E1265F3D49E44069,125,131,6,0.7076604666545525,PASS
5C0B51B1B0F557F8EDA13559F0DF4F171B07CD94A14C385E4E2CF26E1272D0EF,124,132,8,0.6170750774519738,PASS
5B9F38732555B24B40A74E7D25E5BFD0DF1C2B0CC5F646FCB6E957650A2150CC,124,132,8,0.6170750774519738,PASS
75CB27FC3F1240DC89663C00A6A1FA634630DD3689F26CE47F01555C5288103B,136,120,16,0.31731050786291404,PASS
4BBCE97B5FA1B108B952527EB5DD971D06B7CCC47379C395B9F800EF5E8D2296,120,136,16,0.31731050786291404,PASS
3E1D6D4B567D045131AF2527E3B2DA463250E7CC6A5E53EB5009532CD3CBCBCA,127,129,2,0.9005235503397743,PASS
41FD60DFB16C1B5D1AFA2CBC9F67D100C720C070235B3829A667234E3A14011E,137,119,18,0.2605890342736178,PASS
EA6FE32BE94C5C67314EBC598BA7C9B61065BA761AD776A43A317AEB78A33B86,119,137,18,0.2605890342736178,PASS
AD0B9A1F5B5D3C5E2B206D442ACE972C651FD60D461320C35FAAB80D5F4511D0,133,123,10,0.5319710580974012,PASS
34FCCEBFDCCC1A8B7CD9A511A1F0F70F014A245A90B9AD2DE91400B924BB5621,133,123,10,0.5319710580974012,PASS
D879EE4EF88309119C58F11AF0E0D91E4E557E943D0F25275D39DA5F1394EA43,127,129,2,0.9005235503397743,PASS
84D47A59849F1DC8861A4E99C8A0ECC02C1311E84FB68AB8F0A4BA1481B7663A,141,115,26,0.10416255883043901,PASS
6BA13D6D0A4B770780A6BF0533D23BC97F13874E38D914AB619A57AAB0171A8B,129,127,2,0.9005235503397743,PASS
9FCDAB5099C3A9D03BD70C374F9E401EADB5E238D7B3EFB758AC399EB235C6A0,119,137,18,0.2605890342736178,PASS
6672018ED2985E51BD37A8ED932BF8FE805D81D39DDB3E25F6A559351DFAB7D4,118,138,20,0.2112995473337106,PASS
E24A6354457846941D345A27FE07506CC03B752C5233A611D6895E9C3FADB8C1,135,121,14,0.38157390570502125,PASS
B6738344B5984E40497452529DF6EF349780D3A4953D68E4846BE59969A6F431,132,124,8,0.6170750774519738,PASS
E963EFB7093A1E561B2BEA9390ED440DD2FFBFB9DD2A56CF8487913AC3503380,123,133,10,0.5319710580974012,PASS
32DEC18FCD554F7D3FF08E010F59DC233C0BF91A882BD315E5D59CA407E27F70,124,132,8,0.6170750774519738,PASS
5624A48B9D43448CD1997CBEA9ED5DDE04F0368190554FE4B07C8BD3FBC8D518,130,126,4,0.8025873486341526,PASS
8215D50D9CD9989FC32E8626E65FF4AC06D71A528969124293493CEA43C7D946,134,122,12,0.4532547047537365,PASS
C5C5050879327628E8617200AE8E68CE642F080908A5076113D4B4E79BC57ACD,144,112,32,0.04550026389635853,PASS
21F775E71AB2B36F4EDB1CCC46848F16BC52A2FE2733FD8A7E6CAA67191B62F3,117,139,22,0.16913144470267139,PASS
5AE9A0B4530CD8DB5949144A38A60EA29C66B4ADEA7C9EF0E8CC81C95CF1D1C7,132,124,8,0.6170750774519738,PASS
CEA93C06A963E6DCC753FA387C5EFC78BC6F2E25B196709831E6D8E892FC7C34,120,136,16,0.31731050786291404,PASS
A6D65B8FA3921215806353CA612FFAA537EE1E03AAFDD5011501585AE88B48C5,135,121,14,0.38157390570502125,PASS
B0B9E59363E0D9F177AE61347B9D024A5DD20CF85F4C1557429449FA0F41ECB1,128,128,0,1.0,PASS
1075C0B478668C8A96B6AB746C8E856EB5BD34D2F20748B744B5B73D416D6CB9,128,128,0,1.0,PASS
CEC4788EEAC2525FEEA47FC8D20E7876EB6B3DBD7EBDAB4F2DDAFC9A8D19CBA5,109,147,38,0.01754895019147673,PASS
D3B49810A933A5C8B8B664E277C64E0119911F6A7FAEBFBF48B6E94311BD636B,124,132,8,0.6170750774519738,PASS
2657DD3E27C943543A0323CF29B5F60B7253741442167D13AF95C8736CFF57CD,123,133,10,0.5319710580974012,PASS
458DE27318C248FD5B1C7EF05E2F9BB0BA139ADFEE7D713837E1100D5E49988B,124,132,8,0.6170750774519738,PASS
5EBCF5A93E0859E0B7BC7D1315F25D4C3D329E489B0DAD192480ED81D0FEE1CA,127,129,2,0.9005235503397743,PASS
FE704CB7108360F3DB27EB623DF12E92296D528AFFFD4D44C51D2DD19AA1DF53,120,136,16,0.31731050786291404,PASS
8E2DF5254FFB589F6D96E95B29038FCE674A9F098B9C41C999FDEFD923EA56B7,113,143,30,0.060792723530522785,PASS
BCBB018549621225D2CD5BEE800E2A13236BD569BC7693C162E3266559CDB6EB,131,125,6,0.7076604666545525,PASS
3EA4AFECF3E6EEAB2811381404845AA94F9F1798D42189D878354212CD6FB795,131,125,6,0.7076604666545525,PASS
C33974B4ACF67E80791D4940C2925020B1B319E8C9620479E6A90734E6B4BB41,140,116,24,0.13361440253771617,PASS
19CC3E7E0FC2EA9DDBB0B3DB01CBC5CF764D52681A21317FD351BD08E3E71D61,122,134,12,0.4532547047537365,PASS
347D8193C03627DD927C848AEF07E9DDBD05440396DE4D77400F46A75A104FA0,134,122,12,0.4532547047537365,PASS
7099C3AA5EC017B71F81810DB4F54CAB65F8C8AC3EF3F04F9E82D5D12CDB305C,127,129,2,0.9005235503397743,PASS
81B1672D4DD685742CC4213D40F07F1A7D42A4A4E20841235218A377C731128B,144,112,32,0.04550026389635853,PASS
79A8AED8A7914A3E17E08A69CFB76BB0C0FF198260216166B5D3A6D463AF7225,128,128,0,1.0,PASS
9E16A326D71762CFE65D624A80015DE514F1745D38C41AFA4841A079504E1C7D,137,119,18,0.2605890342736178,PASS
B47F1AECDE7E39B5B66B4121AD9209A44108CC9539704F73D7E85F140D6CD288,130,126,4,0.8025873486341526,PASS
B2FD7CBC6AA69AF38E7399AB3F69E836E81D2125A83C48056E9570FC4165B973,123,133,10,0.5319710580974012,PASS
177894D88F700923340B79F98E29313BE02B8B1A5B7AE9046894254411FB8AA7,138,118,20,0.2112995473337106,PASS
796B11B5C5EE82B89AB8CC3F3F306198292097C63CE303B942794D699633EF40,131,125,6,0.7076604666545525,PASS
9F2D8A93CB261CB2EC8F1A2C986D68C686181CF6D249A5E01D707DC7000B767C,134,122,12,0.4532547047537365,PASS
537019BBAD57C8B6170ABB3C9B3E32351BC09C72B39C6D943CC8D7CF10FC5C5B,123,133,10,0.5319710580974012,PASS
5B2C2757AE1F5671EA81ECCCACCC830FD0075A6FF7D0DFFBD29DEBF354821E9F,114,142,28,0.08011831372763423,PASS
1671F64BF73E66EEC01F6A9573F17BC909F751FD6AB76E05AD470312B619D184,119,137,18,0.2605890342736178,PASS
623DF57610FBE206DD3EA84AA17C8D8A1269175603CCDB4A65C65B6E534F07B7,126,130,4,0.8025873486341526,PASS
99661C91FF18A2AFDA7F97397651F43BCA11FFD48223F6527E395BC47D456B,120,136,16,0.31731050786291404,PASS
C1EF333223F94FDD0B8AA1A677E4FA71DB772704C9BF2D45DC47A4DA254BC5D6,118,138,20,0.2112995473337106,PASS
DEABFD0072CF2C2ACCEB12D4F4FABF865146789572CD7148B18EE3ED714EA694,122,134,12,0.4532547047537365,PASS
DFEBA89FD34818E3620102FCD5A9962A975D71285E679B5B336E3C0DADCF1291,125,131,6,0.7076604666545525,PASS
90A02DB0BCE75472341715DDD8304A4EC1526FCD44DAC44CBFA63071634CF13C,135,121,14,0.38157390570502125,PASS
EA3CCD96DB4A45BD9F1BE0364DD95AA15123D240A4B14D826F8317B7CFC58EB9,125,131,6,0.7076604666545525,PASS
427B953AE10577E0DB2DCBD49601F5F2EE2D9D451C40BF150BF6B10397A248ED,127,129,2,0.9005235503397743,PASS
44B8B9BF7E28D675EBF76AFEEAC9FE4E8BAB42C6D0AAE06C3F3EDE6345D8FEEE,106,150,44,0.005959526470109114,FAIL
C0CF79C5C3E96FC5B9EAB0FD2E48557DD7CBA3C07365CF7403880B29C38F19BC,121,135,14,0.38157390570502125,PASS
6A496E5EE8A71B8D295E7EC4F08E48D3D78F7207CE00A4D15D16EFC10F501F96,127,129,2,0.9005235503397743,PASS
F8E57A0F9EA3D1D2ABB4D96A2E5C8E08219E6519AEB1AD191E3127AA2BB0FA73,125,131,6,0.7076604666545525,PASS
F1EC23ADCC471AEFE3882DC90FA8A9542A247665944E29F7BF3FC38FE2446A64,125,131,6,0.7076604666545525,PASS
A853AF853F35CFF00E2B4E24BF3DCF2588D5966D93D19FA81321681138E3405A,130,126,4,0.8025873486341526,PASS
8486433791442C43507580733E2BFF9B4687C641FE1122F9A5CF94220A483FBA,137,119,18,0.2605890342736178,PASS
A46648A5D5A93E50DB2928F5B051F3DDB5E334E2D0CBD26488C010F606DBF565,131,125,6,0.7076604666545525,PASS
941C5E1285329C2BEF8E8C164B4C35D0EFDFB18C00ABAA13D71482FA49CAB26C,134,122,12,0.4532547047537365,PASS
EB8AFC90D137FF844C9C93B15115B34B6275F6B602E31A607437F788A2DB7406,127,129,2,0.9005235503397743,PASS
7D853F5D61EDA8EBEA4A67917EB822C2113602365B8BA29BE394028B75CA1704,132,124,8,0.6170750774519738,PASS
4A16F2FA28F80A8D12976B1256044C95FE0ACBC6781E5E72CD35EF05D0E4E5FE,128,128,0,1.0,PASS
1074A0900337298613517FA143880C635BD12A6AFA00EA750751878EDCBAC3A3,143,113,30,0.060792723530522785,PASS
1B5A42DA847D7756BB94571DFA84B96E076C8C24677914CA3AE5556FE59E3F66,120,136,16,0.31731050786291404,PASS
E67435BCD3A58D2AB1754B5E7A6D0AB5C0619F7C5BA070058FC318E3F1ACCE73,124,132,8,0.6170750774519738,PASS
A30948E3F9730665AEBBB8A99F2B63AC2E05B1443F4193A0C982FBCB6DD240C,133,123,10,0.5319710580974012,PASS
E446CE3D629AA550BCED1FF72446FAE2FF91F395B4FC7ED67DB48D2BACD76C7A,109,147,38,0.01754895019147673,PASS
5F8EFA208D3B209C8AE9E54C804B00E52ED88F554448976E345AD3A5CA7EED24,134,122,12,0.4532547047537365,PASS
5C8D20C96A117EFAC195C3C71713601A53310FD81C1AE626954FA9791786E9DB,132,124,8,0.6170750774519738,PASS
D2B9383E98ECB1D8601379C8BEAF9DE822069E61DA5470F0D783CB76E31C4998,129,127,2,0.9005235503397743,PASS
C476D345CCF6334078E793875FC0F1CDB0406BF780CECB49B9EB8689FDBCC647,122,134,12,0.4532547047537365,PASS
AD232924FC1EF1840A7DC213EFBF8392DCAC6F7534A1DE4C652443239875F77F,123,133,10,0.5319710580974012,PASS
78E5AE5D309F0997192E40CE1683C9F363A0BF51D356137C3C023A787EC95602,132,124,8,0.6170750774519738,PASS
8275CFCAA78EF9840F4ACD5A16A4A930F97CF48EBCEC79952C4049E6017A251F,129,127,2,0.9005235503397743,PASS
8D29945192B43231F896E1D5B4286A951B236C7E66BB6D9AFEB3DE4BB75C8674,123,133,10,0.5319710580974012,PASS
99684F46EAB7D23F2C827A1F0393A17D3F6C4E2448526FD2D5EE0FBEA80FF57C,120,136,16,0.31731050786291404,PASS
E979D6D892CC75EE0C79FCFEE165650EE9A1EA5AEE0C4EA45DECE249E1E0C162,122,134,12,0.4532547047537365,PASS
D64204BD8E62F3DFCC091867745517DDECA09C8C0DD42E9901259AF0A2EC270D,135,121,14,0.38157390570502125,PASS
D287560BB78687440701EEA92986ACBD62BC317F7E226BA00A6456C4A1597FC9,133,123,10,0.5319710580974012,PASS
3FB3901FBFCA89EB629C9C05DF71D0D13855F306847C15B7C86E6ECE77A35361,121,135,14,0.38157390570502125,PASS
ABCBD337EB47CD9EEC21329F523E33D87648212E32CB1195151BEBFA8760858F,124,132,8,0.6170750774519738,PASS
58439DDC9AF347F08A99D4D5C773FA8DA80217D68DEC67130BE4D1A66F2D8A45,125,131,6,0.7076604666545525,PASS
BEED13442C6CC0B35FF59FF5291A0C98A1C99616077E9245EE2DDDC79FD7CA71,120,136,16,0.31731050786291404,PASS
25EC755E3B3B4B63FA0CFD7862CCA10B6145DB6C7425894DFA9FC54E7C9AF569,119,137,18,0.2605890342736178,PASS
EE2E8E4EA9FE7674223A26532C838E19EA05D655407DBE83C68C8FD73D60C421,130,126,4,0.8025873486341526,PASS
A9C19E3D8378314A976FFFDCCE8E21581C37582BD24DD8D678123FC8162C9371,127,129,2,0.9005235503397743,PASS
7F0C4A66E9B3F1721AD7B56B6E2FCF9D0E6127806F4240A8B6E58A22F780AD03,128,128,0,1.0,PASS
5801481DA707D399ECCAB3263DD27FBE3612BBE42B28B69B11463CDFD26E9226,127,129,2,0.9005235503397743,PASS
7184033315C1A3980807CBCD05EFEDC579E93FAC09A3DA0904BC7F152B05E5AE,133,123,10,0.5319710580974012,PASS
A7B6953AFB5F546FD19743E99291FE648CAA0A0C5B1A5A496E28624A4E3A8733,128,128,0,1.0,PASS
B74B09677C8572DCC8B7F317DE2D1196B06E37FC2B96ECD331DA5BB68E3AC4AE,116,140,24,0.13361440253771617,PASS
7EAB75F797860B558747BA9A16A4890FA0AA8FA141D24BF63DFE5F833494E196,123,133,10,0.5319710580974012,PASS
62525391A33959025A8350BA2B2C9714FEDDDA8B830558AA38A7B96670333F3E,133,123,10,0.5319710580974012,PASS
B03C0511634FBA09D355B26896F1D6BEDA82F30C45678A1B56B560351B12A155,135,121,14,0.38157390570502125,PASS
225964A131B75247A5E8B68F881BF25DDE17CED398C1C78CAE80642E7983D4AB,130,126,4,0.8025873486341526,PASS
E6BC140BA95DE4E7B84F5CDCB73CEB2B77E25363CC2E15E8B87E44C6CCE10934,122,134,12,0.4532547047537365,PASS
6FB2339E2C5ECFA3CF332CACC81EA6C49E313D84D4F1FD15E13755FBE6AE9C17,116,140,24,0.13361440253771617,PASS
A1D98946F334D4B1F8E6E4DEF9BA2916E379C5773349C11377697A0AE63CE372,120,136,16,0.31731050786291404,PASS
5DAB330B2C8779289492D6E892D5072E4CE8CF53A784F2E41805A6A605AAAE5B,134,122,12,0.4532547047537365,PASS
28D31ED96D91FA1EAC983CCFBD37D0942439D76E595A6F0F083160D7EA7EEC8A,122,134,12,0.4532547047537365,PASS
F90816C0030F7A054C8873A6C6A5E660EACC11BBAF4666A5FA44EAE52ECF5D37,130,126,4,0.8025873486341526,PASS
F9B92FE8C7EDD9FD754A615D6730C68A15309AF08C58279F2C510E6E151B4E39,125,131,6,0.7076604666545525,PASS
E0719252F9B17363CF9F2E82EB06F43E3EA3DF3AA69995DB09091B1A217D196A,124,132,8,0.6170750774519738,PASS
3D5810E2382DEDCE1B34DE591A0639D67FE39918BB1F6125A2CE449D6A99D17A,127,129,2,0.9005235503397743,PASS
F655A72B56CFA8945BE210BF5C5AFBF6A985C9DE39B2E336EEEC146FD834C65D,114,142,28,0.08011831372763423,PASS
49363CD27E13A7C0E5C93777B2BE6D657571C054DB9FBAFF2B41A4126B51775D,117,139,22,0.16913144470267139,PASS
11802F599BB543039D61BAF1EC346DCA2B9ECDEEA7ACD2C84761023FFA9BED6E,122,134,12,0.4532547047537365,PASS
9C15C1922E7C562AEF97542DFB18E34063425F3F5FDAE9F44C0BC273F26654FD,121,135,14,0.38157390570502125,PASS
4025377C76EB9DB63E4EBB199AA3FB5305E74E87E6FC154F89B8320CB1B0DCFF,117,139,22,0.16913144470267139,PASS
206CF58B626CF1D7BECC2023C95754E1180526980533B5BCD0C2E4DFA51A305E,136,120,16,0.31731050786291404,PASS
629A4AC2F3CE62B38C7F531096D6BB86621C2286B44219680DD8B89D02D34985,140,116,24,0.13361440253771617,PASS
58C67E70EB59F621A0ACF1A8CABC33C70D0C28EE989DFE94EF9C60D99202A9D3,128,128,0,1.0,PASS
840F21B04C37BC94DDC45E3D2713AC67933773FF20AC9E0C0271722AE8CFB0CE,130,126,4,0.8025873486341526,PASS
3FA32D5FCFCAE89ECCC1743694943A1E5ECBF8B8DC0A60B6138FA8DC52379D9E,121,135,14,0.38157390570502125,PASS
378E4D523F49D757746B043194B8F9F3A4118B5823BBF1D45833E619F5508B9D,126,130,4,0.8025873486341526,PASS
5DD623E0C1E8E46546234CF45C0C35EC40B1D03EE84B96B316BE2A27C909368B,136,120,16,0.31731050786291404,PASS
A22789F2A53DCD2F3A571B1F36EEC890B31F4F1F8A1AEB92937146EB34D55207,123,133,10,0.5319710580974012,PASS
CF950659B7099B873EA253971D26A45ABCB48CA6DD391B35DD814F5CC69BC24,128,128,0,1.0,PASS
7E4628F644029C2898FC04DC7CA69DD8ACFE9DAF10CC4803207ACBD15CC4E0C9,137,119,18,0.2605890342736178,PASS
CD39BF46F8DBD6AFAED82560600C94F45EF026FF1F227DA584F98AEA99381A4E,122,134,12,0.4532547047537365,PASS
1BF678D12DE9C2B2005A02F3481D62949B5B90225FED379CB57E367163F178FB,125,131,6,0.7076604666545525,PASS
BFEC7927ADF2F17C738DD0FABF8F9E51955A2D36AC6423B1305F284DE78CFAD6,113,143,30,0.060792723530522785,PASS
90BEE6175F929734CA7FCE909018571FF8F427B7162A846C18949466D35EE147,128,128,0,1.0,PASS
99800687DBB0B5BE2417619BF9EC9A23325278FF9EE05B0E91294AD1FF997CF,125,131,6,0.7076604666545525,PASS
45CC316324CD337741857CF0FBB460067EE143F2108527D52F992A0D2EEFA98A,132,124,8,0.6170750774519738,PASS
4E6F52F4E6956DB3CB8EBD16D8BA969E06356154A6E772D80C541DCAC9205867,127,129,2,0.9005235503397743,PASS
806FA030E45F790BAEB19DA0E9D043CB61D126E8870C224E6672241EE4A04413,144,112,32,0.04550026389635853,PASS
65122ABB35F30A60D5243B56DCBCC2FC41612DF0C89E17A98E2BF1F6BECD65DE,123,133,10,0.5319710580974012,PASS
31219CE0CED7F56EC150F84A604BB4E17E1A17BF4A2AEA5D25DD243600810558,137,119,18,0.2605890342736178,PASS
9B9459A48AD9E72D5039EF5C13D3AE7B01B22CF9682D7262B86450434CD7300B,133,123,10,0.5319710580974012,PASS
EF5C2959B03263EC50900811BF285B120E15782F59235E13B6CDE80E5B0EE7D8,135,121,14,0.38157390570502125,PASS
21CBC7A3C3F6B992C6624DE123F193F08015D4B848528E743ABE9F869A626066,134,122,12,0.4532547047537365,PASS
B4BFC1D4CD691A1C9165CFBE2374DC14DED0DE96568064E535DC220E1D8D4465,130,126,4,0.8025873486341526,PASS
7E1EF3AD3C2637921C462C8669936482170C50F24AB6D732DA891A06863E399A,136,120,16,0.31731050786291404,PASS
E101351AD9583660F7FEEDD3F571771AC945BDC0E2CDD7E18BB07C27D0ED6D81,120,136,16,0.31731050786291404,PASS
77E37713A0D5C141C490DE2A208889EE2820A162A03C703717677F18F0DE4469,141,115,26,0.10416255883043901,PASS
AA67324364244B27D8F879D98659D588F1CFB6DCE894252DC695524DA212BEAD,129,127,2,0.9005235503397743,PASS
EC01269FEF527B52620F636950503C0B469502B12EBC401738429D6378AD9601,142,114,28,0.08011831372763423,PASS
F254D98DBA8D138F15AB31778D89F90C9BEAB82A4E8C3E82F8F322AF02842E82,131,125,6,0.7076604666545525,PASS
866E3D7A11C4B771E02CA43C945B1045F361C1ACEA98ADD1FB2F6EEFD63A996A,124,132,8,0.6170750774519738,PASS
6A358CC0F82A40CF28C4627A668D9AA89F3F9313AEF74A5278A361EE5D09FB6D,127,129,2,0.9005235503397743,PASS
3A797BC480E914FC5E26284D6C4A69567E04BA01ADC1CE0CDFC91470C858924D,138,118,20,0.2112995473337106,PASS
B30A91A300230AF6D62292BAC0F8A2A8C8E18F4AD1CB84BCE6C1FE5FA50B909,140,116,24,0.13361440253771617,PASS
A28FF4317B3EE0582AC3D73CBAF01F2C62DEB960B46C06C7E4E2E780ABD455A8,127,129,2,0.9005235503397743,PASS
9CDB218C985DB9D540280AF98453D33E4FDE6BAD1672C0573943675595DF5682,128,128,0,1.0,PASS
D9967FA1E6175D91AEBFE7C317967B4CB81975349C3BE77E54B706F959C35FBA,109,147,38,0.01754895019147673,PASS
911B9D55F9D8DBA9E4289E3236249BB7032E08C790E881DA4342729FBE5FC279,129,127,2,0.9005235503397743,PASS
1AF2B0E6D0D4BC46199786CEBB8B184B2F08B672DA7C131AF9A37F09A35FDED8,123,133,10,0.5319710580974012,PASS
4AFA9CF2565BE41EF0DC7D6D9B91D5D92EDFC89D2D993D74B75515C18FED48F2,113,143,30,0.060792723530522785,PASS
6A1285FAC4B226547A2863EDCE456FD3DF669D543C263EFDB7E63989D6172BB0,120,136,16,0.31731050786291404,PASS
1361E4D4301F0AB224F7B1F8A1619E3E2A8C49A411B75EE7C07144ACAF0AA19B,136,120,16,0.31731050786291404,PASS
7E0DCBD44CA0E2E14D5B8EAA89A802C511EB6C10A49B5E973326CCCB948BFD6C,132,124,8,0.6170750774519738,PASS
5DD9D040F512A25E4A1BC2D559F55FA0A7F7F4BEF4BC1542DE5A4566D2BD7B12,120,136,16,0.31731050786291404,PASS
9640B073C4220E998CF3CF6109836300628C1CDE440DEC4DED2D3DAFF812C3EE,137,119,18,0.2605890342736178,PASS
F03B6966D4B06D6BC2DF032F996FD220F3A165052834F13037885FC8406DA227,134,122,12,0.4532547047537365,PASS
6DE82AB4FB496B79EA67AFCF8E71E6FF6C49BCFCF619E3728848B048475020E1,121,135,14,0.38157390570502125,PASS
370F4D4536954FC7C350A5A8396DF6D23F7A7C191CB24818382C2F1238FF662E,128,128,0,1.0,PASS
FEAC6B67E7F6EC5F9830FD3F7194C953A8A445FEDB2111AA86D9884F1E779DC4,116,140,24,0.13361440253771617,PASS
D794213747C9331D4BAF72F7FEBA7B97C6525541B256D452D810B8E23AEC7396,121,135,14,0.38157390570502125,PASS
D647AC52AAB2CF96FBEC63E8072BE3A6281882EDECD199D323B3B6D2564A8EB3,123,133,10,0.5319710580974012,PASS
7E1408FFC154DF38AF09FD99B8DCDBBF1D4D1CCC719AEFF26F9B20F780C005C7,118,138,20,0.2112995473337106,PASS
8FD327B2417309E35C59658E3A11DF456781FD80E723DA28E4A8A9E789708195,132,124,8,0.6170750774519738,PASS
DB26A0DB72E17961CD1C2EDC21FB955055650C7000D8EA0470E42D209B029FD5,139,117,22,0.16913144470267139,PASS
D09A509104D679D7822662B5C6E8C99FC2F289640D8F0D82077EF0CA59234A45,139,117,22,0.16913144470267139,PASS
D8E61ED0C299687E7D185BDC223D7A0798CC1BDA5AE452C73E296A205BC8CC66,130,126,4,0.8025873486341526,PASS
4652DD8643BB28ECFD3E72A3DD07306F46869B72B19D5CAD6C82E6B59B813870,126,130,4,0.8025873486341526,PASS
DEE5C6A657B1190B9E57EB8E5F9C451C97FD7B34A7EAD122B79A8660B66AF5C4,116,140,24,0.13361440253771617,PASS
59298F43BE6BAA64484074FD75FADFDB43800EFF152A5FCFB0508CEC152637AC,124,132,8,0.6170750774519738,PASS
62C4EA17F6D35949B4543244DA6C07BB167B0EF68BFCAFCB4B5BE0226953308F,125,131,6,0.7076604666545525,PASS
4D4CF2AF994FAA1BC6C2C7F2D06B15B8BE5C01716063BC016433F6C27A8B524E,130,126,4,0.8025873486341526,PASS
84AEB979B85466F8E3F76B85E94F0685E9B43A42569B7053E8AE62D14E677A3B,122,134,12,0.4532547047537365,PASS
A02FC9CFE30578D68B373BF4AC292021B4F9DF8282B208871C05EE30926EA81F,135,121,14,0.38157390570502125,PASS
49F82E4555D1C606A74E6969ACF37AC10A2EA04048CAC41D5FAFF4A010DFD8A5,135,121,14,0.38157390570502125,PASS
D73864233954A46B54B81DA1A6FBA3B9E9AC45559ADB8133F2DD120B7F1522C6,128,128,0,1.0,PASS
9B1D109D9B5B38797FEF1807DBBD39A7D851802B25D8210A91BEA7DEEE531CA7,122,134,12,0.4532547047537365,PASS
E2EF2EBD6B334A99FE502BA91346F16625B50999065B9F9F7B5DA91C77365049,121,135,14,0.38157390570502125,PASS
DD725C3154F04B8A4AA6189A0ED1304AF78ABA755CBD3159124012ABAECC864D,137,119,18,0.2605890342736178,PASS
A9653B09A9D92F02AFD968E4FFF05B6E6DB323115F20865A8CD8B7E2BFE21914,124,132,8,0.6170750774519738,PASS
4004008569B16C308FF70342173A22CAF3A84B21371D0430E9F3366CE6488651,148,108,40,0.0124193306515523,PASS
A3A07A4D731CA60667C98CB29E474034F360D862B613A0C362D0D35F00152389,143,113,30,0.060792723530522785,PASS
5CA88BD9BEEE70D1A7DA84F56CFE885B17CEABD603445877CB3891D375F27EF9,115,141,26,0.10416255883043901,PASS
7805A4F7F2A991CDC70A0BCE33C919758919BF2EF80F5A7B82F41355842142C7,131,125,6,0.7076604666545525,PASS
6D2D48C7184E9ABEE4BAD495A12A37D583BAA5E3794E38AEA8DC9D08A295CE0F,127,129,2,0.9005235503397743,PASS
E66332511EAE12D50E8997C5CAFD461734AC57E76710EF7E093BD775DBDFABAD,114,142,28,0.08011831372763423,PASS
41667FBAC81CF633CDF6869979D6B3E0B817124B3A48B17961AF39456B86478B,125,131,6,0.7076604666545525,PASS
C877B6F90D0D684EA7EBA291DED0569D500ECB579D7376FE651D2C8C437D6772,119,137,18,0.2605890342736178,PASS
CF99EB6A0624EE6B145BF00935AA668610DA3A092332D8024C4D0596FC02B81,145,111,34,0.03358661289689768,PASS
6FB52E37646BC6F19252FE5EB77FB312AAD96A1A46A592EF0B8D42D6E17BAF1E,114,142,28,0.08011831372763423,PASS
20840F08415650A82DD755A02D73B634D28A9B8A89E301B0BBF20D7308937B2D,143,113,30,0.060792723530522785,PASS
FA6D105CBEC82E7BB3C460AC44FB39F20D7452647791E4AEA0730331230CD9A8,133,123,10,0.5319710580974012,PASS
B108DA9D56F7B582F68A16BD9BB93BFBB0DC05BA0E07082B64B6969E28506829,130,126,4,0.8025873486341526,PASS
57A2D3E38C35A661481EEAE9F6FC2B4C1B93FEBD321A8F0E1AA4C70ACB1B4922,127,129,2,0.9005235503397743,PASS
6C2FCDC327114455DF218D6B58B58F56E11B79DAEB55AEFBA9962A662063C50D,124,132,8,0.6170750774519738,PASS
92DEBBE9FAF0033E974D3C10BA03EADD03249BAF210321DB1E9D92543E3D9869,128,128,0,1.0,PASS
95A459B6E37171A6BF88A152FA1EB985089BA300CF7266560DB9201B66A00298,139,117,22,0.16913144470267139,PASS
D9F16FA6A1DB57F221CFB886A15ACF17A502033802A573A4A9555818FEEFA1A2,129,127,2,0.9005235503397743,PASS
6B8C5734F63DB9955F3CC3D30B75285BF3524EFC5CA58024DFF96D0C85B406DB,121,135,14,0.38157390570502125,PASS
247F8F66D9DF7A69A0C36CB969A623D8E53886A11587450CA02D5E0BC8A9EE63,130,126,4,0.8025873486341526,PASS
9D48616492605F5622DB1673482FA27E7B3871B7945A3750DDBD4ABA51440AB,133,123,10,0.5319710580974012,PASS
A9ED91E673DEA6DB5111405FA9DA1180353CC3863E8E4FA06749F3D4921DA3DA,128,128,0,1.0,PASS
9B3D80EA00231EEACDEFD049619FCDF3ED89A6E9E34B1FD707A11078BA6E8E27,123,133,10,0.5319710580974012,PASS
59E0F72EF2D063527CF59B0CB9C90990C4E70D9C6872E43CD69AE6DAEDFF1064,124,132,8,0.6170750774519738,PASS
35D5DCFBB927A0B7F910EB337721134D5AF6E0446C5B476F99B2AB55AC13AB3A,119,137,18,0.2605890342736178,PASS
8D29B819245D06A4CE54D6995EF349F3ECE8976883021E40B2FD3F4B0074A4AE,134,122,12,0.4532547047537365,PASS
7C6D51E2C9923123AF6527B6315820EF291A6CD105E9E703E50614D08BC3781,139,117,22,0.16913144470267139,PASS
8EA505D14D5658A2106B17B4C488735C74DF472EF4BC52DA084E06F545AFD95F,130,126,4,0.8025873486341526,PASS
8B54070D9D6AFAE0EC523C1D0BBDDF0D2B878D67E01C015911412DE3316DDA0D,133,123,10,0.5319710580974012,PASS
E60515DA5315462AF3AC4BC167596C65B018F8D5BB99EAC573B20FF9D99B2809,127,129,2,0.9005235503397743,PASS
C6ECADCBE935CAF234C499CB073D12D2EEC097AAE1656CBB7DCD51844AE6E8B3,122,134,12,0.4532547047537365,PASS
E0875475C9153823C585C570FD4C74741C0448AAACF1DC682546A57B894F21EC,138,118,20,0.2112995473337106,PASS
DA0D47E56FAF53372452B6EC1F45C02E6AD9A2A31BFC06A273462F34E7B9E4B7,121,135,14,0.38157390570502125,PASS
3CBC7D745650BBA569B9E016D5ABCBE0A5182672CB23B4E9EA28E211558060A7,133,123,10,0.5319710580974012,PASS
32A39635BB6B301AF9D4513D3B30E68F321F1EE999D12D770AAAD6D9DFA4335F,119,137,18,0.2605890342736178,PASS
,256,0,256,1.2777508801076536e-57,FAIL
3667446E19D7B89789F66C024B6127A26E6D3D145CDAA431F600297B71B93D6A,129,127,2,0.9005235503397743,PASS
F755CDC16A75F6BE377F6294BD129272874F1189BAC549236AD8A4CFF5EE3FA4,116,140,24,0.13361440253771617,PASS
18514D1CFB75D1BC8064ECBF6744BAE4905556FB90B594CB89A0D56D30823E5B,130,126,4,0.8025873486341526,PASS
A84ED67F319A9CBDBF026CF91F588E48C4006A4097826AA6D497ED4794E3334F,129,127,2,0.9005235503397743,PASS
F7615CF56802007A7950549285012680F2AE20864DA5AECB867774E53E26334F,139,117,22,0.16913144470267139,PASS
C4E8755AD308046C94CA4269B42EFF24787ACAD6AD411D8A172D1FEFFF8A967B,125,131,6,0.7076604666545525,PASS
8BC85C49949D6BF9C0F1483EA14128B8A0AE88A8242B1C66CE4219054CB274F5,144,112,32,0.04550026389635853,PASS
DEAFBA4BA85FBB5F8CF31E3103101C875A46CA982BCB867430AE487CC33B813F,127,129,2,0.9005235503397743,PASS
9C7C418CE05830BDBFF98C5D1EE1072DC428C4114A6F43088EE36BD38C76E477,132,124,8,0.6170750774519738,PASS
327EF562215EFEC0661FEA164C5074B1AAEB475B0DCEA2146FB1BC03EC923C8D,127,129,2,0.9005235503397743,PASS
F22FCE22D27FC95CE264DAE532D9489E5A2CE69144B8AAA7D148B34E72DE54CC,126,130,4,0.8025873486341526,PASS
1330FE44B09AFA37DE6229AD243BCE9E23E19D0E187878554BF824C0EC095FDD,129,127,2,0.9005235503397743,PASS
ECE678169B1A73EF8E3585747AA0E8504D52941EEC7EE50673B8C579191A6984,129,127,2,0.9005235503397743,PASS
4B746A6F153F2E5826FD51B6542E799A662F47E84381342BD8B5BBBD2CA06B69,124,132,8,0.6170750774519738,PASS
41D0468F59A918F835463FD4C76A96CF3BB3B6EC38364011660995F8BAC344D0,133,123,10,0.5319710580974012,PASS
8B1D7B35603D6744A40ADD4007DD5396A44B7D4F647A3BD9EF2A06148CF964EF,126,130,4,0.8025873486341526,PASS
A62CA1981CDD94B006AAFFE0FB43F7E93021CFB8599ADCEE1D5C42DAB3B0F416,125,131,6,0.7076604666545525,PASS
880F8904FDFE0F5BF4F89B242499EC8E27A81A35431021C9C6A69D270C1030AA,141,115,26,0.10416255883043901,PASS
45C205E0887277C71FDCFCE5B84FBD0D0043FF5E452ED7CAE93C0A0A87A81C24,131,125,6,0.7076604666545525,PASS
6A69958E79501345DCB417CFDFB7E3B70DEE80770116BD89BAFBEAFF594705D7,114,142,28,0.08011831372763423,PASS
9C81039252064F3383B13321565EF07D5034A67D9A8576A81313F3AE95999FD9,133,123,10,0.5319710580974012,PASS
756C7D594579593A3777EB929128C47AB23A9E2E9EB0990E24A1C5FA00C6DBE2,127,129,2,0.9005235503397743,PASS
9E2AF1F667979CF50204EC9B383E1020F3529239ECA1F4C480C393FC008B8F8D,135,121,14,0.38157390570502125,PASS
75AE329D7F1E2F3515D5AAA797871405F7EDEB140EBDF545FA988209541C10FE,122,134,12,0.4532547047537365,PASS
263227A26C4EC0FF6DE6CA1DF0C9E6D8AB6BABE1811DB4B06F10B7C4A9FCB3EC,122,134,12,0.4532547047537365,PASS
75B74B75D06D55BFD15348FDA9C242E716A3D43F81E81800EC8C1570B7B33262,129,127,2,0.9005235503397743,PASS
30A54E2615D15C8BCE251D300E9B5F967DA8B2842355AB26E6DEF4EB970A3E92,129,127,2,0.9005235503397743,PASS
F27613D992AC0434EF04737DDA48683D56EDD00F35794263DA9B5B7599B8061B,127,129,2,0.9005235503397743,PASS
7E75D4AF2F435E4E0251CF4AD8EAD8CED2CCFE043DB3B283023780DF51E1B828,127,129,2,0.9005235503397743,PASS
4733846CF87D83EE9814DC0D33FE642E5D6162E0AD218B9486BC690FF8EB203F,129,127,2,0.9005235503397743,PASS
54EAEBF2640483FC5B5EC8C485F3B162B071BAC8CFC134C052CC9B067C727821,134,122,12,0.4532547047537365,PASS
9E1DE65A9A99F5A1B2188A8C2DAC0AFEB3B2C08C52EC663D829E8C3D4B4C961,134,122,12,0.4532547047537365,PASS
52DCACA98B8B45F3A1137CD3E80E0AA9C99259E7F7174F9EF1915FC1AF11159B,123,133,10,0.5319710580974012,PASS
BCAD1B32A17AC087525BC3E960FB078B529446E56454BED32D3C47F33D8249FA,127,129,2,0.9005235503397743,PASS
725DAD2693F704DEBDD8D348AEF15F1C1E3CD2D8551E3B80A0107C575F47B52B,123,133,10,0.5319710580974012,PASS
B81EFB2949D95A56A6316EF7AFAEE4CD456B84F17EEDEE764BDD3B14412FC215,115,141,26,0.10416255883043901,PASS
D49A272C50B8F8F6CCDE5E46FBDDA88DD4D24362F61B31CB774A2F476894C1B3,122,134,12,0.4532547047537365,PASS
F2D812A5DAAB26B979E57F24D1670F8F7FB95362A6D0FF656EEFC5B0947B5CE4,112,144,32,0.04550026389635853,PASS
2CF23292015CA2FE62805716E7A49D3983AD1F127DE63002C5E850ADE0566259,139,117,22,0.16913144470267139,PASS
2E90CCB89109A5859B07EFBB7AFD59CFEF646AF94EFCADB86E4A10C383AA6014,124,132,8,0.6170750774519738,PASS
F9716D19138B52060B829AF3337FB1BE7C3BDEF845CB0107AC5D37BB657A6BF9,117,139,22,0.16913144470267139,PASS
82AA24FA9F74F6FFBB8AF26BA8400C915B27644BEB6E14B38CA691400D9288C5,133,123,10,0.5319710580974012,PASS
F04361D23276C6E1B269A63CA57F447D234CDFFAB9DAAD56934866919BAC4986,125,131,6,0.7076604666545525,PASS
BB44617078384C25C5F27710549B4ABAD478A40B7CB41CE2B59483D3A7CF6122,135,121,14,0.38157390570502125,PASS
33A600AFDB2166FD7F4BEF3DC1C4462C1473FAB5D18C51562DE91A77E8C3308E,124,132,8,0.6170750774519738,PASS
E03664F4A4F10CA77F71FE9F3C76090535A22DA93D74E80B5D9C5155E5AD7337,122,134,12,0.4532547047537365,PASS
D2BDAA34C09A7356A9C473B3375FCC6B6FA8BDE25CB6C648ACFBD2610079D9BD,119,137,18,0.2605890342736178,PASS
31E4DCA33B34F6E40D0C0EBBA163FA0685A84D3F2B945538EC3DF2454304BF77,128,128,0,1.0,PASS
77DCF32FF4FD72606F6B767FFF28C18934D2D1C4A3C3006E9DF938E557FC986B,112,144,32,0.04550026389635853,PASS
C5B4ED29F735CA253D6DCE291DA214B7E6D1511589E2CA37447F8AD440308225,133,123,10,0.5319710580974012,PASS
FD2885EF4A0AFA5C14DEF19350E9AC08C4B315434BA7A12FD3B1E74D68F5A514,128,128,0,1.0,PASS
88ADDCB25A2A030C047D4CE398534ED0106FB6E03B6F87D76D111267387EBE53,131,125,6,0.7076604666545525,PASS
7DB3A81F5AC1ADE49347A05149DD9DCA1E7CE2A45FC857BC798017282660CCAD,129,127,2,0.9005235503397743,PASS
7D14A7B539C4718921E51B14DD2BF097BB4298FB057869B9687B29D3A9920C70,130,126,4,0.8025873486341526,PASS
2EDB481ABB7913DEB96E07D392141757510562208E46B799F97B91BC5BB183CD,126,130,4,0.8025873486341526,PASS
8AEB6DD69E6457CCE450FDF98DEEFA253DD4633AEF8A1BB1BC176BE56A8D60FB,111,145,34,0.03358661289689768,PASS
7FAF42F4CE93BD5A1243F783F36B2189DE1DEE2F2D9706F84B4266F14D604BD2,120,136,16,0.31731050786291404,PASS
22A1C44D3015F0914476E05E737843B636D7B50A963723317E798F7185F034F6,132,124,8,0.6170750774519738,PASS
A2EACC51272CC5A12CCF87EF6A9449B1B72EC6A17B6E892AC3F7F8E8141DFC88,125,131,6,0.7076604666545525,PASS
,256,0,256,1.2777508801076536e-57,FAIL
5299E1C536B4E876236D4B27DDB87BC8DFDF2361F52B69DF04A217349E158ACB,121,135,14,0.38157390570502125,PASS
8EEFE85B20F81A398DBD86229BE958E1600B52F74466E64B92C7B60524516F79,130,126,4,0.8025873486341526,PASS
F773109C028986931968E7615390E847E8438CB4A8ABDA6B52EF3F7A0C826C0C,136,120,16,0.31731050786291404,PASS
D63BD6EF94D055E83CCC38A1F96A918B0A52F2CF8B0D38C584C5A4FFB0A054B6,129,127,2,0.9005235503397743,PASS
7922918C8BA8AF03DE45F16E4E62D0DB4B447A336F7331F2A8873BBF3E5B7D3F,118,138,20,0.2112995473337106,PASS
B7146053FC3487B7619848E3D3CEE91F1FA5D1365898DA79D23AD88C4AE8FF95,123,133,10,0.5319710580974012,PASS
3BA1C2660155C6EC083A95DC443F11D7BEA61400EF94782B58E5DE0DD680A61B,136,120,16,0.31731050786291404,PASS
C89A737EA9EC025DE2E9BB16A1D30717ABD0359D27E4877DB42EBB584CFD2F65,119,137,18,0.2605890342736178,PASS
7C5515E91C0AF32E9E47BE8FF59529726BB47CBE48BD976D49CF492E3575A57,117,139,22,0.16913144470267139,PASS
EE9E2BD81AEBB3A967A78EB49988A2ED5FCA8D539DC0315E6E37ECCDC2006EE9,120,136,16,0.31731050786291404,PASS
24BA78FC594FC40DA66E4B49E956F4252739502BB8F18C6A38CA721846520D70,136,120,16,0.31731050786291404,PASS
916CB33815DC42D5153AD69C125837273A055B862F14A45976669607AC8A7074,138,118,20,0.2112995473337106,PASS
B02386F90C8978331B61C4CA8316FCCEB0580E08512E9B15A5DC1CC14CD78246,143,113,30,0.060792723530522785,PASS
CADF993BE849048BD01D1845C0819B70141E45F0C6FFC76F48DB73BC92CE83B4,131,125,6,0.7076604666545525,PASS
6F9497C0C340EF297E2D4C9F505EFC166656A537C3E79C67A6555032C2722234,129,127,2,0.9005235503397743,PASS
E2DB2B4B6C66E8F45975B78A163346E02A40110B67E90254F51CEA03F5BF2417,132,124,8,0.6170750774519738,PASS
9D8C2F89B656B26BBD706199860783ABD40766F351569BB8EF370F0AC53E405F,125,131,6,0.7076604666545525,PASS
22A18AEF2EB0DA79EB3E59AD5CE8C74CB3BBA4183E8B22912751976A6F8653A4,126,130,4,0.8025873486341526,PASS
8FAF0899268D7483842B0B7EBED84B12C40DE830BDA6AC8EC03EF4E0EB344021,138,118,20,0.2112995473337106,PASS
160D5ABABB8D84E961065A4E4C83ABE271657AA2E9C4625DC42942740D3010EB,140,116,24,0.13361440253771617,PASS
F395A4EAB128D9E1C4D5ED2614366CF725DC339B443A0C9511F5AE49FC2D3A59,126,130,4,0.8025873486341526,PASS
DDCC769E63E885DC440F1E4883ED5D05A974E0E7E8ACD5839BB7C1C534BE8BFD,121,135,14,0.38157390570502125,PASS
5E8B5B79EABB8CEE4ABCCE5B590A01A0DF0FBE1A55393310F66EDF6AE41DFED5,115,141,26,0.10416255883043901,PASS
5E54B195347848D258286CC5384EC41FB540546D6CB24891E4442A65439516DB,143,113,30,0.060792723530522785,PASS
A38769031C23FCB400927ECC641A5907E4E39EC491A5DA99B5D828473524FCAE,135,121,14,0.38157390570502125,PASS
1BD8F71CCA0861B8D6FD2EEFB6E305F8E132E88BA9ED883D0A2AE62ADA39C168,126,130,4,0.8025873486341526,PASS
2A791576F2D6C45FF6B9F4C1BA113ABA911DF8760E39DF29DBABC312FF7625A6,115,141,26,0.10416255883043901,PASS
CD0FBF8D37E2916492753B6BBE34E919391272E36CF6418998815994A30F6035,130,126,4,0.8025873486341526,PASS
E66FB5FC37277692ED5520502F4CE651BE99DFA16619A2D54BCD947691F1FF0D,117,139,22,0.16913144470267139,PASS
2B5AD05A3A58F1A2135E1E402E7F5B6F5EC4E2D5A8E27D21CA267EB8A8DF6955,124,132,8,0.6170750774519738,PASS
7CB49978A0693EAA12CE11C262EA240B858BBB831CDA71D718091135A1B40DA9,141,115,26,0.10416255883043901,PASS
109A020C5DE403C64AD8792C39EE4EC6602E7B35B2704A5FFF304DC58E622CF7,133,123,10,0.5319710580974012,PASS
468C65ED5D37CDE4D9D135FCBB3238EA66767B54A589789CAFAB05B67305517F,117,139,22,0.16913144470267139,PASS
E0AC0065110B24404AF7C05304AAC4B287B9FFA5688D4EB58A12A869E34B7F6B,139,117,22,0.16913144470267139,PASS
9E498A0ED9AC798968CE4CD74DDA5515F351043C26DF82F73D1B816D18096293,132,124,8,0.6170750774519738,PASS
7524E62D718FB5D684DCCE9F61CF79EFC54BD47E78F3F68AB2625334EE0846D0,118,138,20,0.2112995473337106,PASS
2E1BBC4C60767C81E72A8236E6DD48C6DA30E972F3DF665D19AC2AA823DA0A4B,129,127,2,0.9005235503397743,PASS
B038833C1A0C54CB49AC3170478729A403A3B34FCCFC17AF91F55F747EC87E5F,127,129,2,0.9005235503397743,PASS
2795307B10B5C7CC8BDDF0EFDC8F68EBC0E107BECCDD0FF57360976CDB5D3E20,117,139,22,0.16913144470267139,PASS
834564D28CFA983396E669E4A55E9CCB2492B9306659584EC64C5468A4980DF5,137,119,18,0.2605890342736178,PASS
242D3EBEEC8E57F111EE5A6DAC9E53E35C94BB0EF10EBEBEABC2C5F6B6986726,115,141,26,0.10416255883043901,PASS
2948545B9D0B207CCE1072714344FDEF3CF356D031559DAD115230E10A5946D7,136,120,16,0.31731050786291404,PASS
C807243386E569003FDEE62CF8C6B082E4BCD675FDE86AE66BD58AACF8052125,130,126,4,0.8025873486341526,PASS
F7F27717D531FCBB1B860D1C0730BD2110BC88DF35AA976EE4E8221C02A34E61,130,126,4,0.8025873486341526,PASS
4DB86FAFAF219039C1247F90B4EF3ED7C46203CA58D706B143A6239B105719A8,132,124,8,0.6170750774519738,PASS
8E4DAE1C50E93B17764DB2CC2BAB81D86E7025E563B8C67D24CD896C77386569,127,129,2,0.9005235503397743,PASS
3B02EF166C1FC1E09EDF20F95451CE6CD5248119F861A9725C0957629C5B4C44,135,121,14,0.38157390570502125,PASS
999B484EB99736B5CDBE1EC97FA8E11029526D26913E7237A993691509F046F9,127,129,2,0.9005235503397743,PASS
3972E5DD1670A4C67DE1CBDD41E48792B657336A8E18094A51C50B65A13E5CB4,131,125,6,0.7076604666545525,PASS
9795182F92340C623CEA4A8101B7E6824FB953ACFD8F0428DB3500AA60D32493,141,115,26,0.10416255883043901,PASS
9C399A0E5769413BABBA153D53BF543105B505A5D2AEFA045995EFAAEE8294A9,127,129,2,0.9005235503397743,PASS
3F82E73A88C8DAD59D8D9A9559F29DE8B4F60CE90DF2FF65203FFDA2AB0DC10C,121,135,14,0.38157390570502125,PASS
684A3C3A7A1E3CEC05BFF9649679BD526E40E520E287B233BF2C50773AFAB474,124,132,8,0.6170750774519738,PASS
D6ECF3CDA843BC040BFA83A56850FCF9097AD15FFAA35F3DEE8DAC47D7D7D571,113,143,30,0.060792723530522785,PASS
F5E990B8AE1772F489C61E7A5CA88710A8B8DA610F94059C7F9CBE568B98B3E0,129,127,2,0.9005235503397743,PASS
D13386B0FE6968C0B58E9A88D9A8613B6C59AA8941D1433060575EE10A78296F,138,118,20,0.2112995473337106,PASS
93FCE0846C33BACABB9BCB3B7FE6EDD57E7E8E585D2A271660E40FEBB20E22A5,117,139,22,0.16913144470267139,PASS
D3437A6B3C0D1EDF4D077A9B7497228DC362A00D2EDC52D4B56BFCABEA14A0E6,125,131,6,0.7076604666545525,PASS
F5148648370C2DA16F43FF9E2F87C6C721E886A0E57A275135B46798DD90D8F4,128,128,0,1.0,PASS
E835B863F35171711852170F0477666CE72B393ECB1C8B0D0EC6ED8342CC1B2E,131,125,6,0.7076604666545525,PASS
A4C1E75477B610B4DA655890FF95ED3369EB32A0D035BC56CA5ADB9D78F5C1B7,120,136,16,0.31731050786291404,PASS
1776394B749D6CE936F1D42FAD8713F1516E70B7EB63CCA858ACCB12C5E2D2BA,121,135,14,0.38157390570502125,PASS
72BE49008C0F3D3F0065C7CC5935BAD25FFD62C53808D1285F89B083ED57D92,133,123,10,0.5319710580974012,PASS
2288F70BCE8B0C50A64A5847A8BB13BD4818FA2A40A2034364F1FFBFB3DB8C57,133,123,10,0.5319710580974012,PASS
79B38670E2D82E4EE91AF85929CDDD3E41E8BD48B7DC89CBCBD19F8F5A950C16,122,134,12,0.4532547047537365,PASS
34ECE8056AF10A1ADC9AA54924F9444BFCAFEFD6E405D82FD067ED1ADF957A88,124,132,8,0.6170750774519738,PASS
4A9289B2CB28E76EDF00764EC0D1E31F31B898C2594D3D003735120F493B0ABB,136,120,16,0.31731050786291404,PASS
2737B743C7E2C70246F47FAF210C2459B9E769AEFCF982780419DD7C0B4E7785,123,133,10,0.5319710580974012,PASS
97006EF3623D5B26E8E3D08A69FB7A89C6E60F5CF976C0826920CA22D11717DA,130,126,4,0.8025873486341526,PASS
903B46679157433E254C4140E449627076766A3510052A38B75C6F264623077F,141,115,26,0.10416255883043901,PASS
AC4596AB7E80451E78CE15EFB55B5478CF35D72383A46B9F671F0942C20837BE,125,131,6,0.7076604666545525,PASS
BFB1626E4A58431E8A3694F31AF11C32B5E3702A5609BABFF00A0718AD98F628,133,123,10,0.5319710580974012,PASS
DDE3E9CC81E202D188D617D10F08F81559500CD4A8F71BB4100AB541F5ABA91B,138,118,20,0.2112995473337106,PASS
CB5B1915CC2522798E55502DCC31FEBDA3518AEB3A0FE0F8ED964A4B52372D4E,127,129,2,0.9005235503397743,PASS
B63CD515D839555C664198F87DC63E6672956AC793BDB64A34C51C48852CE0D6,129,127,2,0.9005235503397743,PASS
43656E76619318270CD82BAD83F367016664F7ECF74A0DECDB1A393D8BC76A3A,124,132,8,0.6170750774519738,PASS
236BD2B0C1BA5A16E4C9123449B3A69A5C86E43E1AE771FB52E1A4E3E3B21003,134,122,12,0.4532547047537365,PASS
741DA203ED2BE01B3E78F6C99D9655830DBC17EC0D3CC207D83C6109CA46EF5,132,124,8,0.6170750774519738,PASS
A451C3380D7A15AF9D8B4F4B3F4F7DBABB0E6659CFF7FD5331B091E9F75345C4,114,142,28,0.08011831372763423,PASS
5A4203721E5433B6E36267EA84237278F1AB9839ED8FAAEE2D836853992D26D1,130,126,4,0.8025873486341526,PASS
709B9646DCB9EB82E482EE59A39BD9A8EA241ACDB95D6D0D8AE55085D5ECA158,128,128,0,1.0,PASS
17BE8914BA00B8E6257F23929549BB5AFA154D2F773F665E2C0FCBCC0927E7D4,123,133,10,0.5319710580974012,PASS
D861BFC9E266EB1571C174A5052EC14B956B03B9239EFA7D5C3DC55723EDD21F,121,135,14,0.38157390570502125,PASS
2353FE134F8D6048EE3EFF3EC69B13D295EAE66CC61C96E596160E97743CB75B,118,138,20,0.2112995473337106,PASS
3E354764D794B70EC103CFDC1BDCC8F49A737AAE8224F64D5BA134369140217C,130,126,4,0.8025873486341526,PASS
677C20275165D1122F077326E70FC699BD546B6111954D7DAEB53C9825AAEE78,127,129,2,0.9005235503397743,PASS
823BC5AB7849523262E851D115EEB5DACA6490EF20E14B20DD88CD3E8F68CAB6,133,123,10,0.5319710580974012,PASS
6AC8CB777F217721E3C83E93337F95371D139C961F25EEE16D3C3096A1BD22B6,120,136,16,0.31731050786291404,PASS
DF19D6D083BFA5120AFC942C20265E6629D57C76B79F39AE2FE09BB06A13091,130,126,4,0.8025873486341526,PASS
A83E87DE326F484283B032E8FF2C0235C173771E5EF7E795CA8695A352178EFD,123,133,10,0.5319710580974012,PASS
6AD6309477C0F160FD99677509872FF70217EF9F2F9742359AB565F3DCE25957,117,139,22,0.16913144470267139,PASS
1D7953E5C9D4247DAE2F6B99AC5305B839BE4E61F6D6EE2BCCE15269F10050A9,125,131,6,0.7076604666545525,PASS
85A41D5A045525BA2CEB4FE44448311A8BD0C788F4A73CB9312AACFCACF8E7EF,130,126,4,0.8025873486341526,PASS
ACEBF69A034AFBF4EDB194DFB31A68186DEBB3A850EA155C974A157CD9015339,123,133,10,0.5319710580974012,PASS
3C09FD26415329DC14D4F20D6947ACA45FE5DACF6D4E9D5A100C0C8931E3DC2F,131,125,6,0.7076604666545525,PASS
6458E2F344892A16E7C93AB36A834B0B5043E0C1360011AFB78E127D6E7A3DA9,136,120,16,0.31731050786291404,PASS
5A09BA42E5C3652CA8E2916BA9E1077079579B9E79A6D61CD1AA9FA04C8659AA,131,125,6,0.7076604666545525,PASS
76DC3E8E8354119570265C6D8857C0CC11A861D1B4918BE4B5F05F75E1E2A5CE,133,123,10,0.5319710580974012,PASS
FF61172116D6BF0D0DA70A180955F352B8665F448E50A7CEDDD484B1D2C3F9C5,128,128,0,1.0,PASS
7A15F2CDA5060F9D6AECD0CD14F81DCBFBCC6A0F5E8E4F355E6820D229E79426,125,131,6,0.7076604666545525,PASS
4A80C4D3BA0E1CFF51F1F4F47C45F1757130330BC8803CB9F0A236317521D180,137,119,18,0.2605890342736178,PASS
5CBA502E3A9CB45ADB1E12456BD4C920261F28C817B3C8D6BDB0DB263A31A6AE,132,124,8,0.6170750774519738,PASS
2F62EA9A277B211DD1166C64B0183C462B3BE379C0B6AE95AA730E8A133AB098,134,122,12,0.4532547047537365,PASS
9A2051AE1FC0040E34FF95691B113755A9D213862DE9B38674369B0ED4A102AF,137,119,18,0.2605890342736178,PASS
80E1CB2488A9F55F5E5AE2CCE79E52E938B90BFA8222FBD3DACFDCA8697F5196,120,136,16,0.31731050786291404,PASS
141B798E2DCE83A111D5734B65F85E1F5198921AC453602DE66A99DF4CDB1993,130,126,4,0.8025873486341526,PASS
EA277201D6DCD73B54F0E5F76EA96AEC08BCA5DA663348625CE72CD3FFE179CC,117,139,22,0.16913144470267139,PASS
5D5D2F31D9211CBA9CC87D953F2076468D2A10E59FA47158A5D01AB45CA640EF,132,124,8,0.6170750774519738,PASS
C057933E17376C542E1AA9027AFD6F9C3195A310A1EE62302E157AADD68E6BDD,127,129,2,0.9005235503397743,PASS
4CDC51CF45FBE21B5A3DACCFEEC50C6F314B69840B69F53B4C65A465C59B3FCC,120,136,16,0.31731050786291404,PASS
68F80D0A2BDF70AFC700F547C1A1DEE4E45ECF3C3F626732F0A983E21FC4C279,125,131,6,0.7076604666545525,PASS
35FCB7EEB8DEDB9F8C8745A2217B89E0058A1496CAB539D35A133094FD5505EC,126,130,4,0.8025873486341526,PASS
383B7FD2ADD3DDED6AC76376351D1446CC28E716D26B57B62B193211E990B22F,122,134,12,0.4532547047537365,PASS
144841273E11E5470DA720DE2EFB125133FA81E1494038A28BBE18E064D22B48,145,111,34,0.03358661289689768,PASS
3A0D4A5321C5F5F40123715E02CCC38576F5F068CD69A8D3EB2671CD79C4A6F4,130,126,4,0.8025873486341526,PASS
27F6D467143AE4746BB141734EA7A9B70F611B28DB0C5984CF1C35311331DE73,128,128,0,1.0,PASS
7D0E9D7DF971034AA54D3857A79E37E635DEB0142FE20B2B36CF530FB6D07D81,120,136,16,0.31731050786291404,PASS
DEC7F6B0144D09573A7A1F05029005869AEF87BB70BE125E585A2B7433DB27ED,127,129,2,0.9005235503397743,PASS
117BFC75FDFC65967CDF0BFBA91F9B3A1BA4B2B1A8E6D4CB262F32BD3AF1E8F3,108,148,40,0.0124193306515523,PASS
B95A86182C5EF19C4653F770BDEC9CB2736F797F943B3039A441B125A967FF6D,118,138,20,0.2112995473337106,PASS
E946A702D36378A9C3DE1281E71106C6A7A60B9666C583CCE370B4B7AEE809D4,133,123,10,0.5319710580974012,PASS
8D61BDBE873CF0C7DFCB70EEB69071319FA73667B7D634DA0109CBE8C899D699,118,138,20,0.2112995473337106,PASS
39604CF71E4E93C49178D6F26A11C1C09B4BC9BE8728B84298247B221A52D05F,138,118,20,0.2112995473337106,PASS
7E37724C2C9BA6BBA6FEF7266BE0DF4688A0A10DF18C18DE170C182859DA1A3A,129,127,2,0.9005235503397743,PASS
513049360ED1C50FD9BB7112A292C65B764EC33C08C16B0A7F78F570247CE2CE,133,123,10,0.5319710580974012,PASS
7268A74EABE24E268277E99274889CCC610E2BA87CE09D67C6A03DBD344A02EC,134,122,12,0.4532547047537365,PASS
A11B0E5F1D1DC170A00F06BA6AB885116A24A349F3BD678571FDE37A19826923,134,122,12,0.4532547047537365,PASS
C12D71C352426141173975C1000047186712D239C6982884121D980C41E760D4,158,98,60,0.00017683457040160787,FAIL
26A03096BD09FFAF2E2DE47F35EBBE32229AF955165313679DEFDCA6286F3A8F,116,140,24,0.13361440253771617,PASS
C5B12FE045975BD1132F437E51D7C70F33ABC6FE1698B593C9CA20B9BD89CE9E,120,136,16,0.31731050786291404,PASS
1EC7F1EC025632B2CA872DB55824160A079205C8565C877DED3834530046F3B2,140,116,24,0.13361440253771617,PASS
25069EB564414D36ABFCC3D68D69C4C386E845A5DB18F953E1694D80998ED542,133,123,10,0.5319710580974012,PASS
4270DDAC9644980105B76AFAC718AF8E1E1EEF720EBC6A57FD27DA09A0926662,130,126,4,0.8025873486341526,PASS
ADAC14E07840A7EF6356C6E624895AEF105DE3867D5181C75E16B79CADC5CB4A,127,129,2,0.9005235503397743,PASS
6F5E66556A362459DB44DBC1B5B8CD0B8A97BC3615AF225154BB9773FDEA1166,121,135,14,0.38157390570502125,PASS
68401D722B0350C7BB55FAD5FF4EA324F336A498E9C21443F58DD5138988CEC3,131,125,6,0.7076604666545525,PASS
29F171E2E87E0565B95EB027092D5BAD5B3D1813C0413005EDF57889A962E880,137,119,18,0.2605890342736178,PASS
E42F154670634105510953A3A4E2F2BE5B7DBB86839FD2901753DADE4E21338C,132,124,8,0.6170750774519738,PASS
130773367AD20E610C3675AC7C44D79D0FD417D5F50EB633830845B0D2F9F670,129,127,2,0.9005235503397743,PASS
23571DB0E57FBF7BF04286AC9194D6BACF920700CBA11AD51B841DE08040918F,136,120,16,0.31731050786291404,PASS
B54421389114603D0CD8D673597B56CE1E9533C246AE8023FBB8378E24275C2A,137,119,18,0.2605890342736178,PASS
9CEF99488D42B2CBBBD9840167B01FBF4CCE4B0CAA6DFF46E23F252489429491,130,126,4,0.8025873486341526,PASS
1D372EF8D3FC316039B3E8CEC4645F341B379FD221569401C0EAE672E1FE4B07,126,130,4,0.8025873486341526,PASS
14035E9955D3C7EC5DAD324DE078181DFB1B73448F0D6CC0E2ED315792C5B9D7,126,130,4,0.8025873486341526,PASS
EB04047FC878C2B6DD7A0F7B0CA31595748DED7B014EAEDB2E010650F4A15A86,132,124,8,0.6170750774519738,PASS
4B682348E831EADA6E1F98DF6084A4F78247E6815D3F3F1E2ECDF6322092CCCF,127,129,2,0.9005235503397743,PASS
BD882FE09658F99CC162CE6FCFE11B2D8E9F0BF7FC4E191D098ED4A904AF34C8,124,132,8,0.6170750774519738,PASS
970B3535037058B14614093842F1EE882DABB30BA98773715DDCBFCFCFD6421E,129,127,2,0.9005235503397743,PASS
8FC6A93FA2248C0704E740B947EE3C0556B6C5BB37E0ADBCE9B93D53ECCF64EA,122,134,12,0.4532547047537365,PASS
2A395CA2B9656C8626D88CF3C97C754546281FD75AA408361E8DC1311DA76126,136,120,16,0.31731050786291404,PASS
5FFA5AE60B95DBFF01000B94A481255122071B4A2A91A781806E31413F96B3C7,140,116,24,0.13361440253771617,PASS
CD604E9631925691AF0B75C46141AF288D0641A09C318BCA6C261B05D9235C1D,144,112,32,0.04550026389635853,PASS
A37FBDFC437E25C2F5946EF6296E12199581EB91D124DE41A1084F2E18DDEF81,126,130,4,0.8025873486341526,PASS
76031598C350E19ACD908D5B5E9C5D7A1F4C0AD2C74DB700FE9ADE6B844A57DC,128,128,0,1.0,PASS
E0CEAF5E33559B39B8C94B7D07FF49C0024DC2CAC72E14FD496FB3829D2BC680,126,130,4,0.8025873486341526,PASS
94DE6481D77FEF084E50BCB84D53D5971BD29A468D57760FCB3D1E90BDAB3ED9,118,138,20,0.2112995473337106,PASS
E85783D8C99DC81B6F3FBDE85151A2A32EA157F196A04E31A8A2B5669F885094,131,125,6,0.7076604666545525,PASS
1FE90B64C11E5F09A9EADAF652A8742698C97CAE4E0A857E5EC2970FEA6CB41F,125,131,6,0.7076604666545525,PASS
7ABFEB48271628BBEF5D14D0EB017C5C9893A99EB8DC04DE331370FCA2F8F70D,122,134,12,0.4532547047537365,PASS
113B80C33821B4CCB84E6CF3ADDE4F1970D6775991A27D4E575FBFBB72BC4D16,120,136,16,0.31731050786291404,PASS
C9FC011554082008AE8B55B18DD9B5004F34A56A2DBDDA87F4480B1419CB7755,140,116,24,0.13361440253771617,PASS
604685CE8BF3295BE4B530B750E8C66AE7BEFD71F6F1D60191B170DDF9B4EBA6,118,138,20,0.2112995473337106,PASS
1D02B47E8FE4B036306A7CCB25DFEA30AC8B904144965942794F9FADB55FB59A,127,129,2,0.9005235503397743,PASS
EC53553D391FB25FFD2D5604410190E05E0DB435EBA2A9255203FCEC8F61A7AC,130,126,4,0.8025873486341526,PASS
55D7DB3A0F6775B689D5E9AC3AFE7AB8F4409F6CD8DC1C3E20680BECCB36F544,118,138,20,0.2112995473337106,PASS
1D147C847E57395E28E1754DEF8EE9B3EEFF3A2B4D47B82E659707EBB060A10F,119,137,18,0.2605890342736178,PASS
6F5B0884B8BCE1C843828F3B387033EEDE5A0A6637F43BACF7FF84508B395AF2,124,132,8,0.6170750774519738,PASS
E5B87C1FA43D62E9A33C15BB7C06747C393662D4E2717A12439BF89098AF76BC,124,132,8,0.6170750774519738,PASS
BBB75133D2CECF0F6D3BB2393D315C392B6B3D9A28B4127871D1C79B4A7A339D,119,137,18,0.2605890342736178,PASS
CF2435823B48A560257113306005703B507085063DD0020703A6E77E9544CD77,148,108,40,0.0124193306515523,PASS
E8DD26EFF1605EA632588EBB359470C259800BC186A9FC1E04358695EBB50A33,134,122,12,0.4532547047537365,PASS
CE17EA0B2D46B0931D2243F4ECE02D483807ED52EEEC4CDC75A78D34D3C38166,131,125,6,0.7076604666545525,PASS
D51320CCDF21763AB3A97B5F0C16A0122AC9C159144807FB1770847C700B1415,142,114,28,0.08011831372763423,PASS
3FC71C85F4AEF22F7C6D753A2DFD42FDE133DDEA1B0B2BDACAA47F74F317ECC4,109,147,38,0.01754895019147673,PASS
AC1617F9A234C1A6B041337FBC6D80B9CC1B123797DE331501E8835432CB0014,140,116,24,0.13361440253771617,PASS
2B121FA5847AA8CFB04B6F3E9ED8CCB46A565E83CC81EA69C2B42CB7A31812B3,130,126,4,0.8025873486341526,PASS
A11E9C10C0F7242A214AE44E658B2828C98F813D18BE9E9E1A1F424E73F988E4,140,116,24,0.13361440253771617,PASS
D1D0D4D4A37BC92FE8F45098E69754BCADD6A2FEB79CF54C3573DD48CD46B56A,117,139,22,0.16913144470267139,PASS
8D1355BB51ED9A39045DCD292B67ACAE06A5B9418ECFC35344A0EFF362D99B46,126,130,4,0.8025873486341526,PASS
1C1C0763624E3D57DAD520EA6B76F40927258DF724364B1D7690DFA5BB5ADB6B,122,134,12,0.4532547047537365,PASS
441B0BC23D609673B1897A8BBC9AD5213615DAD124EEBA016CB55FA4260BDA9,135,121,14,0.38157390570502125,PASS
2CEC6CEDB83342DA5F86BD51522E5F3AF5263B3AF2CAD850BD81E3E0EC28DB60,124,132,8,0.6170750774519738,PASS
10B464A8989883BACE2DFE05E210340DBAC873C4AC4E01B8A9DAAF0BABCE27E1,137,119,18,0.2605890342736178,PASS
ADD9C74A65927F90C08EBF36A974A717381AB693E50F310AC687CEB28E893853,128,128,0,1.0,PASS
5C20A28FE7793EFBA39DB3D7624F477133CEC5E779A63085EBFB756BA3D0AC6F,111,145,34,0.03358661289689768,PASS
D4E8E88B9B123B3D8B15160ADF89CA46C6A3984378AD09820F6DD92EEF9BF7AC,126,130,4,0.8025873486341526,PASS
368976B1C86563D597D47E17367845A7C30C3060F866329E29A9C7B595B2FB47,126,130,4,0.8025873486341526,PASS
E3385C81CE07CB8BB26CFCC175848EE6E3361CBC32D709AA716397E392C29F7D,124,132,8,0.6170750774519738,PASS
C37F7AA9BFD355D2BBD65FDBC3A564B207DF9E38AAF3B238FE183F66626CF61D,107,149,42,0.008664896726025117,FAIL
849B54C621F8178C98413F44A5EE685F10E0C1FFAB4928638C03ED097DEB0AFC,134,122,12,0.4532547047537365,PASS
6E11F850B97A6F5278EDD5887D71B34B51E176FDE4F57CB9EEEC7097D0435436,116,140,24,0.13361440253771617,PASS
386B628E93D3EBEFAC1C0B538E80571426FC8D1AA8D9CFB6A11CEF8CA0360438,132,124,8,0.6170750774519738,PASS
D809F83D63881E7F7CE3A9D05A508DC0C3C4C1A96E3CFA71AA65772D15821563,131,125,6,0.7076604666545525,PASS
E94A9461975F8EB0B9CB9D798942724C0B846D72670B5D66D593BFBACFCD8520,125,131,6,0.7076604666545525,PASS
EC62D03C0F4322824949CD6406A7B5572220E5A3B8BBFFB97F945241BBBE930B,130,126,4,0.8025873486341526,PASS
74E2257FD9543DF43D9B3F76D0D7C5E0E5FE0B7F10DD6CBA3161186CB223610E,120,136,16,0.31731050786291404,PASS
AC470CEB8BA44190DDC46CF3960C45FE1BFF0DD8D29F0120689A926865C1FB77,130,126,4,0.8025873486341526,PASS
1B5F90D7AA03E40267CAAF7F71F176A4BEE1D3B7EE632ADE1D1800FEAC76840F,120,136,16,0.31731050786291404,PASS
D19FF34BD7D3D502375AA8338FF152DA7F00BD875C17CAE15BF24BF01BEE08D1,119,137,18,0.2605890342736178,PASS
68E8871D5C15C53F4C86E93779DADEC04D59C3B80ABA2A20BC04622FE9EB8C67,130,126,4,0.8025873486341526,PASS
A458400DEA6ECD06D781FDEF6DBAFD9A552EFC600D79DA1D8319FAA85DD91AAE,120,136,16,0.31731050786291404,PASS
B7407AEEFF49D02423AA5E8C05A50F7BC5BAD027D75950309696393656BB155E,127,129,2,0.9005235503397743,PASS
32BB428BEF6AB49735D7B61F2E318E27FAB0CDBF2B60177A2CA75A0C5D13B026,122,134,12,0.4532547047537365,PASS
2CF679712FB0994B9552000A276C893226221A6892B3AF20032047A84CC10C3,153,103,50,0.0017780505982168669,FAIL
5F99EB69462F2A10644888182A9A4EB5BD2110F13F037C9A2191534A9746324C,142,114,28,0.08011831372763423,PASS
EFECB9D819439C8081DD352C58162A64E0311C51C436B42E707E2F80D3BA496E,137,119,18,0.2605890342736178,PASS
F5CBFF1B1E6DCC5B649A7BBA9C73081F180416FA946AC41213B053F7081638A2,131,125,6,0.7076604666545525,PASS
5942F50F02AB9F693A1A013443001809073D03CBEC6B9F47943826ED0B040536,146,110,36,0.024448945310089426,PASS
EC8C698D3AC607B65CF5021A8EF2E186F19AB12DB759359CF11BB5A4A7FD826C,124,132,8,0.6170750774519738,PASS
8EDD930D207C8E98120B01F74EC87305B34ED73C21637FB7C4F60F78C0D9C7FC,126,130,4,0.8025873486341526,PASS
5E70B6C883A2CB2D38A44BC6728B4564EF7BEB6A0461C2197BAE0EEB2362B9FA,127,129,2,0.9005235503397743,PASS
8FCC3E90DAB2C64B634EFCBBA35B065B4361613D85FB8D6B30358AF237E4DF77,118,138,20,0.2112995473337106,PASS
6F81746F9AC6BF36E831BF0382C0F23BEFF04F0E3A207A5BDC81872D4A9787A1,125,131,6,0.7076604666545525,PASS
8773A3ECAD5CC8EA9559C46717DFE9509DF09E7944316DF86C0A2002A12BA5A9,130,126,4,0.8025873486341526,PASS
BD4EAC57C8355552035154F42934326F563FCDB39C91D9BAA2AE2E74A425A700,131,125,6,0.7076604666545525,PASS
F4A9EE693767C6CD881EDC137A9F4F269D3E2611546C547E7755FFEDBD2783A2,114,142,28,0.08011831372763423,PASS
6281FBEAAACB7744CD6D745819E8EA459A22CA3FB0633E61F719A51B24FC544E,126,130,4,0.8025873486341526,PASS
EA37ECF43ECA84CD30CC877CBA28834A1D037684DBB83704A2F2539A342A98B7,132,124,8,0.6170750774519738,PASS
E55B21E692517DECCD728B47892C91AE0D816DD5651E27BA969F3A891A37FC4C,125,131,6,0.7076604666545525,PASS
4EAC8906A3F5B35062C7EC8770C6930C6D0C0DAA103EC9D4E5C59C62646A5B21,138,118,20,0.2112995473337106,PASS
F43720415F2B9629FB0F564D9A6EC9BB81402BCC5B4E6434673311F1DE97C8E9,127,129,2,0.9005235503397743,PASS
23D8A1A1A6E31E0E6A33A94FA73BA4E3355C421A146E40237D844ACED783017,139,117,22,0.16913144470267139,PASS
11FB5D9040D44E967FECE9D1E00640918D62AADE979E5146E7C8199F91BB3C7C,128,128,0,1.0,PASS
528AF2E06A6E19A3314F92447B03C40C2DED0CEA4AAC2CE7789457BC43F629B3,133,123,10,0.5319710580974012,PASS
459D602894D8A9B3A9A9CBC856B3C1387B31F39F3586F9832BD4F0E86788F1C5,128,128,0,1.0,PASS
CBDDDA95C0DD0DCA138018C3A9B0E974081A63BCB8B59E2A36E8108201A6F9FC,137,119,18,0.2605890342736178,PASS
9C968BD741D387B183164872AD7A1A30D18F3EBE56CEE79D056E2B913B0113CF,127,129,2,0.9005235503397743,PASS
45939F74CF183B450E1760C87D8996A52D09197E5D6FE516E54B1F134DF49E3A,125,131,6,0.7076604666545525,PASS
64C8131E16049C898DEA46E920B96E5F80857D6D1E989E1450AC3E55EF5173E9,134,122,12,0.4532547047537365,PASS
D8BCEF60C607BE7AE964108176205E6A04EB40BB6DF64FCF080939BA66C68C61,132,124,8,0.6170750774519738,PASS
CAC60F78763B4E400A26CDF51FBF8F206047D017C318435D1C4C73AFF38861EF,129,127,2,0.9005235503397743,PASS
4B5ACF5413FA50CF1D305898FF7214F6A7A63F7A81B8B30C9CB1FC30B431D2F5,124,132,8,0.6170750774519738,PASS
7CE3FAD297FD213CB46989916B755D920EAAA405E24EBC5AEE83533AB12E4A35,125,131,6,0.7076604666545525,PASS
9B042D0F4B03E4388156E8663951ED4EEC12B712395552C4836347BBA1667B8F,134,122,12,0.4532547047537365,PASS
D1397629A808DFF182CF80E5BA928213CD6A46D4140E34A49D1992E5583D6CF,138,118,20,0.2112995473337106,PASS
1BDDD6C89972EC8AF6479D74528A8AD340B6AD889E7177B3F3367FD18B2579A9,119,137,18,0.2605890342736178,PASS
B11400B2D38A6ADB62289D3039053F5945E878AE998569BD9045BFBCB7DAEDBD,127,129,2,0.9005235503397743,PASS
89803037AD4095446A3247D5B7C4698B4BE560D09598B1814CAF50A6BE931806,144,112,32,0.04550026389635853,PASS
5A2708840C47C92F4FB0246BEC17D2B4A75459FBF7849795429A68B09BE41EEC,131,125,6,0.7076604666545525,PASS
85CBE5AD398D8403FD8D993CE80376AF2682D09FABEB28F1C3EF6B0C158DCD84,126,130,4,0.8025873486341526,PASS
9E1C674CB4B7BE32A763AF982C7B6D12C615A4CFF6617A257D5B9A917350C96E,120,136,16,0.31731050786291404,PASS
E1EEF1018045AF0CE03900E176889AC66F790C86DC07482F0ED4947C951C7BCA,139,117,22,0.16913144470267139,PASS
2E5DFBC6304F9D865AE004342370EE07C2CBBFBA2326991AED49372BD1C854AA,130,126,4,0.8025873486341526,PASS
67ACBDC38B109C7F63D3BB3156C99DD71A84D56A010E97CB487A0B8CF11D96C1,127,129,2,0.9005235503397743,PASS
BCFC4E6988F2366A420E8AC16A5D2E52F293454378DF318DA2B9C27D57EB6EF7,122,134,12,0.4532547047537365,PASS
6F0CB92A32DD3A2D3377E229086F7A071254BD1F19FB7701C771902926FEECF5,123,133,10,0.5319710580974012,PASS
A8A9A9A5FAFFEFA19765C4B2F75F3E416F3457C4A7B14B40F12A2873E32E66E9,117,139,22,0.16913144470267139,PASS
E18FAC82D429B937428C166D2CD450EE101FB08A18A6E2453D15AA6D94781696,140,116,24,0.13361440253771617,PASS
CED0C4B3A3FC2D70038410E702EBF63F0476709865D010B1131A45422054CBC1,146,110,36,0.024448945310089426,PASS
558A39E744BD943ECEE33AA8FEF68EB554E85F7A7638EFE120F9E0A83FC4191A,119,137,18,0.2605890342736178,PASS
828CC050D8517B28E2B3D5C2426AD4B6B936123437ABD3B7ECE28180D369648B,137,119,18,0.2605890342736178,PASS
A6A602BD19B9F4C8A942A3366210560C63C0A933586DEA0BE6042C4C9929E7BB,140,116,24,0.13361440253771617,PASS
4233528751319B065A89F5589B7BA917FE2E5A71CD779E4644CFDD6D070AF1B4,124,132,8,0.6170750774519738,PASS
E3B2F69D825A1A1AF3013D52C372368F254CD7F69A23E9080611BAC7471B2491,134,122,12,0.4532547047537365,PASS
421673082D43C8679E2B6C088900999B8CCA38545F264B712392AC3AB29348F4,145,111,34,0.03358661289689768,PASS
401483BC7751910CAA03F4EE0785AAFF79A42AFA74E21F4F441C3912FD29A6B9,131,125,6,0.7076604666545525,PASS
3B784510931CE323765792BEFA665DCED51B5B06DF1712671C180D532BEBE68C,125,131,6,0.7076604666545525,PASS
F568770DC25E3E4326FB625E5124EFB9467991C2FEBAFE0310BE1BB8E6C2E8B2,121,135,14,0.38157390570502125,PASS
EBB984BEC1AC0FC47B4ECD655E12DB9654AEE5CDCA041D5EDD3E7881153E1548,125,131,6,0.7076604666545525,PASS
4EA6DDA82F84962E434408C67B7F5F7355A4E3A370299C635EA6E21C7364B58B,127,129,2,0.9005235503397743,PASS
3625C0BE71DB7F70A4621D39E69669C974C2D0FE61998B03BCC9704ADA7F725F,123,133,10,0.5319710580974012,PASS
69FBA92CCEB4356B14D8EF36A42DC46A59A8E8461949ACFFE9FCA7C2AA5CBF5E,118,138,20,0.2112995473337106,PASS
60EDDFE58366A4D2F1C2983B12471727809C4EA44B1B2F6753B8C599D500271E,133,123,10,0.5319710580974012,PASS
852917C78746C4F43C039400F5F823876835E270397632BBD38CA91C54E10517,139,117,22,0.16913144470267139,PASS
17E56869D71261959971EBA19EEB3FEB397E22E51878768C6A251CF3A6F51013,124,132,8,0.6170750774519738,PASS
F142E763490735D3190BAF6004DDB3E0626CFBB77DB44E022AA6488E7FED5E28,127,129,2,0.9005235503397743,PASS
4ED9FA56B4648A157178456E5395F1B2506F566A45DC313EE50689354D40EC2B,131,125,6,0.7076604666545525,PASS
34E9732FE47C366D6EB344E0F0D4C349ED84302EB1771A609050E67E98F0F950,131,125,6,0.7076604666545525,PASS
D220C64696CD6A49D3EFBB0CDBF8183342E05E16FDE3F59F8554CDC28D6B1EB3,122,134,12,0.4532547047537365,PASS
CE8BE03EC390A094614DE15F35AC6C50CAAF833E55CA8A3FF2DCFB31F64FFA10,124,132,8,0.6170750774519738,PASS
B0F541C5DD000A8C92524BE7016FCA5EC9ED4432932FF64FB132F89F8028B65F,131,125,6,0.7076604666545525,PASS
D1E0F5CF168C493A256B401BBDC8D43E09F440AF2CE044611DB721F192803BCF,136,120,16,0.31731050786291404,PASS
5D6AC019DD86FF8F65A87345B2B7A8183F4BDF1E68871EB293391BF9BA5E580B,120,136,16,0.31731050786291404,PASS
E87250776D1F11D2A5FE69E0459B26C22AF1117E3D8F3114313D9877137F1ACE,126,130,4,0.8025873486341526,PASS
7D045CEAB00BC745EDCF1B1D15D02F0C8945206EB2EED7C8AD5E8775508CB061,132,124,8,0.6170750774519738,PASS
E1E8F8D15676EDDA7178C798396A8FEA2C06409DBFE7FB18C21CE04595F03AB8,124,132,8,0.6170750774519738,PASS
DAAB98A3F7706971267D2357647578853BDCBD018F14DAA450D05895D7C424F4,129,127,2,0.9005235503397743,PASS
B99A18C7607AF28837514FC775EA85905165239E87581ADB26FF8F510E43945C,130,126,4,0.8025873486341526,PASS
40F173D43E5BDD5080DC7A340E70D6C6394B1CC33E0A29467C869131FCF11C95,134,122,12,0.4532547047537365,PASS
D6FA86E68BB0260C559F971DDBE310DBBC6FBC2D16E872895C1AFF99BDCACA27,117,139,22,0.16913144470267139,PASS
22095F71D993A4B5FD404173A74E52EF0D557534130A4FA9885A0F66F9D0C2C2,133,123,10,0.5319710580974012,PASS
A8ADB2D57AE379A80765B9558AC144B2EBC060881095628DF6FBA6D57DC5073,132,124,8,0.6170750774519738,PASS
678875FE8D321FF622077C51D35CDE740A60691137773B70AD54E52E0E15BC48,128,128,0,1.0,PASS
5A5DE5FD7632BB2989BA6EC7540EE5345E5BC7C70CCC368C735D0B08412B8B99,125,131,6,0.7076604666545525,PASS
BC2DF2CF700EFE13360541D6000B3CF163D20F50900AE5FD31029F20491270B6,141,115,26,0.10416255883043901,PASS
1D845D701572694F0E8926EE5B17AA0F059992B258C7EAFE986EA9A007E3902F,132,124,8,0.6170750774519738,PASS
CC5DB1E997527BBE6D60D492EEE7B1436B7B492B752CE4C5DC97CAE73C42B721,117,139,22,0.16913144470267139,PASS
FBE0DCD88DF3D6CEDE29BA786CA1AB8968DD41741591232E4BA74339A3385F61,124,132,8,0.6170750774519738,PASS
1A0C6D77E669E0EF5727A82D0FAD26C63ADCE5EC89CBB19B5A447C5B3C4D84AB,122,134,12,0.4532547047537365,PASS
F8AB101167BE450997816C0AB3DE77D8595A54C59F5FA234DC413E65B476626,130,126,4,0.8025873486341526,PASS
A94AC446BB29F383757A419BB8CBD5C52ACF198B7AAEC8C84BB3F79A34AB607D,122,134,12,0.4532547047537365,PASS
2FC529FE0AA6CFF0715B68A6AA15A3BFB7C23826AA28CA4AFE5D7BBB53191AA0,123,133,10,0.5319710580974012,PASS
EB29B448F0120A60B8FFC8032041315FA38CF1DAB5E3A88AD8D456DFBE22336B,133,123,10,0.5319710580974012,PASS
433BE4D5B0DAA7BAE57D00F648E907E3E58AF22FCAC25A4C46E81F81FEF3EC82,123,133,10,0.5319710580974012,PASS
BFAFE21AA667F3962C7773B1B64AEFB99EA9699A03DD6FD7285A9341A16750C8,117,139,22,0.16913144470267139,PASS
E7C23312C39D0A3A71E8AE8B1951C3D798D98B431FD1DF4E05A33F6EB7B9E606,123,133,10,0.5319710580974012,PASS
29A3D121130F10A6B6BA2D9B0CD7D8943689E1962269503EAB792A6603BCDA6D,135,121,14,0.38157390570502125,PASS
19382D6DC15D9F82A06613CDA1585471A4980FDF053781E104A8D896B6B793A3,137,119,18,0.2605890342736178,PASS
2D730ACB3E3A24A14671D127858BAD34248F4D9EF3C4DB89AC980E08728234E7,136,120,16,0.31731050786291404,PASS
1824B480F132471C0D390808DA394A6441A427B5923658ADC244567F4659E606,149,107,42,0.008664896726025117,FAIL
C6D2C6465E6E44C41EA520C8A48204CED0837F083460787E7D438B1655CDF707,139,117,22,0.16913144470267139,PASS
689DC84318415B537644D6F988A90F3752C09144C136E64594E7F27525A9C895,138,118,20,0.2112995473337106,PASS
93F25ADB53DB4273CA75E5F0593850E4E762ABDC5024517EAE4190B42E6D79FC,124,132,8,0.6170750774519738,PASS
BDA35E4B8CB73AF641237C9816696191912BC0158609E56C3A45C5874988F9C6,136,120,16,0.31731050786291404,PASS
F525BAE15B965B98AE13B1716623672412F3DB25288A278E637192634CC48175,133,123,10,0.5319710580974012,PASS
288EC22A4D53AF4D96AF0FF26373A9E0BD6112CC03862AAD4D5F51F95DFD2D40,127,129,2,0.9005235503397743,PASS
1E3B05F0210E830229A4491E0FF456A4A667716EE0F7E5F6607154A162833B30,139,117,22,0.16913144470267139,PASS
9F5D1E88C2944CFF7BBBB819B04CFFDFD17953EB1346A69E2FDD54690CBCD94C,115,141,26,0.10416255883043901,PASS
85840625FEF6FF0B4E325EBD89577997AAD51EB16A097FE5E76E7C1F7E84026,119,137,18,0.2605890342736178,PASS
6A5B8FE44A5546ED05861F1704F088EB5AB46AEC2A9108EE59976596F1FCDD48,129,127,2,0.9005235503397743,PASS
7A042E957E00B86988A6AA78E87E2CCAF395FEE1B9B107043B70C8521973E504,135,121,14,0.38157390570502125,PASS
864D9FB2E2EB44987E9289F1B03BE4D42747A8274AEBF22566983D3A91E4C752,128,128,0,1.0,PASS
A0F75501DAEA837A5655B72132DE7B509DD24E1D2A8A750AC9166F5318514C9C,132,124,8,0.6170750774519738,PASS
5E5B9CB7AF71130A1CC2E5BE93330EAA451F628B30FA20EF7F69067F3E3214FF,120,136,16,0.31731050786291404,PASS
9D43B7217925718CFF5757B1C972826EA259F43A6B7A2FCBFE83E3F401184E28,123,133,10,0.5319710580974012,PASS
AFEFB8E88EEAF898FB669220C1DECF7E8995DAE70C378275A0538461F0039EA1,125,131,6,0.7076604666545525,PASS
21F1775D0B3D6D3B7922A80D802BED9E6FA8F6D0DB2042AA1C6426F9CB7556D,128,128,0,1.0,PASS
341FF83C74230921807BB2533D44A5B149DF37838C144CE18AD59344DD584F9F,134,122,12,0.4532547047537365,PASS
7111F26C8699ED232FE3D17264D69C2FC3C7D23C608CFBC6C108749F9CEECBD,125,131,6,0.7076604666545525,PASS
41642E15AFEF1E51A0718B9BCD763052E87FFF9CAF64E4C67310C7F8B52305C1,125,131,6,0.7076604666545525,PASS
838468EC634F354E16D1BA10D3350454864A2788EDED68C503F3528582C2D5A,143,113,30,0.060792723530522785,PASS
B0FFE236DBDDBA60A730715E8E5F33B8E1461E8B0CF7D5D3748113D689BD4E8B,119,137,18,0.2605890342736178,PASS
8F0624C98D2B8FD41D8EA6CA08A7D2AFA3FDF8715814B3DC097BD1849F4A501B,130,126,4,0.8025873486341526,PASS
F9F2996E03B1D95B65B1EA2AFFF1553F4D557C81413C076DA18D076601ADEB68,123,133,10,0.5319710580974012,PASS
E8222CB73252C03A8924B88BA20AD348CA92E5EBC3E1E32C8962AD5A30411FDF,139,117,22,0.16913144470267139,PASS
B3E0DB25E7DAB304F0D2F70AB5B5DA76F0ED288B3D8043F1FC4E8A621426136B,126,130,4,0.8025873486341526,PASS
7BD271CB9A2FC42F78025F654FD88706F7C34D4C29F38B15C2DCD3CBC855C3D5,122,134,12,0.4532547047537365,PASS
FE26CABB43CDA1904C9A2A260079985B717B6D5315E4DF769BE4A9C0DF22E9B4,126,130,4,0.8025873486341526,PASS
A7BC8ADF05C4382D1BD887F9CC3A523537EDED124CFB9C4F55B671558E61783D,120,136,16,0.31731050786291404,PASS
B47F95449BFDB9D057F139EFB13EB161E9849529CA5573419CCF12C77397E5A,119,137,18,0.2605890342736178,PASS
DE6C0C907099C41D8F0CB21F763871FDCD25395CB16A11487029B7D41C13CEEE,132,124,8,0.6170750774519738,PASS
D2A11744A097110FF1498BB8151D6DB9DFB38C0CCD535030BBFC08B0B56DC2C6,134,122,12,0.4532547047537365,PASS
7B3A4658A8C55AE3C918C3CCDCA610DC7EEF624301832D297FA225ECA10EBDA5,131,125,6,0.7076604666545525,PASS
1859F736D7169CAB79D2E19A2C7E541E12B2B14E15D7F5B307E8CE063B4FCBC4,122,134,12,0.4532547047537365,PASS
5E7E36F6E29C3344D5948689238B159BAE4151BD9DDA077DBD67ADE0EB6445F5,120,136,16,0.31731050786291404,PASS
4E73D8AA28CC00002DA1D61A3D95720BCE33633A7C37D24EB457E99E47E0B24,136,120,16,0.31731050786291404,PASS
D98517F5A28462F622AC992242CEEAB3D41B81300661D34BFE1DD34BCCE9C149,134,122,12,0.4532547047537365,PASS
EAA52FA81615D5A825D421EA028487AFD0E60C530933CC6496F465B4CC5B67F4,135,121,14,0.38157390570502125,PASS
9612F2ED7EEAC9993FD4E558374E6EB93173DEDC3E30B5460EDE3E877A81952F,115,141,26,0.10416255883043901,PASS
3F0C8F5B6F90167510DDA88F64905E23B89E0855C2AA1F5C4B7DF32A1CBB7AB0,128,128,0,1.0,PASS
384AFB1044D54FB156252F061E492CA96B178CB5B4D510B859523CC56657029E,137,119,18,0.2605890342736178,PASS
A38F4FF525E83914950FB0E15A142670A083D0E5BBB08AE05D473A8C738F302B,136,120,16,0.31731050786291404,PASS
723D98A3041F6DC260821DE6682854CCD1CF7D53C3D9EF7B73BB8B39F819FB61,122,134,12,0.4532547047537365,PASS
346BDD7EAA366216878DC241A9C8792AC83CA791C369EAFA06AD2C9DDD5AEF2,127,129,2,0.9005235503397743,PASS
6A0B36CA8F1609816F27E20E10CA1346B389D93C3BDF4BDFAE7AD455FC99235D,125,131,6,0.7076604666545525,PASS
16C589B1448B3AB2ED1809E855EE3D1DDC751F4E5C5C5D0294BAC938EE948691,132,124,8,0.6170750774519738,PASS
7929CCC160DE0802F7B9E70F797A5A37C61574059566EB9797F24E27B314E8FD,122,134,12,0.4532547047537365,PASS
B844B57C3768ABC2D092269A3D7D4C66693DA2AAAE4568CBCAEF5AA1829E3024,132,124,8,0.6170750774519738,PASS
9E38857B9E0B0A52C0ECBCAC8050084EF6BD910CBB51DC5F2AA7A1455EA7A59A,133,123,10,0.5319710580974012,PASS
607D6E274F5BA4ADF3760F3BBF44CB22F1CDD85F43BCEF59DA7927835990A02,120,136,16,0.31731050786291404,PASS
E9D3D0BB15604AEEA0188CDDDD6DEA31E79EF64B642B8F8F15C8E9AA1340B7B6,123,133,10,0.5319710580974012,PASS
482BAE9B439FA098AF2EB3A4C09679EECDA26A44CA49CBD041D7B24EE464F1ED,128,128,0,1.0,PASS
6B23EAA83D5827214DDC62A181D9F51C41F7E1B27F90F7CADAA68A86C934B268,129,127,2,0.9005235503397743,PASS
8485746FB939EB129AE4F2F63C36591711E10AAC998FD4D4C721DB4169C860A3,132,124,8,0.6170750774519738,PASS
EF0966A1FA19CA328B2D17B4AC554D975363F646564700C81D9C128929ED68B5,133,123,10,0.5319710580974012,PASS
4D6DC64F3BD9B369BD42B3C9E32F2A688F76AC8505A8139B1D479DCB2F804B6B,123,133,10,0.5319710580974012,PASS
314CF2D9ECD0833C7E52D3E85DA1525227B23D0303B6F42FF3751A7B5639949E,125,131,6,0.7076604666545525,PASS
FE6B7FA011D6035BCCF221D84993F3BF8A35A8B418CA6CBD735BB745F7471FDB,115,141,26,0.10416255883043901,PASS
C55A18007C2BA7C19D698146BD394AD4CC778CA0546BD98C302AE9ADA36D83ED,134,122,12,0.4532547047537365,PASS
AD8A462D953CE40BAA2382488D59252F5E1DACFE99031F1369E646A764787D56,131,125,6,0.7076604666545525,PASS
56206C8867F95B8F53C080FCC8525B252F0491C45AC3448B6ED17442E3176D74,138,118,20,0.2112995473337106,PASS
E779305ECD26F3B5BE23C308B6750BD2F1163D144639F2EE26635ACA8F6BBD6C,120,136,16,0.31731050786291404,PASS
C8B63A62209FD612CDB8257B41EB435AA28EB84EBEA808810B5CDE11CA62813D,138,118,20,0.2112995473337106,PASS
3921BD093581CD798FD17AE3A9E4FCDAAB3C925734CC4DCF64B709C1B72FF58A,120,136,16,0.31731050786291404,PASS
A6341CCAF994485CFCC0514D72A6D09B4DAD812D2C2C78F3C960DF9542B1E0B4,135,121,14,0.38157390570502125,PASS
844667664CE2D1481F9559FF0B3E8752C7155E53511CD88AEF986A27CA6FA3DB,125,131,6,0.7076604666545525,PASS
D4641FD217567C4C8163EE840C20E2C4A34C1F78617DDB1008B1FB3F7737107D,132,124,8,0.6170750774519738,PASS
67F24F150DB830479A828726FE2AD6EAC7C433CE9948AEDCFF38ED9AB8E032AE,123,133,10,0.5319710580974012,PASS
C4B28C02E9270B2EBD7264ED9C57E478EBBE0B456109D6C4CD7423D04EC899AC,132,124,8,0.6170750774519738,PASS
5053D217A0FC9318F7D1008F9B1B36C718C316FE67E33F0A55E000F3F9B217B8,129,127,2,0.9005235503397743,PASS
A2073FFA0A05DBD7B665560EEA830E594CBB4ABB32BC45DEAFB975B11C58E789,121,135,14,0.38157390570502125,PASS
1851C97A8629B0240CA65BC1674C68EE26915C9B0F11BA9FDACF06A6DACC7CC0,135,121,14,0.38157390570502125,PASS
A7837C3412122003621374299C039F139D345CFA0F500FD2DABF52BDD41B9A10,139,117,22,0.16913144470267139,PASS
E9B977FE52DC8FE2BB6E27422EEED8BEA640C52050B55D894DDC49540162576C,126,130,4,0.8025873486341526,PASS
8B934AEA909E6747C8D2EDB1790530256D540801B1D8592180C02315B91DBCDF,141,115,26,0.10416255883043901,PASS
96EF9EFF743E625C935C8743AA28154052D532A36E0C4FFAF641B82D2F648F36,125,131,6,0.7076604666545525,PASS
4EA79A289702A29ACA1214A7994CC6EFC5D774459B2BC18CAE5E962FE724CA7B,128,128,0,1.0,PASS
3FC5AC3D753E9F84DB699B8BCF54FCD8702B5B6FC9ADE1825C15B903C5208BCD,120,136,16,0.31731050786291404,PASS
69B064DABCA7C0002D5BED2B65D20DC4D4937D71C5545DF24B34EE1FF715804A,129,127,2,0.9005235503397743,PASS
DDC741B9A7DA564971EEDC2A58B2CE457ED5595F34EBB6F3C30CA8CE66DC975B,114,142,28,0.08011831372763423,PASS
44C793C654077E27BAF91F5F16CA404447F29469E8EC6C41DDECD3E9C03A3AA6,127,129,2,0.9005235503397743,PASS
45EF76E377999F605718A645BA5F95C4F7A798B8FCB620057338BF586DA9A9C4,119,137,18,0.2605890342736178,PASS
2AE66E1373F37280DB5F9CBC626F2319C9AB97BFB7AFA04EE7A63EB8B22E0F6E,113,143,30,0.060792723530522785,PASS
38087158553C848B249521C9029D05861BA8BE6B01C552321C66F2E55CC2CCE6,146,110,36,0.024448945310089426,PASS
44A66D12731A41B03057EDE935F4623E41EB18355F2BDF02FA958372FB82285D,130,126,4,0.8025873486341526,PASS
3C62C2D12B269D9F961D746E507BFBFA7EBACABDD8E8647E9047D27AB306B3C,119,137,18,0.2605890342736178,PASS
75B22908FD60FCCA80A0F258AF1F06FF02F9768EA50616662C5B81B0C189E193,136,120,16,0.31731050786291404,PASS
C1D75792607F6F7977D24E5B7BF412F3B0E264E79EF8F46046A2AB2BD23682DB,117,139,22,0.16913144470267139,PASS
7DA1C229E74D660F1CAA0A97675EFAE731A9A9682645662880DCA2CD8D28D006,136,120,16,0.31731050786291404,PASS
BC04A351E46BAF8ECB9D1993E0051C018CF375EB15F0B50C277285C839032044,141,115,26,0.10416255883043901,PASS
AC9649B2C31B6F3134A6DF49F5A035BBAD73B99B19C8F9350AE95DC1B288C9E6,123,133,10,0.5319710580974012,PASS
B01BA5F1EDF5934DAFCD314F37191B99409239A17A3E73BF7F0FCD900022DFC1,122,134,12,0.4532547047537365,PASS
D26BA26EE1F86437FA7A69D9498454CEEC795BFF9BB11CDFDE6EFDC36B94147D,109,147,38,0.01754895019147673,PASS
CA4F3D516D1C11FA90D93C2A993F21A2DE4F1E3206E94D6729CC83A4DFC5FE00,129,127,2,0.9005235503397743,PASS
E6D3235FA86FCF9001C0082C35F1E8981669423FC853503124281BA2440D6122,149,107,42,0.008664896726025117,FAIL
98BB1402EB2EA1D6FF32C3FC5240361132D595F3508C24F802DF78869E0988DB,135,121,14,0.38157390570502125,PASS
1CED258A62E120D8D5F30FA380BCEB0BA07EBB3772D019E258BEA1B7910D9F93,128,128,0,1.0,PASS
24E758A190DFEEF401D81520D4327A5196A61FB32D91699F669D5414644F8039,136,120,16,0.31731050786291404,PASS
F1B78DB3DB78C48073372E1A96B14BF2D78080CB153E191676A7779915D0D1C4,128,128,0,1.0,PASS
922DCE4F3CB5D261A0919BDBD05FC8FD3C4E2639F5C9C0D168B64FD5424A2E06,128,128,0,1.0,PASS
B4934F6F405753DD2310E4C4180AD03ED135C58E53905391B778F5D728EA2F98,132,124,8,0.6170750774519738,PASS
E005DE34CA0653ABE8849BA2C338733A93ED02D5A018A33E94F960AD476178AF,135,121,14,0.38157390570502125,PASS
BA81DA17B05A6289B3ED95A69835E9C42F919488FD8C319292A75684E4E7DADF,128,128,0,1.0,PASS
6DF38358483F198101103B52233A993B543371BA14197AB2FCF945B3A6C838E6,135,121,14,0.38157390570502125,PASS
662B2D326628163DB149E701F40980380A7E59C49F659ED3F3E7D0E5F1053AAF,130,126,4,0.8025873486341526,PASS
6C2F4C2F573563F216E4A21ED96C405383561C5B476C3365B76DA0B3760577E9,126,130,4,0.8025873486341526,PASS
992CACAD05DB2B65A620232A9859AF05C699A82786240131C11B0979BB2920DF,143,113,30,0.060792723530522785,PASS
52DCD249819FDB17C02C7777F761846F6E78D443A77CFD66951A940AEB9096C4,124,132,8,0.6170750774519738,PASS
4AE912F048C9630C671065AE56D70DE9CAC20058C89D950890FF8780844B2BCB,144,112,32,0.04550026389635853,PASS
48C92E447D2BA17588FC5BA80A8F55D7946E5FD2724156430480F251669B072,139,117,22,0.16913144470267139,PASS
37E49F68B53F23DD1897F33312D99509DD76151A8F42C55CFC4EB8D16264F256,123,133,10,0.5319710580974012,PASS
88E361D29756DE13A001BAE036CCAD155E8A2B8AE18AB3CEBB53D3A95092B944,134,122,12,0.4532547047537365,PASS
6F33C698C449587AC81E086D4BA64BBFD1128AB68EE4FE604F3AD127360424B,135,121,14,0.38157390570502125,PASS
6349650843ECC919961443383B06FFB2AD33FAFAE0A331FF5B2AD2693ED85B23,126,130,4,0.8025873486341526,PASS
292C7E63DA1014C56CA4B3D4FA36424806CADA04F7CB44CB5613D9B0D1497292,138,118,20,0.2112995473337106,PASS
7BCED9F17E095834464CF1749667550970597B9BFD985A40612F70D40C672CE2,129,127,2,0.9005235503397743,PASS
FA2CC6A0B4ED8AA43BE78EBA7B9F6280F6A3F8E14F9C6995A51EEAB0F6156D12,121,135,14,0.38157390570502125,PASS
27629B163C7937F335D369EF9DA30A5EF5D77C1A2DBE597A3FD6048FE175B231,113,143,30,0.060792723530522785,PASS
9A8590C17C46A27EC58A9FE3F085C2C98DC1F730972AA9C8A20472A3702C8A58,140,116,24,0.13361440253771617,PASS
84B6159D2B642764A9F441B9CA4466D93BAB1B7EE985020D574E64C5DF896948,132,124,8,0.6170750774519738,PASS
A5D189029BBE184AF6E4BD7C12499954FA4F63886148C8379471EEF9D48CF154,131,125,6,0.7076604666545525,PASS
43C1F1A57F20D7FEF97C1CF717CE6ACBE93D37AAF8BCC39214708013295C2324,124,132,8,0.6170750774519738,PASS
8E1F673706FAE98898BB4CE2B5F89D4B8D2A2EDCA3A487FDC9F9B03DB6163F02,120,136,16,0.31731050786291404,PASS
8C4DA855BDCE50C73F933F90895394965BE658A7EF0FE0D2BB77582D278D6FFA,117,139,22,0.16913144470267139,PASS
18E8D24B71B4B4C2B8820E6B0293935CF05EB0B96848DB1A4FE755899A6738F2,134,122,12,0.4532547047537365,PASS
371CC693B1B6BCAF82BDE7A9B8B348602D279FF1AFD9E26E04DFC7AC8A83CE6D,117,139,22,0.16913144470267139,PASS
B4E927B1AB333D384A650F038D840973E62832F2E8744F0ED826D5D3A39D13B6,131,125,6,0.7076604666545525,PASS
2D64D32D6A272F1D6841D213A047138318E3BFD13A5D26EAF8CF8355F28E175,131,125,6,0.7076604666545525,PASS
4139BF57468790C21AEE49212BC89BD0A9626D7235DAACE6FE7167999DD2767B,123,133,10,0.5319710580974012,PASS
B047CDEBBEE976538862B67239DB97E4EFDB18FD665D2827F8D88CB8E45AAF8B,114,142,28,0.08011831372763423,PASS
D621584B8B424BAA9436B4EB68CF51D7B693FF87E3E9EC6C3F1CFB5B597E01D2,117,139,22,0.16913144470267139,PASS
98B5B36F3BA0BF5FD6F662A736CC464FCEEA9ABF34DF9DA6817C1623064D2D6C,115,141,26,0.10416255883043901,PASS
20B26ACC94CFF83C8A23E20BEE07F4876E5ED8A3E64B7D960B1D96A8EB85E355,125,131,6,0.7076604666545525,PASS
BA03289BBA80F0D78D0046716B4643F13268F0C76EFEDCDD2B622D52365E2770,131,125,6,0.7076604666545525,PASS
BB5F09C5A5FFE2957727FBD1E511D39720A37C2A33CD33EE2CFB7BC96C5A7D27,110,146,36,0.024448945310089426,PASS
DEB055AAEA716F75FAFA089E692326B9EC723CB5832C6CE72AB1F30BD8095699,122,134,12,0.4532547047537365,PASS
C5FF80993C593E6B90BE8C3BB4BC8C2B82B064020B94FFF82BFB95E43D8E02C8,129,127,2,0.9005235503397743,PASS
43677E886B1ACB26C71AC3C28FE5511876AB30A1856A8F69CE5AEB07837753B5,127,129,2,0.9005235503397743,PASS
7F676857870AC139E42766034D6D5DFB97739D8BE4104D2DCF227BA2FE971014,124,132,8,0.6170750774519738,PASS
BAB31D8FB4BC67990A000A133542186CADC3FF13AE7711DB9F677A4A069712E4,129,127,2,0.9005235503397743,PASS
A57D05F45FB8BA9D5D4274DA3B12844D9561C718B9D7679A2C50FEF73F6AEA98,119,137,18,0.2605890342736178,PASS
231F0250A56EDDF9BF387D83BEB0AA41DADE634B44BEA661CD6B247273D264B0,125,131,6,0.7076604666545525,PASS
6463E7E9825790D7BBC3B0E68ADAED2238B445C9A75FA96BC58247E115C49307,128,128,0,1.0,PASS
20B524C8007F79BA422C75CC56080D94A67F3088415F537416B1F7C6C5E1B874,138,118,20,0.2112995473337106,PASS
C28A4718E2618FE022D9896BE91B402886B285D411E257522ED7B31ACBEB733C,136,120,16,0.31731050786291404,PASS
1B0DB6E084AA23AADDAE8905DA0FB0F112FB833C74BA1996BF222C87F19AD902,132,124,8,0.6170750774519738,PASS
9AABFE2BC00CDA35FF6C0BC3EE4DBE9665891EB965F9183A2ABF13A60302F941,124,132,8,0.6170750774519738,PASS
2401BBBA2815C7F4623C33FD09DB7E44773B3F1DB0971CE0F5B675BC911C70AC,124,132,8,0.6170750774519738,PASS
DE24846C0A3929A1059954B9F582E365625620E9A56FE59123E9FBCAD01FAF90,133,123,10,0.5319710580974012,PASS
3B5B1E589F15141AC31FC0A464AC1197E76EE612BB94AC82AFD2C487E7F033EC,128,128,0,1.0,PASS
121D253DD09A3B11A1DEB4AA68A225545CA3F65395B155E3F0AF557F69D06A68,129,127,2,0.9005235503397743,PASS
8E29F180671CDD57D39B99E493F6843C877AD47FF3B5A2CFF74CAC56770095B4,118,138,20,0.2112995473337106,PASS
6A014FD99F8DCB472218F642410E4EAFA204DB9A227985FB5B5EA2A60D1B5CDD,130,126,4,0.8025873486341526,PASS
2F2312B6E155620D7D9700FCA8513B21C6C6F204EB88CA975C9E5BDBDC165871,131,125,6,0.7076604666545525,PASS
DDB46868E69E63705699CDB85E67B332B5A253A2BCC01C84A92982AB65C75075,131,125,6,0.7076604666545525,PASS
3FF20401EB1882498F057EC7D527C831AE8C8D3D909BF0C0B9097430C8A0D9E3,139,117,22,0.16913144470267139,PASS
B37AC7F3DC0607E13BE74AAE6F277732E7B208489A865AE26A909022E03FB0F0,129,127,2,0.9005235503397743,PASS
C35C5ABD4FC70E5049CC5AAF336D2CCC7F8ED3E116E8BF4A4409BA911EBB0B6,126,130,4,0.8025873486341526,PASS
F0A6E01B75F9915DC5781825A5A3B09F7FE55C4B36A163917B03A71EC7F5DF20,122,134,12,0.4532547047537365,PASS
E5B3C83877735164641312D1FB8B1B9E49DE5C1541DFECAB124C2535053250B9,132,124,8,0.6170750774519738,PASS
F34CE9A02ED68545D6A7CA85B4C37925FAA343D3AA54B51DB304B73466CF453,128,128,0,1.0,PASS
60771893FC8654FF0F99C9757613CB739F4E6F7E3329CF9E37F419CB48476566,115,141,26,0.10416255883043901,PASS
4B53B922BEB27DBD22D20E77099986C7C787F826E94835BF6B6C2B9D345E59A6,121,135,14,0.38157390570502125,PASS
2B6D4DA5011C4C2B02612E42ACD7336C49CB3F7B0D80B501FBDCFAF68296987A,132,124,8,0.6170750774519738,PASS
46DFFD5BE41B344C93AAED7976C3DF649C0BCFE9161F4DBA9C89B9F2AF7B72F4,109,147,38,0.01754895019147673,PASS
288E558B224C28CFC6AE7B74A5C1E085334D2B326E69DFF072964F45DA132E74,130,126,4,0.8025873486341526,PASS
A5935E9E33358E50479CD912D9173FEFCCCFF12854F8161AC6F26FDB496E724D,119,137,18,0.2605890342736178,PASS
D865C5C126956FD2F3BE06EA2881FAC3274864E8269C904B3440ABF63416F608,137,119,18,0.2605890342736178,PASS
9F1798ED1F879DAF700724B76802350CE84F2E5EC25E9743606159F0C10B4322,135,121,14,0.38157390570502125,PASS
BE2D876C8251E594D70581EDB712315BA19AAFAAAB6E939B24657C9D17AED9D0,124,132,8,0.6170750774519738,PASS
C9F2B878718AFA0E164B81370D9D9C62B1B1FED3148A573D68D9FCD2BB4E4E19,124,132,8,0.6170750774519738,PASS
FAB2EB5B5A1F39412C2A8803389A27BC23AB66B7224DFF64B8C9381B2771EF87,125,131,6,0.7076604666545525,PASS
E2B3F0D5EE89C43ECDCBD273303AD725F805AF7130663E2E92B027564F432D1C,126,130,4,0.8025873486341526,PASS
5268A56395D09625F5749EDE8D02AE53697B6A78D3C9735321CFD8A0D2FE1E42,126,130,4,0.8025873486341526,PASS
8EC1A17ADEA1F57A69AF1855CC67914A39EEF70E33472BF9CBFAFC14EC8EB3F1,114,142,28,0.08011831372763423,PASS
9696EFE1E97D8E62CA3156AAC327F3738D3EDC1F7E107DA59ADA15B6080D6060,124,132,8,0.6170750774519738,PASS
804BCB0CA33A5E3613EB84447255508433CFD3BF4FF6AB86AA566A8A3581FDFE,126,130,4,0.8025873486341526,PASS
619865551FC0B7C8B61EF25BE05E12E10E824ABFA454A9915F114878B3BABB7A,130,126,4,0.8025873486341526,PASS
4A563AD78A816676AA87B33D7E227211D5714DB6EF36697362A03C15F871A78D,125,131,6,0.7076604666545525,PASS
A48956A402E7AAE5FC990C9104ECF04D48CA4D96C389D3F312BBB7B5C2F70CB7,129,127,2,0.9005235503397743,PASS
A8F890203E547B6EE11E04F477B62CCC3C4FC246F7910C2A52E47710CC7AF0B9,132,124,8,0.6170750774519738,PASS
6CA1CC93380E6017D5DFDC2FE6D7E20AF385C156F73F1578C6F5D852CB348B33,121,135,14,0.38157390570502125,PASS
7E818D2EA411EEF0B28C4F23C8B2FF05F7D415E715E61A993F44276840E3981D,130,126,4,0.8025873486341526,PASS
DC6C695FA73C72A219D9E2D13C0372900A998BA60B59F2ABBE55B539288C1256,132,124,8,0.6170750774519738,PASS
B9E75D9CCED56C033AFED3C2BB1A4B7EB950CD49BECC324A949B1923487205AF,123,133,10,0.5319710580974012,PASS
A18C1FDECA59F9895CA576A5385CE56FD8C17D2346BB4E51FCB8BAF150CEF3AF,116,140,24,0.13361440253771617,PASS
ADE4B1B5D621BB8B6289C857F0DFE1614B88EAA952C91AE9AC268336E299EC06,130,126,4,0.8025873486341526,PASS
FF120AF29C1633A456480D50EEE99963DA129E47167B48DD64E7D0DA045290E3,134,122,12,0.4532547047537365,PASS
B043CD5B9492B4619434638E2D21C7C16FEF176331E7EC3B6FA1F4D6C253860E,127,129,2,0.9005235503397743,PASS
A02B4E4B5D990A41D0EC196B3DB28CE62926C92622BAA050A0C8687A2677C0D1,144,112,32,0.04550026389635853,PASS
8DD86E48D423871CFD227EFCFC203B096EA81155D3F22A1E733459E7B1DADBF0,124,132,8,0.6170750774519738,PASS
EF677F86D314F6254251E791AE1A8F06CF98803A312977C5031FF561989334B9,128,128,0,1.0,PASS
22E380E02A107B09F1AA025BB955082E74CEA24768B1F6EBA549CB5AFDAC6071,136,120,16,0.31731050786291404,PASS
43E852AD50BFF934F7819D71EDDC67C494B0411B7FF5B98B127899AA6A88AB18,125,131,6,0.7076604666545525,PASS
F13BD8897E318054428811AF7E604FB390EEEFC8F1727F39D14AC2935813F6E0,129,127,2,0.9005235503397743,PASS
46FF2FCA249B36EF60C1105337AB1150440A0C50329886732BB9316A3D1B1EE4,139,117,22,0.16913144470267139,PASS
FBF390D6FC900EFE4DF470EF0ADBF818EF0D41A907A4766337A3E0CBDF27DA92,117,139,22,0.16913144470267139,PASS
18E12D95803C30120299977D8DC1123C69CA6A41B08484B7D63DC4E9AC5C6BF7,139,117,22,0.16913144470267139,PASS
9AAFDDB0ABB1137480A832FA74DCBBD487B2F37786A6CEAD1C659CD354EC1DE4,120,136,16,0.31731050786291404,PASS
2088FB28A36B8A75FCC07A776844F6A0292D6C1F5BFE4C637A6849889EFD8DDF,124,132,8,0.6170750774519738,PASS
54D3AE879C3C95FF598471795AFBD97035281069D7537D2D9EEF2C9605A902F1,123,133,10,0.5319710580974012,PASS
BEAACBA63DFC71F9AFB0E21CA9E035EFBFA560F140928BE16B14E44068DCDAA,125,131,6,0.7076604666545525,PASS
497E259B7372903FA4B0C3C36838F5AF3F76341A6F9ACF48D549C3BA1DAF9616,121,135,14,0.38157390570502125,PASS
F9789401462C550FD5012C5FE2FD3F3C29D810A544B7018E05DCCE184A079DC0,140,116,24,0.13361440253771617,PASS
B2F407C97C5921D8A22BE5BEE5D21A2A90F67C201306F2F4BB9A49E400A07460,138,118,20,0.2112995473337106,PASS
3A74FE53D39F486D94FC482633903E01D2A30FEAF6989023B4D90F1339139F1D,129,127,2,0.9005235503397743,PASS
C7A3997124EBF2F5A15C4A830A2F4B164A16FD956FF9BE0DC1DC37C97EA04259,124,132,8,0.6170750774519738,PASS
ACC054D9D4C6C2D8053C2ACFCBCF3D7DE2BF90CD5D173435789B30A92056AB8C,128,128,0,1.0,PASS
FCC440D60CE9178C5AABD1D2A415F8AAF92B85A24D86F2AE137C6A30D43B3916,132,124,8,0.6170750774519738,PASS
D73F64AD26D4F5B3AC9D4067DD89DEFF0C77A030E9FB02AF77DB5DE08E675B9D,110,146,36,0.024448945310089426,PASS
799DA1DD526313F2EFD19EB6C29132576519891B35EAEDABC9C445BE06E0F52F,121,135,14,0.38157390570502125,PASS
BEE8903EBEF3E5116E0A208A2E4FD5A3062E4E6FDDC49308D325BE769F7B0A02,127,129,2,0.9005235503397743,PASS
ECEB3E532CAF2233953A282AE86A881F18C1EA4119ACC36C3A238ABE4983366E,135,121,14,0.38157390570502125,PASS
95EA705F00C0DF4D770EC243CC22D7B1F94DE238867C7B04877E852E31BFF592,126,130,4,0.8025873486341526,PASS
46C1C6DB75A79E653AA115C5B3D72DA1C7151CF4D7E3932998AADBA57FC16AB5,119,137,18,0.2605890342736178,PASS
2A9170F760C114F467461D12F1D8B959C4E6E76F6776AC656FC4CF2AA7E41B15,124,132,8,0.6170750774519738,PASS
D166CAD57E4706734035A85C2824FA85645BDB3C57886F60279E763A666311B2,132,124,8,0.6170750774519738,PASS
27E3C87989EC16E604D80048AC7E7DCD9006A63953FCE2FC5AB8DFBD98406059,132,124,8,0.6170750774519738,PASS
48DA5AE7D37B2F09E6A9041169100ACD300D544E375E8F560C507123B0382C85,143,113,30,0.060792723530522785,PASS
B925CD93AE7FA8C0011B0B1805FDFA3951397ECB36BCD671EAEBE68F07D33833,121,135,14,0.38157390570502125,PASS
7B81C1D58BFEB207DC08F35F5421436E4004EF555BD7BC186BF1BE6F5D8699E,123,133,10,0.5319710580974012,PASS
A3D58F6465B63DA19D3CD5FA6B05E91083374869EA8361864C464C2735AB6AF3,129,127,2,0.9005235503397743,PASS
3C88CC982C318F40E806F374AEE6B3FAC63330760936E929447F5B7CF0D4226B,131,125,6,0.7076604666545525,PASS
BD2D1B41299B20B3D872C3DD2434E12C875DD92B0437F45F29F1FF0FEB7EBF5B,117,139,22,0.16913144470267139,PASS
D90A0A8B37A04B1AA723E7B69ACB368A3EB2F4F88C301CBED6FFCC62D1DB2616,125,131,6,0.7076604666545525,PASS
2A9D6E5A3DB92E3DDEE4F384FCEA130401C7CBBC414BE7EA7C89362FBC09A96E,121,135,14,0.38157390570502125,PASS
D487C82B60F60641732920511D0FE674E918991EB0983EE0526FF7C0B5AAF969,134,122,12,0.4532547047537365,PASS
D9DABA399E2445AEC9F17B66FCFD5469EB6F31F0BBF36052B2FDAC2C8BC7F54D,110,146,36,0.024448945310089426,PASS
BBEAF4232361D8B41821DA84392D61A285C321BD3CD861F44EF3916FDDD96E60,130,126,4,0.8025873486341526,PASS
B1C457ED66C18A92950D739FCB1FD9489FB7288B1EFB8EAE58CE6F9364F56033,119,137,18,0.2605890342736178,PASS
B764E3F69BD87E02F7AACFE9E97732320374BF3E6DFE9C7662498E431E962085,117,139,22,0.16913144470267139,PASS
2F334481986819BBD9EF08830780C569F3DA46F0DCDFBF50A6A06B626988C11,137,119,18,0.2605890342736178,PASS
4E560908E264AD1F9155599C2F3B946DC02CFF7114E8BA756F6A42515FC9C3FD,126,130,4,0.8025873486341526,PASS
9C049DE422C3AF48FFC661BA2D9E0195EE39AF055E66F2AFE23F815381BC6FBE,121,135,14,0.38157390570502125,PASS
B5BE0C31DC55C73E1E55740782B9D7C69A7F6DB0B49E181C3761874F8BC0429B,126,130,4,0.8025873486341526,PASS
BE4A7A40AA86CAD4482D6C22ECCBD9E22CB26C1405FA16CBD5DC029A8934DEC5,135,121,14,0.38157390570502125,PASS
BEC97C4379DC8AEBA9D2AC4F5E26DA7DBB03511958D403E1A9A9F46819065677,125,131,6,0.7076604666545525,PASS
12B3B563B503E3E95A97C73FBC03B8FEF781854BA6F7C9E103C229520793B0FF,121,135,14,0.38157390570502125,PASS
C05BD37A00E9FF9A628A55E0381826E771BE55BC113EE98ACED64D80907F1383,131,125,6,0.7076604666545525,PASS
93F35565ED565F3A693D969C177BA6982471E22380617E3E28BE5D9FC854D4BD,121,135,14,0.38157390570502125,PASS
5423E2C3856FBE48F1AA8B88DB4A23345EC9C5288A4BD717E192C5C7B0673132,133,123,10,0.5319710580974012,PASS
86A52F72CD9A3920E1BA99A33D06DD4DCB7CF8AFC9DEA847074BD13E95A95F0D,121,135,14,0.38157390570502125,PASS
4CA179CB675B2D276DF517DF31FE464B3171B4F3B2E204EF3B0F62BD52E656E8,116,140,24,0.13361440253771617,PASS
A8B16F5C02E881F8C80F60B9E6792273591AADC4B32AF5B85E59404E3BF36199,131,125,6,0.7076604666545525,PASS
A28194DA250175E072E1C65168EEAC78A0EBD82A8FD4370FCD981F971CA6FF28,131,125,6,0.7076604666545525,PASS
CD314B4F2266162070D207A3E0F39B8179DD076D1023AFD9FC95739E583FDA11,129,127,2,0.9005235503397743,PASS
931A63177FBCBAAD2886035B157C888884D844B974025ABAF68899F0B7F98205,136,120,16,0.31731050786291404,PASS
2AB74F0F98A1F7803079E4042581BABA330557E789092A272D134AECA7091BF8,137,119,18,0.2605890342736178,PASS
6C1D0246BEC197CF52E133FAFCA08F30C31AFD546DF68AF014134C0E7A0EF41,132,124,8,0.6170750774519738,PASS
7812B199CA4A7C9308AD73A8FF2444176ED9C441F1973D520C32E672B47B387F,129,127,2,0.9005235503397743,PASS
5DDC29D60ED93B1CD110D6E0FD95E70F804A384AFCB84D1AA99F915C3308CEE6,129,127,2,0.9005235503397743,PASS
C666A0AA30752C4E20A765D663BE002C09DB8B82045CB531A8738B420DFCCD78,141,115,26,0.10416255883043901,PASS
6227933893ACAABFD8D8D2FDE89FD7F35451D3F8B137D7DAB4EBBD077E3564C4,111,145,34,0.03358661289689768,PASS
EE7545FA81A1A99954EACBF80A7E8A59F246D9E9F55ED1BE600D172A129865DA,125,131,6,0.7076604666545525,PASS
CA0A4E33C384DB58D2D22A3C91BA04A63A88100615A8BA231E1B646668966780,148,108,40,0.0124193306515523,PASS
A9FD8ABC9F5053FC34A978263F2B5604226EE4901FDC1E8663A8C77458F54FF9,124,132,8,0.6170750774519738,PASS
83D6E8919935C51DADF10834E66DE614BF1A5553627604FE7F2FF5638D9033D1,124,132,8,0.6170750774519738,PASS
ADF98044F9CB81C229E7C04ACFDD97939F338FFC5B4C754BB2F5DAEB1D67556E,114,142,28,0.08011831372763423,PASS
F3B21426F6FF59291F1EC483A140F566C2D6E3116ACA01A439F4179F86921761,132,124,8,0.6170750774519738,PASS
3797042343B88A68FF2E9FD466E54D66811FD6726586CD6F8C18EC555EF2F47D,121,135,14,0.38157390570502125,PASS
EB897FEF3DD475362C9AD64599915F2486CEEB594CA2E7F5E4D6EBC43994C698,117,139,22,0.16913144470267139,PASS
DC3E35F132A8FF562C253BF261A31B68B76028F581196735DE90C9278E43FE7D,123,133,10,0.5319710580974012,PASS
30EA3B94D42E23B2F91BE9F631FEA5672889D7D226E8D87035B0D8D142D41472,130,126,4,0.8025873486341526,PASS
BD0940EC28A04C0096B142E3339997B495CB9F3EF694980DAB2B351C651E682A,138,118,20,0.2112995473337106,PASS
510D92BD1B14EB1600A1C08F766C9745160B903DC2F177CC20598C62C97241AB,142,114,28,0.08011831372763423,PASS
87B4127569866C989A806490666AE616ACA98CAF6BED19BB5793688A3DFF2107,131,125,6,0.7076604666545525,PASS
1DDC2B3F6AE99745A9154EFE545DDFE3BB24C995C367EBC3A193EBF6A3768967,111,145,34,0.03358661289689768,PASS
FF8918DF3585BF505C262B73F7134FE6176E4CDAFD008BAE547A86A82791B46A,122,134,12,0.4532547047537365,PASS
119D11BF3D9068DB5877A71A9A573B48BD5A11EFE3EE4582F7C641A3F5828AF9,122,134,12,0.4532547047537365,PASS
49A6B4A03FDA1699E87A778C171D1A37D3027721637332B1116CC07D908E23F1,133,123,10,0.5319710580974012,PASS
75B4123BBB7F55CA68183B6A3C2C63FE1D9905E365494A4F95ACF586B1966537,123,133,10,0.5319710580974012,PASS
1F79791AFF0507B106FBADCB9ABB0916FB1222B6D1C4843BB0F38AB4149FCF42,125,131,6,0.7076604666545525,PASS
BCC4D15F4D89676A17A158CC71A4E3D986AC5A13CEBF945A73F0F4F573E22F23,121,135,14,0.38157390570502125,PASS
D9F354F4943B32D0FF24D08EF241340711C2B4E063ADEB4E5D401DC8F9BE0F8A,130,126,4,0.8025873486341526,PASS
7DF8BECE34C77804B3C361FBF3165574F7DFD8210C09D774F4FF497B7B300DD,115,141,26,0.10416255883043901,PASS
7085EB88A5DB11641176F1DD20DB1A4285E21BB22764E7915DF093A849A62892,138,118,20,0.2112995473337106,PASS
90C837BD85D18A546BF1C4F0E473056E67CA37DDB1CE16D5D8E82B015F80B9CA,128,128,0,1.0,PASS
8775E02A239777C8008AF7D3DB913F87572110B896CB4EF93C24C868F22EA076,131,125,6,0.7076604666545525,PASS
9D686FCC6568D731132AA6B484638BF2F119813ADE01BEFED45B1F8A0F0989EC,128,128,0,1.0,PASS
9BD404CF652D8BAC062F314725337A3B5D19F6E419A2D7CF72FF92D776823949,122,134,12,0.4532547047537365,PASS
BEC387CC8D8F43AEF28ACA5FA05D9E6FCA16A20EB193498787ECFC8A9914DDED,121,135,14,0.38157390570502125,PASS
9536EB20870F514143A737377EBBC3779F631F729DCB2FD05CC33D8A2B5A7321,120,136,16,0.31731050786291404,PASS
698C199CA0B89AF08FC4DB43CF7568B2768E50CB8BBB5813270E459C97E7D859,128,128,0,1.0,PASS
A6AD0ED361DCE4E6E160FFC9051BFF37F5A11E58693619E93E42E6F44100FD2E,123,133,10,0.5319710580974012,PASS
EE5B91A63A84275C3EC76D89DFE0C9AAFC072E077BC92527BA100E64EF86287B,125,131,6,0.7076604666545525,PASS
EE432921070171A131690711CF489ACA35BA18B1BE7A249CE9FED73CFCE839C6,131,125,6,0.7076604666545525,PASS
3640632C1F89D6EEF4D42C4B8E39A6B15C5DB9AD64E1C6C723C6400A420C796,137,119,18,0.2605890342736178,PASS
A4FF5EFE74924480D8A0F4A09A364BE56F66B538C9B856415B3DB010B958853E,131,125,6,0.7076604666545525,PASS
298552D530AF12F23F7E35D9567E81B7064DCDE1208660B21A1DB00B58AA5E7,135,121,14,0.38157390570502125,PASS
89F42D29ECC5FFF60ABC3F032298E069EB6FA3DA7FE68CEC00CCB74F56B51ED7,116,140,24,0.13361440253771617,PASS
6496EBD8BB4357877CF90FF4D9CD8675B59ADC19159A602FEAD9FC29B0C0728D,120,136,16,0.31731050786291404,PASS
E9A6F4B6E044929971C8CC2978AED0E04B4CC1F3A1F1FF12D2AFA0B681694111,135,121,14,0.38157390570502125,PASS
DB88202AB76E292C74FE782ECFDE8A3642ECB6A290670DE1B5223FC9AD1B2C3B,126,130,4,0.8025873486341526,PASS
E429EAC8DA9CBB6524BAC5ED2F8D8F082E49683C93E00804CD87A9A4D6ECFF13,130,126,4,0.8025873486341526,PASS
20A6AC1E60ED5F6B4996F8568DCB08D235778D136112F95B24C6A988ADBB5E7C,128,128,0,1.0,PASS
E3703E38B8A5CA59F10C3E7B276F3738942F467C3C5BA2AC3481B8F21900BCF,130,126,4,0.8025873486341526,PASS
275E35FF3DFC9903ABA552B093D0194626212E84A348E565D0330D912383D239,137,119,18,0.2605890342736178,PASS
4857394F2F1FFC527D9CB84809180CEEB3B9D4EE6F5822B318C395B024A319E2,131,125,6,0.7076604666545525,PASS
11AAAE76297B1D4F2DEDBC426BBFCCB78F956E2B58DFA1AF9777229D07D3E45E,111,145,34,0.03358661289689768,PASS
2B2BF2D753CF5C92DCDC032B4414380DAB7A8F04754D6C61FE7BECCC64C43B7F,122,134,12,0.4532547047537365,PASS
25DDE57FD65ED3C87EBCB322562EEA4B4EEBFFE3FA41371DB76DBCCFC5E51165,105,151,46,0.0040402749798920095,FAIL
16A82A522AC526B777F1FBA25B1F7E627DC1F917C92C07188CA0AC5264D7A8E2,129,127,2,0.9005235503397743,PASS
61FB0B52AAABEC5B1B68D9C9D87E85F7DC0FB88C90F552287DCE3BA2FAD6DCD0,118,138,20,0.2112995473337106,PASS
9D393B0F0642EFA49DA16355EA23B7695CC4D59531A4089EDF4B02D65F0601EC,131,125,6,0.7076604666545525,PASS
FBA17E5E40966A0AA6ADC49A020D52B7D39E5BDB3545DF7F17A1689552FFF920,121,135,14,0.38157390570502125,PASS
C7905DBDB97CE6E21ECEF3BFC24BC83CC44F178C3E71103F4AA567312294659A,124,132,8,0.6170750774519738,PASS
6D2278775E3E412EEFDE7B80AA4A1CE95419C44AA86A92CF0C35EED33564DD84,128,128,0,1.0,PASS
8A359DD81EB8F7D7716B93BD662514C7C3CFE0CA6BB003DC2D9D76C29E70E808,124,132,8,0.6170750774519738,PASS
39F6E34A44E4690586719E7355F152C95CC60C8726D5CBEE58174067022F1EDD,131,125,6,0.7076604666545525,PASS
B1CAC15B013FE235116E9C6C3B68BCAD641336A6C1E4AF92B0A6C52522C49DCA,134,122,12,0.4532547047537365,PASS
FC62B55997F285ED871C42D9D0B189FAE5B0BFB4D759DDA41BE62720FCB6BB2C,117,139,22,0.16913144470267139,PASS
143B13E853CD8743A227487F97636DA385B2089FB28242D9CAD39DA10953387E,133,123,10,0.5319710580974012,PASS
E203A492F6CE95C396A0647CBF1BC64F1B166B09D130F368A5CB97F3FA4B271F,123,133,10,0.5319710580974012,PASS
F92F6983825EBAF153CB4AB40D0339C9AFECE48932A5CD4F357ACA29BA5E65BD,121,135,14,0.38157390570502125,PASS
4EA08A1BED5FD14CED88E8FF6AE248A1BB15C40806A085B9603C0CC98212C5A2,143,113,30,0.060792723530522785,PASS
3D67D098CADBB3514501797C918B75318780D1E302DC6B3D4F8FF53075BE53FF,122,134,12,0.4532547047537365,PASS
BCB275618DBD8314E83B598970C91D1A7073F20337D6747F032C821E6915169F,131,125,6,0.7076604666545525,PASS
B87923BB02B8DA9DD9406257FAC818E7067EE5BDB149D6FF568C4710834455F,128,128,0,1.0,PASS
11C029E34F6C6AB7477F2AB24405646892BFFB08BAB5DA6B64CDF8EE092E5258,128,128,0,1.0,PASS
EAA889D3E113D8D0FA13617DB276E7A29F57499FE510CBF575AD55589406D5A1,123,133,10,0.5319710580974012,PASS
F4F1B35BCFD105E831F0A458D15C6C72C185CA65E57453B77555CE3559B34DDB,121,135,14,0.38157390570502125,PASS
98FDD61F680291E3DF7C87BEB53D163BCDCD14DB86B0CC09D76097245E4EF038,123,133,10,0.5319710580974012,PASS
CF41F81F44EE61053A851AA4F35C6E28173AA3A986B9F4A26710CBE150BDF6D5,129,127,2,0.9005235503397743,PASS
EEC7AD1876B10018C0418BA6E75D6A7EE4F0822A5401C88885DF198297A8CFBD,137,119,18,0.2605890342736178,PASS
133DA8222DF335BAD6B6D37727BD71C7537A47A91F0734523A1BAFB6168E33C5,119,137,18,0.2605890342736178,PASS
713A98BD0798E48AB073051540FD1E09266BFFEFB24DD607096C458AF0148CA6,135,121,14,0.38157390570502125,PASS
D0310ADC0B124177B81E0278DB48694DCACB111899EF75F16B3BDBB9F3F9F22D,125,131,6,0.7076604666545525,PASS
91688889E8E065E744D6CFAFEECB5AC554DF31834059CCC070613F574CEB4F2C,129,127,2,0.9005235503397743,PASS
5564999CEA63D86471766EDC52D99102A3F29B5BEF6E6F6D08145A49F68B6A55,124,132,8,0.6170750774519738,PASS
81CFF2326697CC5A9F065B898F5DBC2FAE4F4B661CE0A0A55AD753A0D1B505D6,125,131,6,0.7076604666545525,PASS
5B087FCA88694C64DB34F3E00C0FA404C2F6B34A0FC89069816990A4A3C481B3,144,112,32,0.04550026389635853,PASS
B299510CC366B72C1B2FFB0AB70ED38790035A6375D9ED15AC69384CF770C246,129,127,2,0.9005235503397743,PASS
39370EE5AA358DE56110606D6D28DF0C2F4C4C23E90E1B803A6A4272B14193AD,139,117,22,0.16913144470267139,PASS
ABC7BF61FFFD69BA482E801075D62B0FC7DAAC5DDFE5186B6F81BA7BCF4DFAED,107,149,42,0.008664896726025117,FAIL
60BDCE3FD82116C9964CCE001C2DFF8CDC9E29BFAAC0E31472AE512F190E634D,130,126,4,0.8025873486341526,PASS
A454E51C04E9200EFD424BDBA7B2A1E4548C97A51A3C8B0A2C8E889C27B59215,141,115,26,0.10416255883043901,PASS
ECB0733EE8DB937B5707873EF6E0C4D0F6E1B97CE338AF480B965CF69B9C590C,118,138,20,0.2112995473337106,PASS
C4D11EC5674647294E19771E3E8AF4D6D9256768E919C86D900D6C3EEF51E123,128,128,0,1.0,PASS
40F43126A781369862A277E00D223853A51A3FED7D59FF0C0D1F64CEE253864D,133,123,10,0.5319710580974012,PASS
F277E15CE2004F87DB446E41396356129452261679660BF6111011C50A24BAE5,142,114,28,0.08011831372763423,PASS
90612086C2C5D0D594E3496D173A6AA4CF73413732DC79C7DA16AFB62F2FA2AC,129,127,2,0.9005235503397743,PASS
F778A4590D6CCC27D9AFCBE7E72D22EA9720B46E64BB5B9DFE903D2471641ABE,118,138,20,0.2112995473337106,PASS
8E294B199653EA85D12AA2355BB73AF464E566E18664533087169E875B51A13C,133,123,10,0.5319710580974012,PASS
3E9E0F92F28DC23BC999CAABB38971667DFF228D06F05F2070DB3B8065FFCDAE,119,137,18,0.2605890342736178,PASS
EF1550CB5B0C957CA80363D2D613019D73D8C5EAD6482ACB10FDC30E5DAAB5A3,130,126,4,0.8025873486341526,PASS
3F0BDA20D3C76923FD83C7F4208BC10C3F7AD28F312DCD186A0EB6E287E4EC97,126,130,4,0.8025873486341526,PASS
E191B25D5EF3107D389C29EBFE3AF7AB7FF0D3959F6F56D6FCB38AD950D42FB0,109,147,38,0.01754895019147673,PASS
9ACB99044B16411121DB4F729F416200B1B3D775692F87FE4FAD8DBF66B9D543,125,131,6,0.7076604666545525,PASS
C3F5CA658D3FF7296F0263E9507935A3E5E6A668EC3280F9153068E051D6FCF4,125,131,6,0.7076604666545525,PASS
F0ACAB348BB6445D5D9AD232154AF1AD0AB5CB5DFF168EEF6C6391900A2B90A8,129,127,2,0.9005235503397743,PASS
C66D201F7369E4A19F70EE42856E6C97BDB83BB446EF276982CFF5A1BCB254D4,121,135,14,0.38157390570502125,PASS
13D4735FA360BC3A38E7A61FBE5E1BC2FBA42F34ED34A0D3F7F1C2AB79E69B89,115,141,26,0.10416255883043901,PASS
3DEDB3BE6CFDA1AAFFA6B53715E6AF91C7C83871B4D8CEAA9AA4324B0E30470D,119,137,18,0.2605890342736178,PASS
1540FE3C4DDCD443E08987D4E743EABC32C8236885276764858528E08D46B6F6,136,120,16,0.31731050786291404,PASS
95456256B0FCF407FBC97F17FF0D4C45B93778D98C15DB6AC488601C2E4D54DF,123,133,10,0.5319710580974012,PASS
7A585EA568BB685E6A05766D97B16D4FCA01118C15EB4DCD4D60AF2392DF723A,126,130,4,0.8025873486341526,PASS
37A9F84C90BEF3F94C80C92CF87B05A3A38D635B3326C94AA8DEECD7F27C842,127,129,2,0.9005235503397743,PASS
38C5E32744C9A5F418DDE7A7E90C304F4CA5DDD2B9C860174B675D2AF11C4EB4,128,128,0,1.0,PASS
8913DE5192B92E35927522803FFE2DA6AA18F15AA0919BD30DC53E7052979BDD,129,127,2,0.9005235503397743,PASS
BD17B24818C677B4BBCFD5AE47604B1EFAC67FD1094498E28E8B653A463DD373,122,134,12,0.4532547047537365,PASS
EF87F7BE4FB40ACA23976256D4D436FDA7572E7995054792586EFFF2315A9BBF,111,145,34,0.03358661289689768,PASS
A552F646424C40D2FCCB656469D053310A08D2E212E0CD53DFB82FEC798FB3B5,132,124,8,0.6170750774519738,PASS
5F0C4C10792201E84AF6EB8642DAE037591B35AF897D300244FE8A94F8B4873E,136,120,16,0.31731050786291404,PASS
,256,0,256,1.2777508801076536e-57,FAIL
,256,0,256,1.2777508801076536e-57,FAIL
,256,0,256,1.2777508801076536e-57,FAIL
,256,0,256,1.2777508801076536e-57,FAIL
94DD6FD96F4105E26C4BA9D6A0FC4A6E4F414260F7119DAE975203F7AFEA8D5A,123,133,10,0.5319710580974012,PASS
6D57DAE1911E8F7FB1912668DEE61E9A24AB2BCFA9D5C5A5872BBD7C8D7F8E0B,115,141,26,0.10416255883043901,PASS
7234704213FC0C826297C9DDB8D37A57540B073943DAA98B128370467226B202,142,114,28,0.08011831372763423,PASS
9D81CA639C877CFF029A6C4B7D4CF3AC93D723A045E9A652CFC98E461D127542,128,128,0,1.0,PASS
4F3838175389C0F551D10A4BAE1E22DDCB5381CCE6EBDCAAEE39AFAE1D69F63D,121,135,14,0.38157390570502125,PASS
B812C1162215A1DD9C7C11B79B444525987BC596F9D4923EA924D992BE938254,136,120,16,0.31731050786291404,PASS
C58982A16743411112A9B5124B2791920415E43698E7E31AB9941FFAC085F67A,141,115,26,0.10416255883043901,PASS
D11D33AB0D5E4922CBA4C98DB197CC82D7D1AE63973C52B2708911F51921E9BF,129,127,2,0.9005235503397743,PASS
DE73E92F8F9C22C3681414FEEA1E9B602571BB208045A2007392063D0776C817,139,117,22,0.16913144470267139,PASS
BE156CD715EC3BD4A0A9A506E02583E5C7358533BE09881C454F06CAE60B196E,135,121,14,0.38157390570502125,PASS
A6F099DC183D204C1705D170E29B0E03E1C1050F2C752C19BE19643E53A185DA,142,114,28,0.08011831372763423,PASS
E8F4B0B9683A9D0716DB377C569F70917E65D4FD022C055CE49561F61E0A0F77,125,131,6,0.7076604666545525,PASS
86A98BE6760F5B1B7A5D2A92CFE6836C001D629CF65B15878BBA0185E05C88F4,132,124,8,0.6170750774519738,PASS
1E44F0A2B24AF5D3937CB0FAF93D226CBCC8A26523DA85EB746FB5D4AAEEC046,124,132,8,0.6170750774519738,PASS
6E2D43DFA341A107E39675927570F0701C2DB1BCB34A847D8312ADD42EDD6B32,129,127,2,0.9005235503397743,PASS
446432C32EC3F8C9C2FD24D59E92DC4B41BB4CBBA82A32CFF3EDBE9B13CF50DA,122,134,12,0.4532547047537365,PASS
31E27FE363E671588002862C5E18767A65D5DEEC2972F81A8F643DBA6A8911B2,130,126,4,0.8025873486341526,PASS
D8FF21EF336DEB667BAA0BCC0805BF011756754BC2521C9A3C8E3E2C54C4B3ED,125,131,6,0.7076604666545525,PASS
B133C6D526002F2F70E96495CBAF845C435396E133C90F1CC712428784464E1C,139,117,22,0.16913144470267139,PASS
ED43AC2BF06C445537F1A04C9B9D34E707B433DD2A23AF1C098BFD43AF670AF1,125,131,6,0.7076604666545525,PASS
222B719D0A35CDFFCE29AA480B0BCB716FB3AC733047147442C5B34BC72860C1,134,122,12,0.4532547047537365,PASS
A2143C3827E6C09E9471F7CEF08DB09CC8D5D61CEDE02B5C35E663E9CAED5B6A,124,132,8,0.6170750774519738,PASS
A58188101A9A16D9EFC65FE4530C6542E42621DA7C88B772550D88BF117D188E,138,118,20,0.2112995473337106,PASS
C7EB5108A5E2F8BACF41B69F9FBD09C129456E31C366CAE65605D92535B6B394,125,131,6,0.7076604666545525,PASS
DAFC7888AEA6BBBDC4B4FB9A6BF7C48382775FD2BAA1DC20024CDDD5A195D7ED,116,140,24,0.13361440253771617,PASS
62F6F63281529F142C905C3C769152A7D281A1902F460C93D1C9D0A1E66B07B1,140,116,24,0.13361440253771617,PASS
AEE919F8DF727904D9FE7A3D22CA5E5FC3AE2E7B8FDFE64CB04C7F21E32E4528,114,142,28,0.08011831372763423,PASS
8EC0B7A5BD642EA2C3D220301382D2B784549A7F1DBF46B72C20E06505AAA4D7,136,120,16,0.31731050786291404,PASS
3F456C1B140085939108D16C146D3C0C3DBFA3969C2DDD546C2BF7E7C8E93633,131,125,6,0.7076604666545525,PASS
4565B3EF271DC7EE066BFC651CC2A5940DBF914E38C8EE3275DA1618276E4BE2,124,132,8,0.6170750774519738,PASS
B2CAE724B498031120A77121F4869A614F247A42CFF68C9AB1F384B8E1288BCA,139,117,22,0.16913144470267139,PASS
8C36B070A08EAD8BF2A9F3C0652748D67C19BDC3761C6F672C30F5361532FE14,129,127,2,0.9005235503397743,PASS
539DC721E307696FFF3C5537C466800F2F7F04DF02DEEFDD0800CFA6EB3EE332,119,137,18,0.2605890342736178,PASS
CFC9CC52A56FAC1EEBB8FAAD406684BBFE4533FE41140F0A21BCC57F1DC22E51,124,132,8,0.6170750774519738,PASS
4798B275E74514ED119E6AFEE281FA97FB35C92989886EDD2336D28A33CCFEFC,119,137,18,0.2605890342736178,PASS
F2D854D3AF2992C261B0F375D34F0F1EC1D1FB45FE4C32DD226D5F332ED1FAB,119,137,18,0.2605890342736178,PASS
207B8B2E21F30A90E4B024BC0660300B134FD5DFE13A142D860B14D08CB2E947,145,111,34,0.03358661289689768,PASS
77500B6866772647E24B2CC5E7B23476A0F94314D173E59711DDAB54F217CB2E,126,130,4,0.8025873486341526,PASS
BE87159B5244D4D202E142A9D9C935BB8BD3BFF9F878DDC37C8E93D7988CA935,121,135,14,0.38157390570502125,PASS
CEB1085B34FDC9F8365645B01E14D584BF5DBA58462DC4BCCA831FA7C9F3C1A7,125,131,6,0.7076604666545525,PASS
16BDE6F2EF3E0D6CDA9BE04F26DB8607C57CE4BE80B5E89AAC2AAE2B26F79B69,117,139,22,0.16913144470267139,PASS
F2756A9277DF28ACE015847D7BFF774E2C88A93A2CEBE0365511A6F97DC7F45A,117,139,22,0.16913144470267139,PASS
86EE93063023D7624850C25619A8E8F71A0792BC69EBBDF8CC8390CC003FED76,134,122,12,0.4532547047537365,PASS
F2B98DCE0D2E1B794785746B2038FF937D9B8284184F99B97A7659D6AB13F4B0,123,133,10,0.5319710580974012,PASS
7F6148CA355B46C9709A857E5EBE2B060231D2E4DA3738EE0212009278DEEF14,135,121,14,0.38157390570502125,PASS
BE71B113B6592A6E4050BDF09987B26D1E3DA1EB4D830CBE426AF04A56148C4B,133,123,10,0.5319710580974012,PASS
625F3F0F2FD4CFC7B2F5967D315052179E640D43E798E6A88B211C6A5AEC918,128,128,0,1.0,PASS
845F06BBC4297069675A05E1ABF694A25425D3C9452C3DEB5D3123C1D012BE3E,133,123,10,0.5319710580974012,PASS
9E134564FC96423117A4E6DA0D47CDE38189AFE29E73B3B69749DF58BE4922C7,124,132,8,0.6170750774519738,PASS
D36866E9BFD06033652973A026F48492D250EBED6ABDD6FB1D925D9828582300,133,123,10,0.5319710580974012,PASS
80775C5F3AEA9E74716CBAB6387920556DAA06A085D9FDD9F3284D662BB4F4D9,123,133,10,0.5319710580974012,PASS
758371A07711548DD183D1B6B34F8CD93436C1D44DC715FF0AE31923A0153F68,132,124,8,0.6170750774519738,PASS
2B2753AF48A5383117B57334BFCCE6CC2AE5DB602DFBCABD8693479052E75F79,119,137,18,0.2605890342736178,PASS
4170D59F93F7485EC5EDD99BA4CC366E870CA3A9F8F6C59112AB2A9B333661C7,123,133,10,0.5319710580974012,PASS
BEFC2EEB01A2BC924F4610E5BF461619506E27875EAB5148BFE4C3B8E868E8C8,129,127,2,0.9005235503397743,PASS
BE62B49DB9F6D0021D2EC29D953E208F439498415CE97FAE05030ACE9CB0C344,136,120,16,0.31731050786291404,PASS
F20982662718256F81806C548F5DF5A5C4ECD0E90D682B6204C1E9A2FD648B0D,140,116,24,0.13361440253771617,PASS
52A6A59BCBDA4DFBA86011E00A4A1A1B148CD0F0AA7AD03ABC0EF8D996EC8424,138,118,20,0.2112995473337106,PASS
558E7CE86877C2A3393B76B339C9E3477311E13C50D30379501499545B0F0EE7,129,127,2,0.9005235503397743,PASS
139B0A4B4B9094A6BECAA386A3796EAAE3B3E529EEBCEAEDA8C60958FAB7664F,121,135,14,0.38157390570502125,PASS
438D539E720C2FD9A08CC9B140C87F4C66AF249610A16306C45789D7BF5BDF08,134,122,12,0.4532547047537365,PASS
F98419DCEF4AFDEA13FACB0EC8ADEE3924E8B0B48B4B6EACC5443B34549CD6AD,122,134,12,0.4532547047537365,PASS
3879863A8D211CA484390826634440F3D9D46C0835B401DD51189CEFAF3439EB,142,114,28,0.08011831372763423,PASS
291D234659E0632A15197A4C18EF77F10DCE72DFF950677ADB8DF16EF82F5BC1,120,136,16,0.31731050786291404,PASS
A779B0BE3C0F6966EAAFC7D6171D0DD076256371A116751E6414C207A4FAC372,127,129,2,0.9005235503397743,PASS
1F22CFCA1D5718E3C5BC296CBF7137293EF0493781A9DE9F2D3B8BDEBB70FB09,116,140,24,0.13361440253771617,PASS
F7AAB7FC3CD81C8FD6FA5B5E101EDA9638D50143C837423FC0E869A8E979E60,126,130,4,0.8025873486341526,PASS
C3F86A51CAE0D88BCA34BC3A7051C048EF1F3E54B1F5F87E887B1DE88F36EFCA,122,134,12,0.4532547047537365,PASS
73B24CB9BFC8EEFB4025BA1A87B7343C5BE1DD76C817364AF07566865CBD44B6,120,136,16,0.31731050786291404,PASS
43FD92AA3096B360F71F5E8EDE77988B25BA233465778B4683C1687542E548D8,128,128,0,1.0,PASS
EB35EA40A50975C6EEE7E2876C5D9BAFEF4CF223D7E322920F192C575F3558B1,119,137,18,0.2605890342736178,PASS
1711D697F0A1B8A0A2853720D19BD8588E5C7DD8A440530B4590F79782BCF5AE,135,121,14,0.38157390570502125,PASS
86C9EE979FD021655AFAD5CCEE7EC01EDE5173E8973AAA01D88F3684428ADBF5,122,134,12,0.4532547047537365,PASS
AC4D50F86AF4262F4DB1DFD4C70C4B54828C15147C3D8BCDEF4EBE113971DEDB,123,133,10,0.5319710580974012,PASS
723F8DBD667E5F7AA389B1F54182ED0F0D34B5CF91869A3CB8B3E5B79BCEBDA0,115,141,26,0.10416255883043901,PASS
6E2E3A8A2CB66F5B412B037CE176D33387DDF633117795424DB7BF42B9140680,127,129,2,0.9005235503397743,PASS
57A7666F03F2ABA84A5E39C0B079F5D0F8C7CA648508F3471AFC7E9A6FF8ED94,120,136,16,0.31731050786291404,PASS
5A84B7CBA430F8E6A989E97831437980F7CB4395C5ABCC233E330ABB34C48B20,133,123,10,0.5319710580974012,PASS
E374865CB7152DC58C8D9420669FD2C2B43BD191BF836363859FC4BA1F1AFA1A,127,129,2,0.9005235503397743,PASS
C03F6146A39B203358358F4548B953AA22B7C3043C158F9CE573BE347A3398BD,132,124,8,0.6170750774519738,PASS
DA6B7C371FC298579218A20C3EC56321FCE319220A0AC67D83C264CA298ED9C7,135,121,14,0.38157390570502125,PASS
4950591A7B23E3568B6AF6CBEE24C87D822DB3A5267B32827678415E33B125A3,130,126,4,0.8025873486341526,PASS
B24C81BBFABBD39CF05AFF16AFD95006975B72510F16A8EB2C0AC83B994C7E19,124,132,8,0.6170750774519738,PASS
F543C15D2ECF38D015416B3C64B74CF283753E54E55A0BF3693B372046866B09,130,126,4,0.8025873486341526,PASS
71916D890FEFA7DD8B29AB47826776DD25BE502819A2EC921D4578E7A663995E,124,132,8,0.6170750774519738,PASS
4CB2BB14988E3FA3CD17B33BDDB5F04FB521F88F326547E204B406C5D67B8460,127,129,2,0.9005235503397743,PASS
C3873668B71C839AC12BE7BC8B92779C87CE028EB3F7C1F1A07F0EBBF21043AC,125,131,6,0.7076604666545525,PASS
19500DA269323DA650303C522C03F2C4F49A95C3B401797E9C1B563943EAA8D8,141,115,26,0.10416255883043901,PASS
CAB76D2322D8F5D854CAD00AAEAA7A73001D1996DC7FFFDDEB919A341B631A14,125,131,6,0.7076604666545525,PASS
D8A8CBA5808367CE8C45FAE05A1E8B368C3C51183A8084A7C59FF6CB210D03B7,137,119,18,0.2605890342736178,PASS
DD1A6E9B14DF53D160CDCE268F4E368A7AA8C543D67729E3C5093572C7583FD1,123,133,10,0.5319710580974012,PASS
67F71DA9DB5AE58DB9FBEACFBB6F0EB955F51ED0460459F160523ACBF66D7681,112,144,32,0.04550026389635853,PASS
1D4F1A98DA2438BB96400406B1B04B8AA4F4D9138F0E320DAF0D4118239689C6,146,110,36,0.024448945310089426,PASS
9C0E10D31CE64F56C415C2A1DEBEFEF8393D3FD912AAC8FCEC999D4920F1005F,126,130,4,0.8025873486341526,PASS
3000ABBC28D59F76D397CFA7DE2378EBB96F8F4C313434BF95295E57C290AB8A,121,135,14,0.38157390570502125,PASS
14146452339C9A31C566CA70892024BCF16D42548997D56129AC750502F212,152,104,48,0.0026997960632601987,FAIL
4185EF450E79083DEC69648FA87019A65C6DDB696560B63C0CD4EB9FD7E7CD90,126,130,4,0.8025873486341526,PASS
F372AE522264769CDF6B1DC74D5AA547C207AA8E371860F4FF358B21D7BE2A3B,121,135,14,0.38157390570502125,PASS
A9DA3747ABA53BABD2613304CADA91361E5BCFE6083F5E112A9029683D9D9AD6,127,129,2,0.9005235503397743,PASS
CE703B2B89FFA5436E4B582D46E83F605117187DBEA02C96342AF4D8CB19D5B4,128,128,0,1.0,PASS
43DFF95AB36E2BE289167EF4064F184ABAC57C53AB10936CFAEFEAF21BD627E9,116,140,24,0.13361440253771617,PASS
5E183C218CF66F2473787A30B205D70E7C881519ACC9C6F6BE1A6157B7F2DCD3,126,130,4,0.8025873486341526,PASS
F34A7C49367B56D9615DBD3FCF935154F7648EE7F9C4B99B49C2E932B175A29C,115,141,26,0.10416255883043901,PASS
C6E938D6139320423143953E4228A05EB6FB4CAF9716AE1E87841CDB22DBEF94,132,124,8,0.6170750774519738,PASS
F876A2ABEDEFECA2179E01A8A94A8CF149084F762CA4336E3EF8915A408EF3,132,124,8,0.6170750774519738,PASS
7BCE403F252B958BADE58AEB8DA5BBFB4389D826A50723751C77088C25D1E18E,127,129,2,0.9005235503397743,PASS
2A544A727292369A68D674A59465FC8DE14E5E0D847EC4C818440CA0BD206FCA,140,116,24,0.13361440253771617,PASS
F303C18C756676D972DA2BA8175609D76942B6B12EFB00CBFBD6807B80ADC113,129,127,2,0.9005235503397743,PASS
C980DC68C55A21D306984847ABA971A946B3314E02A2932419365D8B874297CE,143,113,30,0.060792723530522785,PASS
A9772B2ED169ECEECD953994FFB9C54463B81B05F36DAB11F8E4FF5088A36AC1,120,136,16,0.31731050786291404,PASS
D7E8501B1AB6A27DDF686CA73D77FDF45A6D046BAB72668C73919EFD02933F03,117,139,22,0.16913144470267139,PASS
F05F5B2FA7F1BEA343DB6047E49ECB64023D0DB1EBB88F0F1E31F4B921E2AD88,122,134,12,0.4532547047537365,PASS
5A78083D89CE8818C34A852A3D4FD928A1940EB28366BD7320B8FC23BB3DF80F,135,121,14,0.38157390570502125,PASS
E1CEF572BCA6FEAFDCC0EDA2AE9D5E7AB94D8F7F9BF2EAEBC4EBEF6E25278CC5,102,154,52,0.0011540500847815347,FAIL
2B352BDEF72F4DC9050A0BA9933C49C046A42021DED13892CF3AEA884FC90851,139,117,22,0.16913144470267139,PASS
3A37D1833738B6748E2F4417EC9EB1DBE627359D538971E67D17DD00ACA0EF5E,120,136,16,0.31731050786291404,PASS
2D8017926DBF87DF4B6156DF01E77454275CCDE1374A781AC7B8727588101635,129,127,2,0.9005235503397743,PASS
E7E4C6D37B6D088AC75CFB9EA567168F0338B341D4B23636D930CF1360612ACA,128,128,0,1.0,PASS
47F28A4C2A7EC8EBD764C8D0B3FE2E200865720893900EB62844BFB5B50394AB,136,120,16,0.31731050786291404,PASS
C031BB2B0C8A0EA1366B09CD6206915084B5F2AFC05205B402E7B5B4606699F7,142,114,28,0.08011831372763423,PASS
3A9022BD0B62BA053639C418B8E7D98842ED08D97FE874F978BCBEC342BAF4EE,127,129,2,0.9005235503397743,PASS
95E706E3E8D16894A5075422FEFD5B5D2FE83361CC0F46DD168F0F0293599964,128,128,0,1.0,PASS
DF46EBA07190A85686EC5221733CE7BAAF39BEB1A17FF2BB1D914C4FABE0E5A1,120,136,16,0.31731050786291404,PASS
759F21BC53E64518B5A744EA3376491C816477D332C7DE88048FB791C582FC87,129,127,2,0.9005235503397743,PASS
EC72C99A7DAAD2256A36D12D51C5A2EC1FA1A1E1CD9E93C9DACC92DB4B42ADDD,123,133,10,0.5319710580974012,PASS
5E91F5945016B939680CEFFBC1F5BD2E931D236E36EC5E1678449A65B5588079,126,130,4,0.8025873486341526,PASS
,256,0,256,1.2777508801076536e-57,FAIL
FC134EA2DF9DE5CA4541AB8B7F388A67A36D18DB54D191CEC3D7F14A51FBA5DC,118,138,20,0.2112995473337106,PASS
EEB750012E743D6AD661175C89CFF24D48EEE931B9D43B8FA8E69B79C08B6F59,121,135,14,0.38157390570502125,PASS
,256,0,256,1.2777508801076536e-57,FAIL
674CE7D285551DEC08021841C123ED5FC2D94FB3FF3B67E173AE0C2C81584C1,134,122,12,0.4532547047537365,PASS
DEAC0B9A4D96675F7C4628BD53113A702B6C0BF313E2A84B629270B9BE82019E,132,124,8,0.6170750774519738,PASS
,256,0,256,1.2777508801076536e-57,FAIL
9089DCB7ED526B322E595031281083E152FA13B997578FE27ADA3031A40FFBDD,129,127,2,0.9005235503397743,PASS
3249506BA80401CAE64A126BCDAD3D25FC66125914A25633085EC742F4EF67F1,137,119,18,0.2605890342736178,PASS
FF6A43344797507DCDC21680E7F5B8A2C5F6C37A94DEBDF64F324D13952FEB42,118,138,20,0.2112995473337106,PASS
9F2B6251CCF21B148E04E69C5B86913A6F483677D15089EAC59C55E2B9478DAA,131,125,6,0.7076604666545525,PASS
FD2BAB16D57BF141FD02F306ED4E3B255E47C61213EE7FB2776499C90A917443,121,135,14,0.38157390570502125,PASS
421D57B444FE3710BEBB0A0A0985353EF786B3FBAC1C555A7D3994DBE9ECAD47,121,135,14,0.38157390570502125,PASS
DCE940333F1E28173B1AB56AEA3262B0752B55B190AC54C623CEA6B0542E46E1,135,121,14,0.38157390570502125,PASS
79731D4A3E055ECEF8C4907B32892AE73E76E61D88EF957A3D3A10BDC3CFA61E,120,136,16,0.31731050786291404,PASS
B5FF6EACC03BFC5FF0D05A4BAD1E8034F1A91D691291A5B23B0A01496E73BE7D,124,132,8,0.6170750774519738,PASS
C2318E797EA17DB90D4A7C680984A7E57B6DBA51B20104A1C1EF34D98B35DCEA,129,127,2,0.9005235503397743,PASS
9CD258DD37AAC55CAA830F97DB5B5924394B532D028214AD26A3AEB36A5CDB7E,126,130,4,0.8025873486341526,PASS
45E65078074E5C8BCEC2DD3C871E5E02D8BD1EC56407153A5E36D5B6C6C71138,131,125,6,0.7076604666545525,PASS
A151CD74A05A9B4289E2736737D76D8ACCDE33433EEBC123BEA4156236BC4596,127,129,2,0.9005235503397743,PASS
5C68BF2135B9005575E0626F6AED08B4E85D688DDF0B5546FC7E03FBF355DA14,124,132,8,0.6170750774519738,PASS
2F098CA0F6DC22A8EC5D6F5E75007263F1A5CE5830D31313FCB9AB03F54BD908,130,126,4,0.8025873486341526,PASS
485E3E47CE7EB4BE7B4B9C0B8927D2AAADF87291A70A174FE3B039EEE0021591,126,130,4,0.8025873486341526,PASS
7F249BA49B6B63A86EB4EE1C187C751739CABA365562B57EA12E20991025243A,131,125,6,0.7076604666545525,PASS
DBA755B228D650956FDFF5EB12F286A4DE19614A62A70E27221CD391048B2ACD,130,126,4,0.8025873486341526,PASS
F2416A4BA75AD6A3AB99B207F338FFF4926BF364A79871051D128B05347D6F6B,122,134,12,0.4532547047537365,PASS
1FB17AD9972C431FF18FE1E9F72CF0720D6E2EBDA4E5D074369A13EB7C74F99E,114,142,28,0.08011831372763423,PASS
E3620E1BD0068A3FDA0237C1195E923B9547A96A93D3203208944559E5F826DA,139,117,22,0.16913144470267139,PASS
610095E469EA999CF641204BDC129AC85737FBD6A442FCB3BF0F6DFE442BE9A4,126,130,4,0.8025873486341526,PASS
582B33ABB29561E30417A47F4FE485D8D5D6F0DD2F75C587D1E9930E2457EFDB,119,137,18,0.2605890342736178,PASS
7B20306F6A17E769E4DE8ADE7DB942E359FB28AEDCCCCB90CD61FE79D86ABDB0,115,141,26,0.10416255883043901,PASS
4814827DA3051D23BEDD31374CAD1C579D52F87B7E3010777F27FAEBFAE40E59,121,135,14,0.38157390570502125,PASS
7FE6266E2D29FDF8F5BBCF16763C08AF32A009EFE03267D2B1B5DAC3C6A518CD,118,138,20,0.2112995473337106,PASS
606AF8E96AA86FBFF9C7AF05383A74394CED44EE91B98F09DCD60A81BE779A97,119,137,18,0.2605890342736178,PASS
CB6138DF512E0820AA7EF03CB9BCC48C9D8BDB706958D17E6A57010D94865D22,134,122,12,0.4532547047537365,PASS
9A145DB7B55A37C55A144A560BDEEB114BF3E28E3B045CDB6FCAC8FF9D18740D,122,134,12,0.4532547047537365,PASS
B36EDBA1F2C7F27227E8A3DD281B0C32FD34328C75C57F322ACFFD5130E43180,125,131,6,0.7076604666545525,PASS
DA613FE757943D750EC747B3BAFBD20ACA48B2E2E872EC46BFDF477C50505B72,117,139,22,0.16913144470267139,PASS
C4B6F17D0F3DF2C995C4B5536677C3C66A6D2FBE829733B9C896088996A7224D,123,133,10,0.5319710580974012,PASS
5BBA2B6DA4E9319D7019256205EFC4F0BD0BB777FF88AD4C791C9EEEEC017F37,117,139,22,0.16913144470267139,PASS
368A0CAAE7F1883751E4B51F10B26770DA67932C1D3F03AC8D0E3D40BFB62B6B,128,128,0,1.0,PASS
35EC873658516F9E1CB5379FD4A93E6AE07CF13EAAFCB02002BAAD291B90CE99,125,131,6,0.7076604666545525,PASS
E4952AC44738F5C1FD0250E6C626B37A20504682199DE2B9DC85CB56279944E1,138,118,20,0.2112995473337106,PASS
4D4696A3C5A0741BD4AAE2AFE8D247FE58C93EAD3997E3B006D9FF5EEEA1FEFC,114,142,28,0.08011831372763423,PASS
14CE8DEDFA4D0629312B3E28068756AEF9962173FDC6FC719676572E395986AD,123,133,10,0.5319710580974012,PASS
5694D60B90A86333894B0B2FA0BA2ABD9DA53B5847E339DF63DE10B6DB1F7B4B,123,133,10,0.5319710580974012,PASS
C2F907F7BABD189B267D1E780F96E0B74301D0596881BEDF4A07C854965C68CF,127,129,2,0.9005235503397743,PASS
F491A8AAF3D0E8BD0046E30163F8614160ECA00C756546966B3257A4E3403D29,142,114,28,0.08011831372763423,PASS
1C636A9CA9EA509A5C7C3639EA4D4247A07D3499A2A11DBD6F4482A568513DA3,134,122,12,0.4532547047537365,PASS
AC3ABABF43254EBF4A36E348E8784D64D552FB1AEA2706093D6AD14BD5E8D7B0,124,132,8,0.6170750774519738,PASS
3C9302167DF4CC969CF7DB7E632F6D5E6DE49CA0335F9FCBE54E9199266677A8,115,141,26,0.10416255883043901,PASS
913CE6F1535508C748BBC07E6A5C2997A1B9B21760B8159259C433E0CB1CC05B,136,120,16,0.31731050786291404,PASS
D10C362AB0AE79EB3206E29B4B22FFC6F6F1E907DF9BC5779CF7B4517B568A59,116,140,24,0.13361440253771617,PASS
6B852A4A96A946D383D1CBA81AA7E5E896870BE45EC4EC33B8830B5565BF8581,132,124,8,0.6170750774519738,PASS
B7581B2AFD52F3F0836DFC1DCFD653FCE6E90B6615FA613B04218D5156E0A2B4,123,133,10,0.5319710580974012,PASS
FBB546C4E35CFFC1A0299D0BE11887247EA5636C26475677E1292874F070EB6A,128,128,0,1.0,PASS
A9C8D4840E6A87BD7869C831F1FE8288DDCE4DE7997352A7B2123139E966CAFC,126,130,4,0.8025873486341526,PASS
229B23E85643D2A9B8F7F14CE94D095A614427AAF0731206967129E101F61384,140,116,24,0.13361440253771617,PASS
15AD9D1DC8B3587072554BCDBD9189A5CE3F5958E53BA70B508432F3AF73FC04,125,131,6,0.7076604666545525,PASS
1F23C4B7EA581A2CDEE4D98478076150FDEDC7B7A665D49F0BAE8F78BB1EBE3C,117,139,22,0.16913144470267139,PASS
E9DFCC0EBA2DE4081E8613210B2CF08B2ACF6851E10EB35C9D2A8481D760C430,141,115,26,0.10416255883043901,PASS
BB625FBDAB161EBF1DC3D0E1FF7526CAECB9B634E067CE0AFD854E3394C7B20B,115,141,26,0.10416255883043901,PASS
27CA08C23E39565BA20857DA16B856A1462616C7AA3811DB114DECE0B483767B,137,119,18,0.2605890342736178,PASS
72B70B834D88C302D0CDD1D1755106EA1EDA750ECB84441272F912361EAD018,143,113,30,0.060792723530522785,PASS
C3A6EC6877232E152864850E3424AC0FCEF3C1BB5BC3364C2425AEC6EFB2A4C1,133,123,10,0.5319710580974012,PASS
AB70325716E0D148423365A6BA01C43ED56F5C9AE4D2C792AAE60CBEE2AC9795,131,125,6,0.7076604666545525,PASS
367C49A89A9EA19D625A7D789BD0708A7596D58B694AC2744C22B40B373C603C,134,122,12,0.4532547047537365,PASS
F63D6E1FA6BEECFB1F461975EA79B5FEF2C5CA2A5F63EDBA5915285147F46C1E,109,147,38,0.01754895019147673,PASS
F87AA5E5BB50714DDBC94E82A1B8CC7C3DF2BAFFD45196129B0B98C6FAE65626,120,136,16,0.31731050786291404,PASS
D3353A27D57483CEAA7A21E2F12441C05DAA908BB414A8CA93E076103465C749,140,116,24,0.13361440253771617,PASS
CEB9B5970253D6A97E2AE6C288767D457502E0BC926EC5D751C7EED6E1E8B6BE,119,137,18,0.2605890342736178,PASS
F30E8061FA925D1F263D9DD84B33AF6A9C9665B8017D72CB7E99DFA86F528CD5,120,136,16,0.31731050786291404,PASS
99B071105D3781ECD8C7E0FE0B98E1EF0EC87E6EBDB01A2DC04F3C8CC7940559,130,126,4,0.8025873486341526,PASS
E69D735E3935323E94550884C00ABAD4FCD583F461C336E4DBBC521DD720D233,130,126,4,0.8025873486341526,PASS
B6C622FD8AE374070113A3E22DA9947C67668916B4E325219BFBE371A16F3546,129,127,2,0.9005235503397743,PASS
4DDD53F06B4FC7977E47DE09CCD3DC25774025E8E3B6CBC590B55AE48B6F96BA,116,140,24,0.13361440253771617,PASS
B8B7BBFD0277DFBE48F54FDD257CB5FE6D2D483ADA4576B1BA4ED7ED7DDCBDE1,100,156,56,0.0004652581580710493,FAIL
D723B229C4D568295F00FD02EC82178F31BC0FFBAA3021C1418FCA6513E3BED8,133,123,10,0.5319710580974012,PASS
E419DFD2AF86EECFCA911F4C58B97EACF344C334E416EFCD02BDAAA83FB6FAB4,115,141,26,0.10416255883043901,PASS
544EBE10E40AEA3669B4DB9DB8CF2BBC4C12CD7F95BE00ADB4A0B356C2BC31F1,126,130,4,0.8025873486341526,PASS
BADFFDD63BB3EA0987B66A7F61225CE4A7489B37A5A86DCF617C65CE85042714,120,136,16,0.31731050786291404,PASS
7E42E08E541A344AE89AE479BAB8EE7157201113B8CB12A8BE8627EA8785B5D,135,121,14,0.38157390570502125,PASS
E81BE4BAEA87D88742F0C7D406228AF437C41980EBE00613FED5599F497EB400,134,122,12,0.4532547047537365,PASS
E72837F8107267E64E0A04FD3954E1B81D36503CC132B92782BEF9A40B067384,136,120,16,0.31731050786291404,PASS
18D9D45B8E03E1F292F3E291800BAC8D3D875AE9F15E42A4177CC312E4AA4FDD,130,126,4,0.8025873486341526,PASS
15EE0749AC4A8E2FC57E6144DB088023831A68F9931C0F0099BB228A2E430501,148,108,40,0.0124193306515523,PASS
DBE31A69C81309787FEBD88AF24BA27E53492E8E113F1CC8FA5E07B0B633889E,126,130,4,0.8025873486341526,PASS
80630C54ADA5B7185AC23A77630F13093E8792BC9259AE2568B29F9A5FC4827F,132,124,8,0.6170750774519738,PASS
CA76F133D5723E30B958C29B551F6F9AB9B2FD0F1A6AC34C891A45E555224DDC,124,132,8,0.6170750774519738,PASS
3B9B3B2BDE1A0B1666952E6D6252E5CE6C3B3A5EA289039D429073911C1B38B8,132,124,8,0.6170750774519738,PASS
9C7C85515C9787E13D8130C1E40C6C48B504A5EC7F53ABE1327AE42EA0FBB73E,129,127,2,0.9005235503397743,PASS
5626B53FD94349743B58868906A4D9077B50BCB39DB2D90C399BA77930614679,130,126,4,0.8025873486341526,PASS
3279C7ACF88E82F95E0E76AFFF4CA3F906CBB2843077086923113C5793B4F7D5,122,134,12,0.4532547047537365,PASS
A1FC09D3DFD8CCE34CDAD2B788D8DDC818E13AA3660CBB78B933C4B984DD52BF,122,134,12,0.4532547047537365,PASS
9B7216557CFF52EBC367DC7B60928C985B052A5356F162F6F10D7C1297EDE2C2,122,134,12,0.4532547047537365,PASS
7699A91C34536019F64A706BACD3C9F35CF4AFBAD186B428537AC7538CCC9F6E,123,133,10,0.5319710580974012,PASS
6DB34219F63AF58EC2C41E1965C0AB04EE129A9A158DD6A50BAE60A07D57E17E,131,125,6,0.7076604666545525,PASS
F69871D6AB9B5A91710E75709621D1CAAD4F4289142BAC62551C8448A6F82D2B,136,120,16,0.31731050786291404,PASS
A3A15FD15A4A251488CA2F96D599373367107A18B6E9DF8373B0234C28FD06B6,131,125,6,0.7076604666545525,PASS
3538225BF314E39508C2B0BCC30AA44A5F78424C19315654204D7DEE7CF60255,140,116,24,0.13361440253771617,PASS
862776DC096E5F01F9EDD88C3CBA392720DDE2B0C0ED8AF1A4B28DED81AB661B,127,129,2,0.9005235503397743,PASS
FC0294D9B76E0B91F903653B1697F014E9761CB56521437932CB7EDF32FBC9AF,120,136,16,0.31731050786291404,PASS
4DDA61C37113FA360804CDF075CBF4B149C5A2EA85A96A4096FD7D959452190E,133,123,10,0.5319710580974012,PASS
A0406C9EB1CA531C2BE4D96F367AEF01CE9D6E104F45742B0A846E224B6847F2,134,122,12,0.4532547047537365,PASS
9E1DEF08C20F23049934EE5803DB41CFC7D72EF4A822D8892D209EF69294F152,134,122,12,0.4532547047537365,PASS
BFD975AEBD8D20EE698191EB9DB7B0E6AF5448FF62849BA1EC0646A9EE01426C,124,132,8,0.6170750774519738,PASS
EED9FAE609269BFD212534C66E0CD5035F132186DB3AFF897C6A87FF208D3425,124,132,8,0.6170750774519738,PASS
33868866D85CB3FCA03845BA9D0AE30B1D3438E8824996D8148FF6E552DD44BD,134,122,12,0.4532547047537365,PASS
2DE602F9A0A780061AD891C9F00347B9011524773B75570C2F287FA0D917D1FA,137,119,18,0.2605890342736178,PASS
5A3E305E757A46F3CF8A12C8A513D24FC6FB8F18AB86E71E769902CE670BA66,126,130,4,0.8025873486341526,PASS
40D8859A33EBB82666D4425D26505F50A318C7F385CD3FB230553ACD095F60F0,135,121,14,0.38157390570502125,PASS
9240A9A25AD03F0BFFF160A9B4FE4B5ADDC551F24A39162A9F30FD4DB3553D4C,124,132,8,0.6170750774519738,PASS
BA82E2A638B9DBCDCF57DC5EF5ACCF6AF60C154FA6C587A9245AFDF3B9281D5A,115,141,26,0.10416255883043901,PASS
432F5F63148FC68EF44C8D1BD5259BC4C89A80ED0C7C72472E74361DBAD07DF4,127,129,2,0.9005235503397743,PASS
F35AC17332CF766C1883A97F33DAC3F690CB6190A88F3520BBDEE89CAF96F2FA,119,137,18,0.2605890342736178,PASS
3B563E41EA0BD180BFBFE26D56950B20E15C65D8A37DA9A7056D9741CF58C3EB,124,132,8,0.6170750774519738,PASS
283603F5FB15044AA81EF761FCCDF1FA799FFBB2A5F33CEE78848CB1164ABD20,121,135,14,0.38157390570502125,PASS
16C6C3724F6D868A07773BE57566A8E1764C939F8BC24F590E197F67375D9794,120,136,16,0.31731050786291404,PASS
9CA989E5C7653CCDE7AAFDF7142B8A01F5551EC296F9EC297F100BF97B7A814D,119,137,18,0.2605890342736178,PASS
BEC1AD1C30AFDC9CFA8AB847D62A327645D78DCDE4FDDF98496029E5D3E2445E,121,135,14,0.38157390570502125,PASS
4473869DBC71A0E588970A0A3D1D349EC2A84F365C74EC755A523B2474BEE948,133,123,10,0.5319710580974012,PASS
E77CBFB49F0360A7044AA0D5E2596DF7995841C63C58C753B8C9F91FF3570FBC,120,136,16,0.31731050786291404,PASS
872F220C3B3B1AF136B607291BA37221F3BB22121C0C9E157F91F89A64E14C76,133,123,10,0.5319710580974012,PASS
27A0B566A7A5B26D3827085E12E3097B30C98EC65BED8853D8A5E66B37EBBA99,126,130,4,0.8025873486341526,PASS
E435FF2D914B4C9DD3324467F82602C2983B426D9CCB30F90BB26C7279668649,132,124,8,0.6170750774519738,PASS
C005AC57331C68C358C4B13FC370A3263AF869335A22696916E4A79BED79F22C,132,124,8,0.6170750774519738,PASS
F5B4D57BF46CD0E2CF9E2FD5BDFA72B5DF6EE90083A2F6083E9DA2B30387C88D,116,140,24,0.13361440253771617,PASS
A6B13C33EFAC9EC6C8FFD1AD0A182ED0F3477D60272B37514DEBC7D94D7BB145,118,138,20,0.2112995473337106,PASS
75FFA248C366CA951199AB5147BFD611ABF8833E969E744AF3F0AC55923CF4A0,124,132,8,0.6170750774519738,PASS
1D0DC47A3F41C1966CF7D5989B479FAA418F59EECD99EE982A80F38480096DA4,130,126,4,0.8025873486341526,PASS
355CF830FB1CAAFDC87008DDF5A6BDE8BA2C23DF0F9F898B5A50494282668E33,127,129,2,0.9005235503397743,PASS
15417F708817E98A1A5E2DEAA2425BF15D0E131D73DA21D623AEC8ED86A89ADE,130,126,4,0.8025873486341526,PASS
3407E02488F22C36E8CC29B87C65A19C6F5A009E3DAEA1C66E4E6BF7D26F4EE4,129,127,2,0.9005235503397743,PASS
359E1BD3E1916B9B153E5CD2C44A38702752607DFA593432B166903C81D2183A,136,120,16,0.31731050786291404,PASS
93E6DD2969F5EEBF0FE7FF839F040559B50A8502C7C7AC653E7F49506F56547F,115,141,26,0.10416255883043901,PASS
ED437FD8B2692351EC4E5ECD53F3C6F4514CEFBD0337B88A09BBDFA5A5E36543,116,140,24,0.13361440253771617,PASS
BB4E12076CA8BFBA382CD758D70111F91265C01BE16C241CEF52A21E95C2103A,138,118,20,0.2112995473337106,PASS
1CDE69444B730F384AEE7CBA7522508F81D7D92FFB3D02DE6DA97558F9FFD6C5,115,141,26,0.10416255883043901,PASS
A0000DAC35BEB3E2CA8F43AA06F12B7DE0F4B33B92B5E2E6E26AD27A1A20945A,132,124,8,0.6170750774519738,PASS
EFE20A08518B77D1C76E1C66933A6D9707945C580A927F216E918BAB32011CE9,134,122,12,0.4532547047537365,PASS
8DDC4228475CD4A16EBA6BC06D991D06539A50C20FFA8716B3E973180984846D,138,118,20,0.2112995473337106,PASS
B1FE03A48FF6639B32944F28026A785BC5B94681CB4E8E74324644632E8E0A66,136,120,16,0.31731050786291404,PASS
86870A2BCEF9FED32D1D7592322A12935D6C960777A10D7BB1A1D7F08A171090,131,125,6,0.7076604666545525,PASS
65B84C73350F5284DB1C938CA636AAA538AA9A710ADA4ED98D4DDCBE599E4319,130,126,4,0.8025873486341526,PASS
C21635886E98FEA8B0AFE74CE109D547ACC1643A51F4D63B136E061780DBEB44,132,124,8,0.6170750774519738,PASS
82A7E9693F530790908528E421B600FBC7192FC23ABAB8F15F3D6FA3CCCEB39B,126,130,4,0.8025873486341526,PASS
99E705958BE48DAFBF26714B9EBAA910523202C47D7450E82BBFE855E9723805,130,126,4,0.8025873486341526,PASS
B29D9279A70411F4AD5528F7EE23731C24C4F61A1F0C8AB9515BB68973F5AA6E,126,130,4,0.8025873486341526,PASS
C1C8482EDB5F7D51DABA4354071AF6000B36EB6B387397870CD022FD22AD3F82,131,125,6,0.7076604666545525,PASS
607E2F8C2CBF52FEDE6B729C97971462ACACF725C5EA7DC157375E4278799EB5,114,142,28,0.08011831372763423,PASS
D31478144B12083892E5131EB3A1F78CB94DE4AF580BA1837151C71A8DB9A59C,137,119,18,0.2605890342736178,PASS
D9C3A8B1CD4ADD9E34AD994E66797DFCFED953CC0AFA29EB5F4189D74DF3F70A,111,145,34,0.03358661289689768,PASS
5906A6986147D30F9FC5D5CD91B637EC3C87CB5A0C438AF62F28B48EA26A935,130,126,4,0.8025873486341526,PASS
BA02594E4BC9EE87C3D4C34E57061BE5F09DB47FD01602FE12148EE14A7233F0,131,125,6,0.7076604666545525,PASS
6B63194836F3E3F2056E4E63B5A51CAFE8105D4B21801254BB82BCAE996A001E,137,119,18,0.2605890342736178,PASS
4AD8F8D61F26EC242E5B463E97F6EA5D344120C92A72C992EA9969B7A27DC47C,126,130,4,0.8025873486341526,PASS
C35481B36848DF1182EC2552679DA1FE19FCE1F00A3A5820DD2BB4739CB41235,135,121,14,0.38157390570502125,PASS
8C25D3E040ACC9FAD57214DD37B49B0C503C49896C0CC489293C0113681F62C7,143,113,30,0.060792723530522785,PASS
E6EA4C515EF355F531C8DCFFA072AEDFB78FBE2B80EF77B5A0B5580ABAFF6EF9,106,150,44,0.005959526470109114,FAIL
3AFE93566A033491D15ACA36EE90B9CE9920711CB666C21BA23BF11A369F57D0,129,127,2,0.9005235503397743,PASS
59CABFA5184DD4E27D196730D794939FEA461CAD4611A47DC07CA10C906E1734,132,124,8,0.6170750774519738,PASS
CB1F39A051D82532082C9F0598AFA38412D619EB7210A65BA812EE192500A321,147,109,38,0.01754895019147673,PASS
473E789830BDF15516715FEF04C2280B25C8F0E16F80AD6CBAAE01CE05FE8DA6,131,125,6,0.7076604666545525,PASS
847216BDC043AF3B29463D5A16D208F9E999968770286142B70103DB25AFF0DF,134,122,12,0.4532547047537365,PASS
407EB42932C75287358523BC6CE6804872819C8587DC14B922BDA11E1517721B,141,115,26,0.10416255883043901,PASS
7F567ACD75445458DEA347FA01479E88777C6DCFDD9A9B3309838E42B0E14ED0,124,132,8,0.6170750774519738,PASS
F41D96A4269C07106F4D4AD44C2C5CB81F2EAB9D30D54D39F2A7EA85C03140C0,138,118,20,0.2112995473337106,PASS
A69D8758906291CAAE54CD3B3C0FC105575DC42957E4F4A4C5F585EEF4916E0D,129,127,2,0.9005235503397743,PASS
FC72F45260F01ABEA91AB340B365CCD3DEC4FBCB7DC328C911D0A7ECD2A18F35,124,132,8,0.6170750774519738,PASS
482528E59453315D3A8944DC7ECC5ABDDFFC553BF59958976762F41C9A4B1084,128,128,0,1.0,PASS
BF3CC7D051A1690A1D74117B59A95783D8CEEF337C8B29D709F7AA90E8365C4A,125,131,6,0.7076604666545525,PASS
F788F508744B8A55F5788805CB354CEFB858D2338897FB5A75C4012B084E12F6,133,123,10,0.5319710580974012,PASS
27806BFE0A10E2FF3CDC95C03A5A6FEB362950121ADAF2362B939BA12095F86F,129,127,2,0.9005235503397743,PASS
1A1BE8586728A9C725D59225C0E3BA167B1CA479E821677A57DFC1866428963A,133,123,10,0.5319710580974012,PASS
38C163269EDC9CBC208F98F8E96A05A593A95E70E4F4C9C7F166B4B1399CEB55,126,130,4,0.8025873486341526,PASS
DB45DA328C1A80E20A5D03432080966E99463C2FA2983D4E3FBEF606825FCD9,139,117,22,0.16913144470267139,PASS
9D8674DA66144050AC1868666B9A17B53BD55A910A3AA06B057D0DFFB274DD45,133,123,10,0.5319710580974012,PASS
534CC9974846DCBC1D6804FB8475FCF502E7DA038A2681D085BC87C6AECF4F86,131,125,6,0.7076604666545525,PASS
D3A2328D950D52E22968D16FC4A36F0464BB0BE50890C705C90ED9B56F405156,139,117,22,0.16913144470267139,PASS
B16949FCB3EA6FC8E11436B06117E6133D8110B31C43233CB2B8535E9CD8B19E,132,124,8,0.6170750774519738,PASS
43BFEDB10265AF198B96C09AF989CBB364AAD06321664BA0F8E36ED5A41F696B,126,130,4,0.8025873486341526,PASS
7F995194DF34DE21A8F14D2DB6CEC98D0B308487E507B9855D41A8CA570B6DF8,128,128,0,1.0,PASS
779004A6CC503C2B483912BE92891AD3E3F3DAD54F856B3920661751444CF47,138,118,20,0.2112995473337106,PASS
FCBC354B8F9C6B14DCC70B275C10C4DEBA9F83752225F73E8E217191DDC7571B,121,135,14,0.38157390570502125,PASS
9A3D45D8AE7B399F8DA8ABDFA34BC6D8EFBB4C986E82EB78DF51C7A24F78377D,110,146,36,0.024448945310089426,PASS
202284FE21E75512BD3895515C93D36F2CD2DB661195973AE255A93CD1E01EE9,131,125,6,0.7076604666545525,PASS
FE353320C6D42F8663BA59A09C6834986C307BF53ECBBBFE7A70BCD8EF6148A5,122,134,12,0.4532547047537365,PASS
7A3AC865D71DD1352FE4739DD2E60F7F59308CCC98375B921A9EC6380DC42F88,126,130,4,0.8025873486341526,PASS
2343AD5C1FE50BD91F494139225FB0DAA513F0E8B59A8323D27152903D1661E1,135,121,14,0.38157390570502125,PASS
39452724012F94BDCE319DB0A69CCD8B7AD030D77AB6D156495A4B8F9638C182,133,123,10,0.5319710580974012,PASS
C5E18A0E23F456EF03869C4D8941EB5C8F9185DD0DD2E71F39054A8526A1FD53,131,125,6,0.7076604666545525,PASS
C8B3F580D6CDF757EA32E7E627E94160858EF8CE7A2ECA8888482AABCF1BB9A9,124,132,8,0.6170750774519738,PASS
6891A4F37CAD7EFBFFD473D6213D8BD1F41EB891EB40C5F60A9F299EC2609A1B,119,137,18,0.2605890342736178,PASS
2603111767319AC742CBDBCC4326F8A94FF4E14BEC01A79222A0B0E1780D3CEA,137,119,18,0.2605890342736178,PASS
64DF6C7D6D87220595854DFEAC99E8EAA2D6125F464D14B8597A4515C8992020,135,121,14,0.38157390570502125,PASS
BFCCC0AE072E111A3B6CB364D4C8479F2D0D78B629C7BC5456474613CD57D2C9,128,128,0,1.0,PASS
6EF2BF7A805B65C4D9A5F06DFC5D66F443D0F79DA757DD7036F7A01102924B0C,121,135,14,0.38157390570502125,PASS
939F0AD59C0A26DFD7797D7C6CA4316FD13AAAB8738F97C6E6182939091C62DC,123,133,10,0.5319710580974012,PASS
7E7810E0717B5134906F4946112F50B3783CC8808718C3982A8C059F867030B5,146,110,36,0.024448945310089426,PASS
9F8CDD88245523C6022AECB8DDC61755121CC6F7C012A48CE1F64D5E0A32D886,138,118,20,0.2112995473337106,PASS
BBD4280D3F1B146A1907BFB8FB811181000CF72A3E03FD01093789621BC575E1,138,118,20,0.2112995473337106,PASS
C6E334EECB4169190EDA5E2DCE2BAD4FCFF86BDE9D58DA5C462D93A2C4973655,119,137,18,0.2605890342736178,PASS
B3429FE4589AA75504EA0AB738DD4D1A8B21AD4007F2C50FC9AFC4D3CCB08990,135,121,14,0.38157390570502125,PASS
ED43C53AE424498F36E7A6C53E412F08B2C0C81D52C59ED9EAE80A82F50FFF99,129,127,2,0.9005235503397743,PASS
EFA7507B16D2137F82ADBE46F0197A1926539B4110E1F29D2BFABC18D9037755,125,131,6,0.7076604666545525,PASS
6E927D721339CED9181744A643AC1BA628BE63ABE3C001B71197283AD04E6A20,138,118,20,0.2112995473337106,PASS
4ECEBDDBE11E7734D706E7161EF4630A071FF25BFF802D7FEAC08FA5A230E9FD,115,141,26,0.10416255883043901,PASS
DB7B24A9A5A37C0E59708FDEBBF3A0592AC4D73AF7A9F66898B983333E8D5398,119,137,18,0.2605890342736178,PASS
FEC3863D35143F8D2DB74874EC418BF5F8FF7723DF81E00ABF7F8422D8E82C37,118,138,20,0.2112995473337106,PASS
D837BBDFD44D64900E14B311C2F9AD99804E11B19DA7A48182645A84583CCD60,140,116,24,0.13361440253771617,PASS
56E6D0BE54F2FD4783EE97D5685775DEE81B4EECE79DDBBB418B1720149C2CA1,118,138,20,0.2112995473337106,PASS
E633BA09CC6E6CCCFE3E04829AC0FE4D10EE25800E20F381F08C09592EF42F00,141,115,26,0.10416255883043901,PASS
EE7E18550D11040D24D5385AF444D7689D15725D86F97229C127E521DD97C677,131,125,6,0.7076604666545525,PASS
B71BBF9BDD35152E6F22B3E221C2B57D6B9A9627764386B7285D3D1550CEFFD4,116,140,24,0.13361440253771617,PASS
7F39CDCBD1D90F13D9FF864376A17710335CF0C5C3721BA42EB4EADB2572055,124,132,8,0.6170750774519738,PASS
341FC4AD4DF38C52254D03B4A1537690005DE4B550238173860E3BBE7554BA76,136,120,16,0.31731050786291404,PASS
1A08096D3C688E1BB19500993601BA5378717EB5A77192A895E64937B137B471,136,120,16,0.31731050786291404,PASS
FDF7E62EB06AD441CC5A7EFB534B5C97DDC4EEF5A96507D43C3921D3F511D9D,115,141,26,0.10416255883043901,PASS
ECE53EF59E60A5AE2E789517381D146627B2A44492B1A5FF04583B712F8E9346,129,127,2,0.9005235503397743,PASS
8985E9FC6328951C74FFB937B08C59B59A2A77BBDDBDFEFCA2DEA237BFE7402E,110,146,36,0.024448945310089426,PASS
9C74FA23B678E36C65EFB1F4D766BA278EE5C6D171B058358AED40FDE8ACF2EB,115,141,26,0.10416255883043901,PASS
23C27BC31F30CE31245DBD7A6B8592E221DFE2BE4ED8960938291D7844FE60AC,130,126,4,0.8025873486341526,PASS
19DDA1BB91BA9AB7224ECB487F910C76AAAA06B7BE6A9E30DF5EAE7C9CE587E1,118,138,20,0.2112995473337106,PASS
360FD0791643043494AC1174308889F0E0DCBE30BF57988D25BD5D2DCC9D2627,137,119,18,0.2605890342736178,PASS
5A50B588E95E7AA11D8174D587E4AE19D554B05A447262AA2EE7B41341A4FFEF,129,127,2,0.9005235503397743,PASS
66B7373BAFA89ACFC49B67C67B4E42533D8DB0AABD98629EB85FFD26AD3B6C46,114,142,28,0.08011831372763423,PASS
72F2D7C6F3FCC423713ED8CE58998126A23628B48B9F112F48E701C6E472F771,127,129,2,0.9005235503397743,PASS
2480A6A588AE50BE97690684267B34260B41E1E6B5AE88AECB0C0CB502560A18,148,108,40,0.0124193306515523,PASS
24E09B49B5914B7ADE96D3ED648A85D11507137BCA74E806FFA5B7CC6A56EC9B,123,133,10,0.5319710580974012,PASS
B9E224BE9DDA307CAB416B112615D9170EF3DA2A23CC356FBBE81B3B92D51F0A,125,131,6,0.7076604666545525,PASS
132997B0EC8C5F70D985F4BC962E6A33EA8AB2371745719CBE6FD0371E5E1308,126,130,4,0.8025873486341526,PASS
B8F44A368F1A56EC93E7C7427C1FC851EB4AC6C262B3535F3529147619C6746D,126,130,4,0.8025873486341526,PASS
3F0F22CFDC8ADF653F25FF4ED3759E266F0D3827B431715B1ED1E16301E2EB46,118,138,20,0.2112995473337106,PASS
E63CE21F165BF9E8565AA06B9B5E6A3C520D827F3CADA4864643B6C46F3AFE20,125,131,6,0.7076604666545525,PASS
826CF41BFC0A6EE9C145F5081E57F10D11E7D3B15CC553833DBA653893A24C5A,130,126,4,0.8025873486341526,PASS
36610686A3D34D56EDCAB35A3F9B2589937CA06909B99B7F07D68BFFA4859563,123,133,10,0.5319710580974012,PASS
8FB47B67336886D322C40A90137FE62791A11B03E0AE533106A4E3D94536B18F,135,121,14,0.38157390570502125,PASS
95D175C2BE17098366453EE95B6F6FEEAB235116C52B9CA6A8D9B9BB93E261EB,119,137,18,0.2605890342736178,PASS
2048F430ED0A8CB22AE25234A11B46538E5336097DBAA8CDD275900B7EA58586,141,115,26,0.10416255883043901,PASS
F6CA0A3A26C2AC8AE49F0EDECE5B1394D7CC6BCB595243CAD89577C4773F7E1B,119,137,18,0.2605890342736178,PASS
B8769941E6CB8DC7F22EC40A06FBCE697981BEB4CECB566FB3127CEADA8D19B,121,135,14,0.38157390570502125,PASS
86B4CB629A9071EAEE01F6DA5D156DBB8AE934026F1657895BE51E8262C5BB1D,127,129,2,0.9005235503397743,PASS
F4A852E4024AE1ADDCEB84BCB3C74E6C9976307292463F89E40A80F0A287E9A1,136,120,16,0.31731050786291404,PASS
BB169098785541828F1D9CCABC4DE32332C03307EDCFB5E8388DDB45A3001871,137,119,18,0.2605890342736178,PASS
4800E1C0FB9D82797F9FFFC79C82E12E6F5961967F2008EF63C351FAEE35A20F,122,134,12,0.4532547047537365,PASS
EECEA77828B1986F708144C7F3C586CD11742BE9E5E9CCB2A19094811D9FE2D7,128,128,0,1.0,PASS
C0549C9D34002BD6BDD0A956CA1DDDABC0EF5171FDE422AB524FD1DAEFCA3777,121,135,14,0.38157390570502125,PASS
A0EE4BC9E67C62279317395C02AD69DA8CA1023E8A970CFCE22B31B40AA5CAC6,135,121,14,0.38157390570502125,PASS
2755F9B6F176A1E49191F636BC9C1417E632B70F6493E85BDF002C3D9945907A,126,130,4,0.8025873486341526,PASS
E990C6FC765A5009901EAA4746CE98C00C5207129CE89E9981327F3469C7565C,140,116,24,0.13361440253771617,PASS
3DCC1F1F7D96B962EB8F4782DF4E7D73A8398D34725636B84276CC39FAA5B991,117,139,22,0.16913144470267139,PASS
1E6482055B7CA371CC59E0B94F5FADC08D083A1BB65F8906CC8EE8F71B5A84BA,130,126,4,0.8025873486341526,PASS
C64B3AC109F5D686EB983E2BC8C0CA2C99474A77A50BCA46E3B23C1412C4CBB4,135,121,14,0.38157390570502125,PASS
B1F536683911554A65AFBF349FB3C373821E22722AE98B7601B6E46A4E92A4DF,126,130,4,0.8025873486341526,PASS
893CA7A321A5A643EB19AF90A121DE6964EBB859D9A98F8DA77AFF85074C277E,123,133,10,0.5319710580974012,PASS
E935BFEC0BF57A49C95798E80E1E46992B6995762FFAB6BC495E8FFEDA7DC70A,112,144,32,0.04550026389635853,PASS
2FE0A2448D7D06C490ACF65968C5ADA1487F95BA48712DB08E205BA9FC39034A,137,119,18,0.2605890342736178,PASS
503C27BDBBBF0318EDC70EB06470C62C5D66296991720E6762113A9009F65BBA,133,123,10,0.5319710580974012,PASS
A9ED011ECC20051DC2E1525A8B40F093F8279CE485B3866D871E6FF15CF82838,137,119,18,0.2605890342736178,PASS
3C54525EAD15B9091BF71CC118B96003DAD959418F12295BDA56CAC66DF1EC97,130,126,4,0.8025873486341526,PASS
FB4BF8AAF48ED0795A9685764B33C0BBEA554E0821507DAEA5CBEC76E6830E46,125,131,6,0.7076604666545525,PASS
F43E1AC3FC675175A73EF0C0CA5CFBCD23864112EC35478391C0E380907FD224,132,124,8,0.6170750774519738,PASS
B800C52ADA217EB51B3F1322CA3A14070FC574F379553E561EF608E12C6D8DC5,132,124,8,0.6170750774519738,PASS
2A85D923531CB3955EB1EBC090C7D122A53033CE23A91EF639EBF08A2548B0,139,117,22,0.16913144470267139,PASS
4F99BC45009B550C6F2D4DC9E1CEC850CDE69830C1F1CA6382026F4B7A07C30E,137,119,18,0.2605890342736178,PASS
D648FCBB73AD16EFD0CECA46FEC830D85CEE3B53A2131BEF99FCC45DE0B5DCC0,117,139,22,0.16913144470267139,PASS
AA127812DFA9F74E50843CB082430EE24474937020127CAE5B32284ADBC991DC,142,114,28,0.08011831372763423,PASS
A3780F20212A7D3E27BC697E1C963A7D7801374A0C04FB811F2BB722ECA18C8F,133,123,10,0.5319710580974012,PASS
2ED5BDC7AA58A519961AC0751C656F683808AF5A488F9E807CC51794197BA621,134,122,12,0.4532547047537365,PASS
F452A447CA4AC6EB53F096B7740C14D87AA3730BBAD8BF58235B3135863D8176,128,128,0,1.0,PASS
578DCB7CBD2730BB48757E20E21F55875B1B9A33A8DE8741F83D28379B618A29,125,131,6,0.7076604666545525,PASS
FD2A81588DAE8D3C5B80EA0DA96668D11EC27F5B19B5D3580EF92E08FDF93E70,125,131,6,0.7076604666545525,PASS
4B3367E021CD5FD1854D67874948BA12B4F0660504BFA62C72DC0E59EAB02398,136,120,16,0.31731050786291404,PASS
5855F8CECA8CCF20CBEC71BC180189DBD0DF22CEDFC4FF79A5E54F3771BC5F94,117,139,22,0.16913144470267139,PASS
4DC2A9C26BD683DA982726210936864B84E140E32FDDF2F15161D215D06B9CDF,134,122,12,0.4532547047537365,PASS
BD6281C41F5F55199F1F504D6D96BA5C7F4E99E54C2E53982937F6581E2DDD9B,119,137,18,0.2605890342736178,PASS
5CD9104D51FE8E5EC7ACDE36C2D9BE2E8DBCF8AC59F8C56A0A33A7D1C7C6912,123,133,10,0.5319710580974012,PASS
9C2965D0284A3A5EE8FE087D950A62BE0E51E078D1F4C4BA87217A60DC58608D,138,118,20,0.2112995473337106,PASS
C788436BB6B63C80FA8201B93301D4BD8607302787860302AFE5B88EA3028893,145,111,34,0.03358661289689768,PASS
63CABC60A01BA74F33F914E876BCB471AFCB223DB1CA835AEE3DD3812CB37DB7,120,136,16,0.31731050786291404,PASS
706C9E297A8B93864F60DBD78D61538DE97CA019E6E9882951A201483021FDE4,137,119,18,0.2605890342736178,PASS
209DCF82D2D3C85C63F739FDC914832C452FD0E74359D579361CA346EF0D38BF,124,132,8,0.6170750774519738,PASS
23058E6673A5EE6D1A0A6A9D8C5652BF0F061E0DA7AC729E067FCEDA2CBEAD69,124,132,8,0.6170750774519738,PASS
8CC7CEACC1C303748090296EE8837BB31E1D51778A9EE39BD9B47F002396286E,132,124,8,0.6170750774519738,PASS
3831C72FA7BBC77223C2DB257060C3CC44B5886F5C7F5BE976D8410A2FCF436A,125,131,6,0.7076604666545525,PASS
817623120364F7865D6896B17D962A528DFD2FC5B54E8DB20AB0991149A428E6,136,120,16,0.31731050786291404,PASS
FCF71C2A86F66F1E41440087429357328B4D109C4ED39991A950A3EA946812BD,138,118,20,0.2112995473337106,PASS
F190178855ABF69FBAD786A81FC7F7A5CA4EEA5A506D62018B71CE965324ACF5,123,133,10,0.5319710580974012,PASS
CD0AA3CBBD8039E3B8F4548674901D117E28BBD69CFD646EC7A0263150130A3C,135,121,14,0.38157390570502125,PASS
BF6546165AEBD5A74921398B2040397B276C37B6BF7456727C3E7C1BA8E1FF13,120,136,16,0.31731050786291404,PASS
3E9925027B80D6EBE7312C04C2A8BB2D7DCA50376B1E2DCD2279901933FE26BC,130,126,4,0.8025873486341526,PASS
B02BFC2DB37180200D2BDA26F7F0735F94E5B2FAE36A639DBB2B566F22B5370F,119,137,18,0.2605890342736178,PASS
6D7EC07A792DCE3AC96BE7CD3FD27D36FBF44C64752106B445710310A2642A5C,126,130,4,0.8025873486341526,PASS
41838C06591D90A81ABD6027E597573837333A24C46A70A1D84964C4BA20C17D,144,112,32,0.04550026389635853,PASS
CA98152FC8425E922F0FBA53D02E1038CEFDC31DCD628C4D868497A58613D9DF,132,124,8,0.6170750774519738,PASS
AAC5E2DFDEB66E4295AF039D4C32422DB301C4BE01740BBE0CA3CEDDDF589CAA,126,130,4,0.8025873486341526,PASS
19C4205FDB3C2A05FB8A37CB8FC3BD8E1AA4B7BBAD133A3F624427FF35E37CF5,116,140,24,0.13361440253771617,PASS
5D0AAB0B5AF51E725C387985D0C3112B7B299A2D1E3C6B2B6FEEC6796F8F6365,121,135,14,0.38157390570502125,PASS
1F1E10FCDD08AFD29993923F54F38E9D77A7C235CF181CB6534A13AAF902C882,128,128,0,1.0,PASS
F979359DB962B6653A4C4CE1CF62813D38C0116A84A19125006B0BC3FDB9417D,135,121,14,0.38157390570502125,PASS
8F3466B827424BB73CEF713AB9367C4B00D7DB373D54A787FBCB4B8B7C6173FE,113,143,30,0.060792723530522785,PASS
BA08038A5B747E436590DDED77EB3F376E61EAE3A4A60E155460018E0A7971F0,130,126,4,0.8025873486341526,PASS
8B5C5CB57F84CC0C58F1F63EA8F944CC976987E5F041BE942E750233183F1268,130,126,4,0.8025873486341526,PASS
BDF642448ECBD60D8E7CB5729A1E22ABE834F6884B33E13D0D3122B0199A82C0,136,120,16,0.31731050786291404,PASS
59AEA7D85DAC863F6E4350814E49B11437CAC87713FE4427059707372F0A6158,133,123,10,0.5319710580974012,PASS
970D37A80ABBCA0BB51A8E25F81E53B5CA98824AF1837C18732BCD1DF57D176E,126,130,4,0.8025873486341526,PASS
961FDB8EC2C4F55E43EFD6BD3F39FF6218F43C4A18F957A01686FCE926D677C6,114,142,28,0.08011831372763423,PASS
B657D01D1B5CCCA501C9C2DEE197B36E7D3594723830F8798D8239BEC2109132,132,124,8,0.6170750774519738,PASS
54039F21AB8A942A18DA50F194A213B4CD5CCB0CDA9AD06A1BD24D8258A7935A,140,116,24,0.13361440253771617,PASS
DB481050CB7ECB3399B59CFA2D1EA1C5A62289913B46BEF612C6CA955FFAC150,128,128,0,1.0,PASS
864E214F40D91CB492ADC14B4734F01BBA6775118DEDBC1BD1B6C1A3C72031C1,135,121,14,0.38157390570502125,PASS
4126A4C0BA93A5F25FFC5105E4E6213AD089EDD8BC9B86DDB8798F9C94FBBA2C,125,131,6,0.7076604666545525,PASS
DCDA857DC4FB0645C0FAB78FAEF1A8BBF26092A224E485BD9006069C113DB26B,130,126,4,0.8025873486341526,PASS
65D09DC875B4306E3E5ECFE710050A9DA2225277A4B8E7768E4DA89D93A649C2,131,125,6,0.7076604666545525,PASS
FBE31EC9911F6566F8FABB26AB2E85F0C1E58013FEC15B1571AA5BCB2EA19C64,122,134,12,0.4532547047537365,PASS
D6F1D1F890911D76494DF466D7E189F6E7D90BBF0E8BD6AC95F8926E1BA566CF,116,140,24,0.13361440253771617,PASS
D8E11A4BB78C494D4A4900C55697ABF3886EB795E439F2C236697588668785BC,131,125,6,0.7076604666545525,PASS
BA4E1F47F0293A16E9AA528BED0AB1D7E101AF6D0A86CDD3DAE2DFBE85C9679,123,133,10,0.5319710580974012,PASS
96FB56D972CE8C404729358CBA62BF862DCC2756D191A718A427EC1ECDC1E2D0,130,126,4,0.8025873486341526,PASS
29D44887877942333D1E5E2EA97D7BF2716F76C2947B0450A83693D0FF8DD712,125,131,6,0.7076604666545525,PASS
7322D18BBA80EAF583CF8622CC4198FDC676ADF0682F32011C2436E741A8D10D,137,119,18,0.2605890342736178,PASS
1BDD5712219D6B7411907A34484D6755D40BC549C89D7703230676255471ADCF,135,121,14,0.38157390570502125,PASS
F013F3F6E75C5C32EEE8E2F10BCA6F22B86DE5DA1A4E3415423DDC688C6027A0,128,128,0,1.0,PASS
F611D804FEAC4C106E3059E84FAD4B63F8B78F5F54414F93AE3E28E12BD1100C,132,124,8,0.6170750774519738,PASS
993E163B19508D8DC6E1B5022AA133ABF304B3F2933001E5B87B193022808F27,141,115,26,0.10416255883043901,PASS
750E650D59B31F7DF7A37CD5A5D154FD3D3A5AB8E9228D4755C2F3FDB6DB34EB,110,146,36,0.024448945310089426,PASS
770AAA94267B80B1D6C1781E33EA56E1DBD6BBE6DA2FE5A3AD101C040E7089F5,128,128,0,1.0,PASS
50EEBC91047828876B6CCC264F3B6AAC246B674EC7A512AFEC38DFA457BCED86,125,131,6,0.7076604666545525,PASS
52CFFA6CABE42733DD9AB8096F2C89328CC8E43EEAAF55C59647FC065C1BDF57,119,137,18,0.2605890342736178,PASS
3DA2898D3AD90A202E14457BB9E7215A6AF7C652C6EC9BD6F639AC51863BCB42,128,128,0,1.0,PASS
F22B374D7E562CEA46593A6588025A8522FE8776CD5493D36B95C948290BBAFB,127,129,2,0.9005235503397743,PASS
88204576DA611072303504A42A83675BB37FFB38FFE32A4FF743ECDCAD90612E,129,127,2,0.9005235503397743,PASS
B1B90DF1330517A1D309FA3A8FD757090CB8732F2497099470566BE974EA8D0A,131,125,6,0.7076604666545525,PASS
2BEB3E7657CC05D5A32DACE06F2F8CA3DEF09FAEE5D153A80F069D8FFED55836,115,141,26,0.10416255883043901,PASS
DF1C35D71EC655E7C5325196F9035270A66B189EE9FE271E2F57AB889EBF4D,121,135,14,0.38157390570502125,PASS
AF940FE7DEDFB959A51812088FCA132E44B5B4AEEBC037914432B9042202DD75,133,123,10,0.5319710580974012,PASS
62E97FF9D47FA42B39385DA802932D66F3D8833E88CE8F9348511DB5EA09ABDF,122,134,12,0.4532547047537365,PASS
4D5FEAC4273A303F6875AFB02A2CE129EFB022172FAA0B612923C717C2DA6D31,130,126,4,0.8025873486341526,PASS
F3257352D7D7A6419B66777734625227BB0E622EB539C5E57EAC63D48556566D,119,137,18,0.2605890342736178,PASS
D9D14B46C59344E97EDAA8103505CD42C7D01999643683E3AA268C9DE6B7E96C,132,124,8,0.6170750774519738,PASS
3B5163FA9A7B86E055933E6E2D094BD73613B805DA7A9A11D65F2059487D1A93,128,128,0,1.0,PASS
F8DC8B8F7BD059FBBE48BD57F0D9E2DB6D506BC74DB33A18818267ADC1D0C213,121,135,14,0.38157390570502125,PASS
5793AD30DBB280474ED486FC0BD39193C390E250FF65B92C6EDA6AE3A91BFE06,125,131,6,0.7076604666545525,PASS
E179C30376B1ED130484A482F344072F19D499BD2E7CF81A0A9C79C6C9158789,136,120,16,0.31731050786291404,PASS
DB7067176FFF8DFF1E125839481549F5A92E51B4BC5FF6F461B5E9E2A1AF530F,114,142,28,0.08011831372763423,PASS
59580004B07C2D47150CB2AB008F8E2B9F1287EB27479BD54578B663CB87FED8,133,123,10,0.5319710580974012,PASS
7467A24EAE5602DA1B1AD9AF103A8F97803A1957243F0A22EBE556435003283A,139,117,22,0.16913144470267139,PASS
A1429C2726FD3D8C0DE764C656820E3F4CA57CD885664AB86DC1628EB363B039,133,123,10,0.5319710580974012,PASS
EC34A82C5BD6ED7C96990CE606D6050D41BF617D8E2969A44C140F534533A4A1,136,120,16,0.31731050786291404,PASS
3FEA8B7F0B566E897A0362AA445933CFC75FD806B6581AAE0DC60E284C5C2210,134,122,12,0.4532547047537365,PASS
FECE4D165FCE2810CD013F9E81F328581102976FBA32AB05F9A2A4991E1B0EEE,131,125,6,0.7076604666545525,PASS
2CD7B92630DB478C4E7C155288C57DB357130B64AB5AA0393ED480F52DBFAF56,126,130,4,0.8025873486341526,PASS
E408B060A6E94517A96D08806E8FB63BA698A80A9BE5D852C8729D415F5917AC,138,118,20,0.2112995473337106,PASS
98E4256BBCE117A93E678F3C3FDF901BE47C351DAE0E49876892475F8815B9E0,125,131,6,0.7076604666545525,PASS
61BFF9A326C4DA2A0F497E5294D26F180603FB413FDBB01C59D97FB344E2CDF5,122,134,12,0.4532547047537365,PASS
CDC80CA9499681C95EACE4A1C42F23ADD9370DC5121F0832135A716919CC164B,140,116,24,0.13361440253771617,PASS
B96D149293FCA3D0B13558F9A38B32AC63F9BC07BF0B8BF97CEB558F87CD1EF,117,139,22,0.16913144470267139,PASS
359611E4F5508B39BE3A5A96562DDADEAB2BB090B952ADD27A1323C5827E6F2,128,128,0,1.0,PASS
E9BDAB4AE08067367F79B624D00257739949297C4FAD05A1221184B78F4A6B72,132,124,8,0.6170750774519738,PASS
CBCAA8C21A1CE189EB562ADFFE17CDA3262EB03EC6F947540A07257E39EB246D,125,131,6,0.7076604666545525,PASS
8AE580D5E97D2A5AE5B015A33EE6D8ACE78E4387495345D1720D30DCE580B740,133,123,10,0.5319710580974012,PASS
3B8B051597DA1D635397EE330426A66DAF2B44C2CBE19126F3B2220946E96515,133,123,10,0.5319710580974012,PASS
A1278DFDBC82978512431A425B666729145B27C974D9B9633F02FACDD6F37C8F,124,132,8,0.6170750774519738,PASS
F08EA08EF2FB2D818D88ECC239BF03558FF93987634650F011B190933A47D33E,131,125,6,0.7076604666545525,PASS
BB9C8EAC68C1C7E5F54AE93B2297A618815812FDC66DB71B9AD7EF0D5AE4D59,122,134,12,0.4532547047537365,PASS
104B8357D340BC669EEAC9239EA822D0ADF917B56A870562D10C612CE70F9F53,133,123,10,0.5319710580974012,PASS
58045E941C42335003B5E4102FB235305F808554EB8CB945974FF1F04E4DA058,144,112,32,0.04550026389635853,PASS
D103B9115C1144E23A8EFF8351C924D464F1E39160D6EF4650E3DBB25F02691C,135,121,14,0.38157390570502125,PASS
5DC07BCB04FAA78A427B2C899F28512AC06FECFDD82DA48D43121ED0652CB510,135,121,14,0.38157390570502125,PASS
839779E4D8013697059D030D45E08D0FA8AA3E91108BD828D3B0B10E9207084F,146,110,36,0.024448945310089426,PASS
E657264997D319F27C1CD6DC95F005D401DEABE0877EF2C5EB52BF2707BD9702,121,135,14,0.38157390570502125,PASS
A36B5E221883ED9F3C461CB27F88D970F237E0503A7E2E01B2B0464DC8659ED7,130,126,4,0.8025873486341526,PASS
8EAB955223259E05C464F767E50CB1D49DE21C6C80022BE0B03EF1DA0BF74C0E,135,121,14,0.38157390570502125,PASS
38F35A901C96EDC0D50AD6B225775E74FE49E1F9376A61F4099AFE6D4D4C9B39,121,135,14,0.38157390570502125,PASS
9FA1B8451A5CE66658A0905C80D092E1BF51CE178AF92645881E8653C302F962,141,115,26,0.10416255883043901,PASS
68B4F00692052EA6C53CF820F37515F6F0A8A1BC7BBB7338D86BA12D85EF4F00,130,126,4,0.8025873486341526,PASS
43704B71199CCA3675FDC69799035BA741ABA12FF4284DFF3881AD836AD63CA1,127,129,2,0.9005235503397743,PASS
3785B42F42A8A5895FAF11958EDABB73EF41D9BA152146D3825338AD99B58C4D,127,129,2,0.9005235503397743,PASS
FC957326F8995187F321A677682CE148CB97E700ED9AD01299CD3B4EC66DCFBD,122,134,12,0.4532547047537365,PASS
890AFDC2111A3981746B78743A4A799D1EA3C405BEA38652816A03A9639206DB,140,116,24,0.13361440253771617,PASS
DFE80113E8E957D8E657E0ED49B50EF8C43144B8283AC8A1099853E125F3BFF6,129,127,2,0.9005235503397743,PASS
8D07713E42C3CBBBD9B583487913A78FDCBE3716D4764C7556828E82F3745607,125,131,6,0.7076604666545525,PASS
EC90F0B105D3DEAF029EFC68B019700B377BDE459615904575C31D1A38847A01,136,120,16,0.31731050786291404,PASS
319CCD284EDBB7B04291AC15B4A7298C7B1546356476E5D85A6CDBCD1AABB637,126,130,4,0.8025873486341526,PASS
9A170747EC6B7AE84CC3667E16C8BD4E7817A19A93233CFF4FE08366F4844BF2,124,132,8,0.6170750774519738,PASS
7EA3B60F6072C744D9E4D1FC55D9BCDE440F106F613DF5200C63E8B8A46F03C3,128,128,0,1.0,PASS
629F982C8E3BC40ADBC19D8CFFE6B8DE1DAC94A9DC7A8F09C09FEC1D28506B8,128,128,0,1.0,PASS
92A0C7CF07F532949B1DC242A791E3E207941628D80F1F93D50A246FAD5C4008,140,116,24,0.13361440253771617,PASS
CFCF5DABC91ABD28E6FF4E14D0095F0EEABBAF146BF695242F12DC6AA02111D3,123,133,10,0.5319710580974012,PASS
736F1BB51969C32A6F16DEBBC101175E19F4697D6313B6A9A228723533E435CE,124,132,8,0.6170750774519738,PASS
92CC083C8CABBDF8E26E98E6EDBE3A5545431A20837BE17F7B1089CB7C33DBD2,124,132,8,0.6170750774519738,PASS
9339DF256E59DF507BE62BD448BCA9C5DDC26169D3FD8F53949A7788A7FCEE94,114,142,28,0.08011831372763423,PASS
65D0C9C124898E6C23036EA2CB9344D60D88BB683AC11F4164C48B7EDAC5C025,142,114,28,0.08011831372763423,PASS
25995C7C365C6FD246B4E55DB8B453E094FFDC045E4A4EFE8F6065DBA279DA61,121,135,14,0.38157390570502125,PASS
1F5426146D07804FF11C1E5A3815AC0D5BD072169CD70BDE5E34AA5AB872DC46,134,122,12,0.4532547047537365,PASS
E4270BB082A14D846051EF3FC77D7C0A7E6FC6C5C0D00653A6C0F62B8D1C6209,136,120,16,0.31731050786291404,PASS
5FFD8B29D7788D94689B90044F3AE121450CA5099F79F165CB98EEBB9F112977,125,131,6,0.7076604666545525,PASS
FDE4DE5D6032F3D647229CA66EC70F001D44FA7C3F4E10683C5DAD4A19AFB2CE,124,132,8,0.6170750774519738,PASS
E6DA070BA957BE699419F8FC4947A458D59C25D7B665D6D4B8994A00C4E97EAA,126,130,4,0.8025873486341526,PASS
860BD33C645DC804D770624624A4545CD148E2FF9A6076FFBBDD9432FC685406,133,123,10,0.5319710580974012,PASS
540C15BAD7068173B9EE91A887EB9ADD9CC7826922F37A218A167D0A86BDC984,132,124,8,0.6170750774519738,PASS
B47BC4C9A28F6192911CDACE15C53C306E3EAC4CF04CBEB99376929FCAD630CC,128,128,0,1.0,PASS
BD9F693BB59C82A8305B307C85D3C7CC39BF9B3B9E6F63881BF89CE6EBCA5E90,117,139,22,0.16913144470267139,PASS
6D0CF5DBADADA1B7AC3F571D48E1E9E81D42AC7E062F5EAAB2741775D07C5EE1,118,138,20,0.2112995473337106,PASS
E39095ECEA566A0E9E45D295E43A4E08EABFD24AB2820C347582FC76B7844813,134,122,12,0.4532547047537365,PASS
8B6FBF93D17EF72B934C8E8792E89BB5870DC5A87B9F7D9CC30C2651C3D95CF6,115,141,26,0.10416255883043901,PASS
7E88CFB54024255C8E398C26871042C3A3F767C0B0558D5D6E1B3AFE90F8167E,132,124,8,0.6170750774519738,PASS
C60CB629DE53CFE1BA4A42F17FF79F2AB8F3DBD58DE39A0D26EEDE0D61EDCD41,113,143,30,0.060792723530522785,PASS
A555423D6D8D7EFB26128AAE11FD00149C03A22C24A16822281BAB05F5C6B7E8,140,116,24,0.13361440253771617,PASS
FA0BF7DB9E2F7086DFDF7BF94630607026A5D102F636399CB956CDA072C8773F,117,139,22,0.16913144470267139,PASS
F7257417705656C5E55B60D485B1CEF0416EB9DB43F173825B61EB15A950809B,129,127,2,0.9005235503397743,PASS
C52B5AB380EBC9BF618BC4D46DA91AF8776D4A3DDF7668AF17136B9759C59CC1,118,138,20,0.2112995473337106,PASS
8E842E819876F2B72F58B4927E85D630C11ABF75358876AAFD293116E6348CA,132,124,8,0.6170750774519738,PASS
8F90B4F54ABBC24A2F062C98B320B776373883E26CFD0F23583199444A3DFE70,131,125,6,0.7076604666545525,PASS
DA39959ADB94FF0D454EAB1839E4CBB2665DCB13389B99E7DFACBEB1F7CB012,118,138,20,0.2112995473337106,PASS
64E2063CF196546D992166BE79F1BD535108B7640418EF98FF8093A2B5848D5C,133,123,10,0.5319710580974012,PASS
C1A673B4135BF1186BD552EA57FBB564E1774D6D24981388128FC6FFEA02D87E,123,133,10,0.5319710580974012,PASS
80158701FCE486BE1AF17DEF8BAAC2773E7122221640FD7C87C8DD479076C252,131,125,6,0.7076604666545525,PASS
169C863CB60DCFF5170F61562A226D81236638161CA0B6237C7FBEAB234C998E,132,124,8,0.6170750774519738,PASS
F80959B927EA330D03AA7832026AE4A672C0F13878CA30C940608CDB8D6CCF02,143,113,30,0.060792723530522785,PASS
7FAB7C11EA25000027D027C3868BAB080AF078196DB11CBC182C5447E8AC8AB4,144,112,32,0.04550026389635853,PASS
8493AF1B68F1C21ED62608A12E60352D19EE014642617BB2055A5934EE91DB5E,138,118,20,0.2112995473337106,PASS
8DC99CAD5CFD4CBE1A0B2F582212CA045E063F2E479E363A849AE98042E90695,137,119,18,0.2605890342736178,PASS
CCBC3787A59EB7F28EB748BB110F312D161A32284BCC8496AE9A052AC42184,141,115,26,0.10416255883043901,PASS
599DECA941A3EFE1CF1BD255209397D87D38B40F068506B7C275ADC4795823C1,129,127,2,0.9005235503397743,PASS
6F14FC50A978D61D66C2F986FA9F3F46AA28DFEFFEB172124A89289533F8C684,122,134,12,0.4532547047537365,PASS
CF7FC4FE763264FBB618A2DC892BB7850C452C078490B1E3977823AA89AD9DDE,125,131,6,0.7076604666545525,PASS
5154D70EDFC0118268B4385AD89C2AC330A1B4902902FF79814B3770EA96979D,138,118,20,0.2112995473337106,PASS
ACE6491496480A64620F6B590BF6A22AF0F0CFBDB8AF428B2DF4B118DADBA768,130,126,4,0.8025873486341526,PASS
E739213B00B2603662E244898CD222DDBEA1BB2C36529D99BAA49ABCFDA03A9F,132,124,8,0.6170750774519738,PASS
EC879647438C09CB8819606277FE71CE12255566D15D9FC8E117BF1EEB8C90B7,127,129,2,0.9005235503397743,PASS
5F0CEA466F5BB37788B08EA086CBCCC46E65933454B18802E84B8FA36045807E,137,119,18,0.2605890342736178,PASS
3F149EF03E632277689E9BC502DCE63FEBF1D8948FC7C09CDA8A8FD649B99EDF,116,140,24,0.13361440253771617,PASS
638BD72B71DCB2B3E3791E17E32BC2F73CB338AF9CAEFD9CDB08D6A1829EDC8,117,139,22,0.16913144470267139,PASS
D4503CDC07C2F2ECE8CC0A43C3F363088AC81327C4E144E208C497A223C5D6E4,143,113,30,0.060792723530522785,PASS
BC6676D223A9F41A8F8C758D679FDC18F894D69738A0DBC81BC54BA38C94BD97,123,133,10,0.5319710580974012,PASS
87F8A6569B30279E64394C104026FD171746F77085612AB216C0992704537E9D,138,118,20,0.2112995473337106,PASS
D0055A45502FBE8B0E5E2CDF47F684B30E0B11FBF0A73767E9DCE37B675C6125,122,134,12,0.4532547047537365,PASS
DFDC8759CE9D35252C1C54BA943249A8188FD7360CDC785A83952088C027F9C0,137,119,18,0.2605890342736178,PASS
F9E5F63C5C6D319B8E6F37A63574A95E465692E5C04486FB330767854A8F79D3,120,136,16,0.31731050786291404,PASS
6E69510CD252333C1F76B70D42ECE9A8C94D50F4393C68EE499FC330BD37549C,128,128,0,1.0,PASS
E43508309B55A7FF98E41B51D2BC64262281B3928F2742E812C356026857581A,142,114,28,0.08011831372763423,PASS
30DB9C34C4F4C2780DA44FE06484F530A5ECE7D0C8003B183910E2237A0D9163,144,112,32,0.04550026389635853,PASS
31DE7E7DDF19452E65371F9B9036659234992F42E90024DD33C3B68DEAD4B211,127,129,2,0.9005235503397743,PASS
52D0A0495554571682E07D7FD2284AF82987B45EF7EB82549E6164E8DFD325E8,130,126,4,0.8025873486341526,PASS
97733C3D9BF674EF8F26C637BABA58FB3D1EDD423B11BF3991B4BE17C9253355,111,145,34,0.03358661289689768,PASS
670D66F054494C7FB1A06EDAD98A32B442F7929509374D01CAE1A4D8BC9E6B7C,130,126,4,0.8025873486341526,PASS
C79599A5A01E9EDB996E0A5AD9405ABAA35E81D32BAD73D351AA38CC79280DFA,127,129,2,0.9005235503397743,PASS
86F259C0417F245188D4A121986A0103A800515D83D54A4173C30F6F974C5A0,152,104,48,0.0026997960632601987,FAIL
EC3ACA2A14250CC6EBC3451CF5C760D4096A4E1D5372C2E82DBBC90A5E145609,138,118,20,0.2112995473337106,PASS
CFC0B3B6D84546601CA4DD0C8144AFB1AB6C2A4DA6F59834162559F497F5C915,133,123,10,0.5319710580974012,PASS
F7156668E9675A8C8805EC4341BBD3476F03693E400F289B8B622F299719B76,133,123,10,0.5319710580974012,PASS
295206C1156601F8640CD9BEFF7B69027EF38630BA37F59934F530BEEA5E3FDF,120,136,16,0.31731050786291404,PASS
8C09454E3C848D520C646EB558DDB402DBAE04FF2E8990D514A9771CE4A125F0,139,117,22,0.16913144470267139,PASS
E2F15FBB35E009D55459AD375D2599ED14ADCABF4E4DE4BCCD8EE108A5F12056,123,133,10,0.5319710580974012,PASS
12AC97722D8A6C245EA08CB9D9C92BBC37CDB339905CF675F81034B6CDFE9F49,124,132,8,0.6170750774519738,PASS
D15B90C3FFE601AFFFFE4B5A04621BAE3D32FF2F920B0ABF07892F920092CFD9,121,135,14,0.38157390570502125,PASS
A1C4A052CEBB815C30E72781F05C3A89862CE6940AA859E498889150ED0BECEB,142,114,28,0.08011831372763423,PASS
CE8FF5BE8F47F67FB674B3BE2D52D3BB283C7CB4AEBC1D92A6B7303720C60E3E,112,144,32,0.04550026389635853,PASS
DF37ED5973B0D93655078E775F203392E5C01D77B451D4045C6256905560B723,129,127,2,0.9005235503397743,PASS
42C36E26F02B1AEC9FC8A5B5969DD90B09350B95796EACBA31F44EE8FCFCE292,124,132,8,0.6170750774519738,PASS
3668D67EADC494E83EB18B5A8701A90E786AD56C7DBC0EB94793860CE86EEF79,124,132,8,0.6170750774519738,PASS
F8796B2E35B4E532AC8A8798B68540A84F2579947786C35DAE3F9CA2E11A133F,127,129,2,0.9005235503397743,PASS
D253ED310A16DBDCBF0F4FA5D6505D48D9E9346DFF757F0A47619359110CDC0D,122,134,12,0.4532547047537365,PASS
10FDC2D177BBECF201B912A004C808271DCA3DBF3F7C67D577205FE2B967AC12,126,130,4,0.8025873486341526,PASS
7893337AC0E4457F5E7C64DFD9CC51DA57FECCEA3668570C776CA1E225CC3455,120,136,16,0.31731050786291404,PASS
44CE8319BD4DD95B645436721587C7E903DA9A5AC7084876B12DC0A832BDA50A,136,120,16,0.31731050786291404,PASS
35F3676EE439A67BEEA55A78D24D589540BF90CB31A793E42470575D13FABA16,122,134,12,0.4532547047537365,PASS
217C87C6C9592490BD93665F96C2C6D177476116FA7E3F09A3F5C2EBB2A3E7D4,121,135,14,0.38157390570502125,PASS
A61920030368B891F632434E70C77518347FDD62F140DC6EC66AED68BCE1855A,135,121,14,0.38157390570502125,PASS
D919607A45D4E114F7FA791D32900424040459A1E8BF25870F09E0DFB4643FAA,138,118,20,0.2112995473337106,PASS
BBBA936ECB496CD0DDDB7A9E70425AEFFCF718CFB08DD52102FB78BAB2CE88D2,116,140,24,0.13361440253771617,PASS
9C9BBA7FFBF7428A857926271DF658A3B128B887B5CBD4DCB47AC37BD5F64022,118,138,20,0.2112995473337106,PASS
BC4906BD5CAF26BE35908040ACB613D21911EDED2299BBB4676EE7E3A1B7C538,127,129,2,0.9005235503397743,PASS
3086F89F8231A04953461424EC9F659B9B82A7FA758EB1B2E6B00F5C9BA725C3,131,125,6,0.7076604666545525,PASS
1222A13412BA11AA4651542ACBC30CF10B57C05730753F6EECBE1CC5B51218F3,139,117,22,0.16913144470267139,PASS
E16C27C25F0439876C2A87AA660A5CD376E443420316740BE5C9B0DA6D97092,140,116,24,0.13361440253771617,PASS
7417F564D3FE7BD6E9353DB7CA5E7DA6DC7EA4A88B2E65EFDA8071A1C252A31,117,139,22,0.16913144470267139,PASS
34235F1DAED2F32D11B106E46E84200175276C2620835DAD1042ED8F15CBFE1F,136,120,16,0.31731050786291404,PASS
BE2BFDE70931BDEE8EF7DB7FC8955AC11B61F3CC67B0DEA5528232341A8C9B17,117,139,22,0.16913144470267139,PASS
B174F9028920A29C5B4771753398BCBEE4E7A436789A243BE904C555EFC0E88,134,122,12,0.4532547047537365,PASS
1C7B90E410EB7E6C06BB4893FCDFE9BF8E0781E0DD0D46B6787D044E3D47CC89,125,131,6,0.7076604666545525,PASS
EC0014A87055D8826A0F75EAA8A904B5E668CAC471BE5745E2859882AEBE4913,140,116,24,0.13361440253771617,PASS
49470B4B75CFC783A53758A568D804C16F20ED0E3335E4F4901378507A11D479,136,120,16,0.31731050786291404,PASS
2A61FD4795540D8E68A45EA9379DBE72F423018725ECEDFFB6E0D6D341AD8D47,122,134,12,0.4532547047537365,PASS
E23D819B3DC851AD571A494608BAE7E4A90D69B5271A216490791B44F38EF172,134,122,12,0.4532547047537365,PASS
8E7F70FF0FA5935DA2AFEB1F72B298C0493816AE7BEC55471B0100F09025F7C4,127,129,2,0.9005235503397743,PASS
49441644E579A103B6F5AF7FD85624FE06020C250A10DA0221178D6EDA0F9D7B,138,118,20,0.2112995473337106,PASS
A9B8F919041641665CD7C65B3810B2DD78D32FD53E401975516DD18AAB07895,135,121,14,0.38157390570502125,PASS
84D874C79EF10B8178FBF72EB6B1352B6F2911A3BAEADCEC53C5EF5433C04FA9,119,137,18,0.2605890342736178,PASS
BB76820340ACE7D757E7AE3D7FAC579353876D3045560129DAB5945B77C0AFF3,119,137,18,0.2605890342736178,PASS
209FE95DCBF6FB1FA64DAD7EE293BE9B7A5CB3517CC6F84B0D7EEB4AD06B9023,112,144,32,0.04550026389635853,PASS
D8EF7BB6E5E8E62AD9738CCA8113D933CE1178A1B4E3AB1D47C73EF94D48BB2E,118,138,20,0.2112995473337106,PASS
26BB8612C764AEA082C5AA166D5ECF135BD852C070AAF01F664689707CEB8DA8,134,122,12,0.4532547047537365,PASS
9A59C6538A75AD0850202207F234328571270C680D040DFAEF6DF06F83A09DA0,144,112,32,0.04550026389635853,PASS
A356D88D37A0F6EAE53EC697DDA9675A68EBAB230663FC29FABDDFA75E431358,114,142,28,0.08011831372763423,PASS
D7D62976B79CEE277B20AAA174D1920C0DA3B95D5B0E4D0F1DE18A472BA96C25,127,129,2,0.9005235503397743,PASS
324CC51EF10E75F2BEEB6937D84805057807FA40FEC104E6AAE799A153BB87FC,126,130,4,0.8025873486341526,PASS
BD9EE85434A617EB0C176A1ECD666C05BAD5692D9A6079E7902E992D4B6B731C,126,130,4,0.8025873486341526,PASS
2F23FA8E6C56B8E2F6B8ED1CAD468C29E13553102E8D8A38FC2F76FD9F491B8D,122,134,12,0.4532547047537365,PASS
774F27160EBA1A89FC1EDD21ACECC2DC06DC5EA622549E804353D5B84B4C46FB,129,127,2,0.9005235503397743,PASS
A2614273FAE0BB23B1A3AD83A143ED60F8B8A7AEFAAE09DD68D1D9DD83A06C75,125,131,6,0.7076604666545525,PASS
A158ABC1303C01FDD2DC9035B35DB33F5FA7E2F7C4CE368B5297EB11EAE9012D,123,133,10,0.5319710580974012,PASS
83FEC4F44C6114AFF68E92F0AC2350C28AC635E0FF1EFB6EB3480246CEF835E6,127,129,2,0.9005235503397743,PASS
61274720EE869D8D2E2C09F6053BFD571335B3940C0EB4806418F16D213549A5,139,117,22,0.16913144470267139,PASS
BB532CDE1C4D9E2B713173F833210F140E9655C6E486BD981090795516919C15,136,120,16,0.31731050786291404,PASS
189AF9EA13AE5E8E5592487F39B9BA08CEA08EA2C30630422030BB5AE3D7171D,135,121,14,0.38157390570502125,PASS
BC25158F56809C0F82D287C0A977B7FEDCCD66FE15E468568F453DA636ED7F21,121,135,14,0.38157390570502125,PASS
3FADC5BF7FE95DD48484C00ADAD0FEEFF56DF55F20B6008A1C445FDBA79EDE9B,113,143,30,0.060792723530522785,PASS
B29C8226C2634B8EC5B4F5679DB18B449555D3E753C769E1EC2EEC4961B2F444,127,129,2,0.9005235503397743,PASS
43668C01712D35F26196B4839D5AD21E0A83CC3748F9050C424246B958A076A3,145,111,34,0.03358661289689768,PASS
71E1BE364165C77862F1B1F5DBAE6371F3859AF418EDEBE3FA0C97B384B9BA77,113,143,30,0.060792723530522785,PASS
41BCD19F82839D9FB2962ECF771F4CA8F86E5CF0AC6B4B7C912AB8EB88198B58,124,132,8,0.6170750774519738,PASS
A319F0F4EFA630BB1662DB697E9066FD90A3C695D73C45A4F1C8E9CBCCF94422,124,132,8,0.6170750774519738,PASS
FF29FEB02B7DEEC1F1D305BB609B2BA7EB924754E694C825C4EBC654C8158A00,127,129,2,0.9005235503397743,PASS
6A59F1EAF51A6352B3EE2B287013FA62CE13F650179EEC0E861067C2B0EA2E47,129,127,2,0.9005235503397743,PASS
85D4A18CCCE1076873D174C02191E341771B1DBD772F630839AD861487B11C7B,135,121,14,0.38157390570502125,PASS
36C597F88BADEB0BDED15ACC6D85052018238DA4EC8BBC657311C28149BD765F,129,127,2,0.9005235503397743,PASS
B5C2345C5EC0CFDEE652B7A0FDF6B07D546B35320AD6A64FD715179C0CA94402,127,129,2,0.9005235503397743,PASS
91F8DA2C6B03914904FE16916D65A8C0EA1F7149E43ABB7A2DBCDC5CEBAC4996,128,128,0,1.0,PASS
7776BF12FFE56AFC6476922ABC76AD27EE4349D383274066A8CB16713F682174,121,135,14,0.38157390570502125,PASS
5D7275EAEDD9BC744539167355532D1F548D2824D2EE327A6002EB5E6A8FA287,126,130,4,0.8025873486341526,PASS
70756DC99F1FB082F7E34998BB73D9B65E23BFCB934F110CE416113379A55844,124,132,8,0.6170750774519738,PASS
B1458279963940B197E264F0E004DB1CA697920DB96F492853923EEAC4D09881,141,115,26,0.10416255883043901,PASS
9B9FC8942BD54C50D3212386853843FFBCD17C1CAB602C935F351113789138BF,132,124,8,0.6170750774519738,PASS
65AD249425B7DAE8D9D05E3778C8F45BB7B0C5F5482EDB73AAA34875BF237362,120,136,16,0.31731050786291404,PASS
76C352026A095B9F406D509DF92EDAF0149DE2014508DE63E3BDFE28B456435C,133,123,10,0.5319710580974012,PASS
74494127B76B3F8AF198983488F88C35084FDB38079C1B388A8076DFAEE1001C,138,118,20,0.2112995473337106,PASS
BBC150E31A9D415E9688BDC4B616A7807E6E5D5E242CD0E3359D12DAFAE54119,130,126,4,0.8025873486341526,PASS
6C0EDEC8A6D31F6C699CD01454CFE625BE41C912C49571492838D1543334D25E,136,120,16,0.31731050786291404,PASS
D3445BDAABE62CF87767DEE6EE9238F51561054E5C6EB3D8E7EB1A99C28C052E,120,136,16,0.31731050786291404,PASS
C5A6793DB7A08F7D7A5ADE52426AE16BCDA2E3605D769437094D1215407C2AB0,130,126,4,0.8025873486341526,PASS
C297D4391A9D5414784D988D5D5C2602C446C7D785DC64A21970A2FEDEA6323C,135,121,14,0.38157390570502125,PASS
968AECE42C8567D29A8D7986F6B36C935BBE4780B315731260401604030D9FA7,136,120,16,0.31731050786291404,PASS
2B6C9B9766FC30290A93A000BF1472B1D9CB2B6622804C8A7DB08AD78A1D40A3,141,115,26,0.10416255883043901,PASS
618140AC254C3F4D9444B931CB8A21970A2449E79EF8F869C87CB75AF2D5519D,134,122,12,0.4532547047537365,PASS
4D1EC21E4DE5C4C5ABBC8C24F7C651EBA1E920E6268623EC7091451D8FA51B54,133,123,10,0.5319710580974012,PASS
C3D34FB2C7B770BABB5C5EF443576FCC5F5C9932807425DF8842907084F8F9A9,123,133,10,0.5319710580974012,PASS
3D0914649E1E3F358141798C1456CDC403DE8BCC6E3FA98A901742A21175E213,140,116,24,0.13361440253771617,PASS
2940D8B13551253CE74E782E77A014F9AC17D752CCF2C29EA7B26FA3A3E07BC2,127,129,2,0.9005235503397743,PASS
A4725C8E0B07857771C4B12D6502950400F827EFA001F018136B1361586C2D35,147,109,38,0.01754895019147673,PASS
A51F500BC562F9A38F764B30F9C55D098C5F79671F68C40650330A6E78FA058A,132,124,8,0.6170750774519738,PASS
C46C718C22B68B89FA2AB90E4836950C6A4E7CED998E2099E5C3CCBD35D9A8CF,130,126,4,0.8025873486341526,PASS
B7B8AD268C75C2A4247C95AC7C3A266890945E461C727FD172C02C05B38210CE,139,117,22,0.16913144470267139,PASS
36C5B0C9EFCCC733A654EBAAAAD86A982FB5A80AB9A0DC736ADCC5E6344716F0,125,131,6,0.7076604666545525,PASS
51A9FA9BA43A2E40CC1F5AB69C6DE2F85613415396A8CA3AB162F1FDF4BC7390,126,130,4,0.8025873486341526,PASS
F5AFA82133CDF8CA861510B4E6FC2CD9457DAF183C7466DB4E6D1A3A868BC44D,126,130,4,0.8025873486341526,PASS
1A79D682CA8E275B26B7847275F89B64DF914381154AD9867F94A0E63468CEA8,131,125,6,0.7076604666545525,PASS
3A1DDA5ABE0DD261CA0B56AF34DBF8791BD1F7755B1AEA608DE0929CC54FBFB2,118,138,20,0.2112995473337106,PASS
8D4B518EC3CAF6B64E979596A4028CE3A1EABFE2F7CD40B8A4CC0C6285281C3B,132,124,8,0.6170750774519738,PASS
51888CD8CBC6C57143F17A2F0C43B23498F74541F70B3169970669064639B2A4,138,118,20,0.2112995473337106,PASS
84A0DF4E1E5AECF78ACDF2058A1F5AA3630B92DF83A5BAEF3911CBEB0B706B09,124,132,8,0.6170750774519738,PASS
F71D6AA080C5ECA3CA083784FA1F32E8DFE5501FE7809554099C0AAD27AC5C1,136,120,16,0.31731050786291404,PASS
57C1AF76005B4F7F32454BD10852381A30BEBFB6C48C16D564B75515858BE4D1,131,125,6,0.7076604666545525,PASS
E59E08D234341FE6BE4DB741D16B2C9E38BCA4C393300F6913176CACCE8AA6DD,128,128,0,1.0,PASS
1F454BB7E0BD954398583BA45152BF014B6AB7BA76703CA1DE50DFB449D2A4B4,127,129,2,0.9005235503397743,PASS
5968C48FC9E1F791C735A7B2DA28FF6D3CCE8985B143A740E974793D10E770E1,124,132,8,0.6170750774519738,PASS
1ACBA68AB033CF4498DB179C694108657692F5B8737460A54C96F966407A0F10,137,119,18,0.2605890342736178,PASS
9056A95507752281689F1DE1C58D9CF68216A7DCA0F457D36A9FD83551D78C76,128,128,0,1.0,PASS
685E1A27F9D7E33042B6E489DB84CB801685DCF1C41706BF67F4101EBF68C906,131,125,6,0.7076604666545525,PASS
34F2D155E3DA44F9065D1B9ED21D811D3A6862C7C59F76A28B9A2C9AAC92E7AF,125,131,6,0.7076604666545525,PASS
D1FC6B33A3956C69324492377D1097C57E14316203604BF01F1B4097700FDAAA,135,121,14,0.38157390570502125,PASS
63524798C3A0BDF84DBEF490B87DCEBC0F510CBF2527D7BE94C06B7EFD424976,120,136,16,0.31731050786291404,PASS
2CB42B1F3B0F4BF2B8F9BA47204AC764A691E8B6D89AF9219E4A37AF3495823D,126,130,4,0.8025873486341526,PASS
32D4BC9F1950FB44A6E87F40241481CC0529ED4986F2843429BC4DD33134A537,139,117,22,0.16913144470267139,PASS
BB4DCAFBB2420B8B2F8468779E68B60B806E6EABDA3F89F88944E92D3EB6359E,122,134,12,0.4532547047537365,PASS
7FC7E9ABFDE9373D405D22016CFFE5A1187F0ECD8E9A4E55B17FBD14120E728C,119,137,18,0.2605890342736178,PASS
710BB6184253EFE310BAD9E0F73ED49BC1A846BD396D4CBA9374259E7EBCF318,122,134,12,0.4532547047537365,PASS
3C9E4095AB2DCB31320D60055911026DDE8FC0C23A56B90FAD45EB310CFC99AC,137,119,18,0.2605890342736178,PASS
D3C060BC8E370D52CB986A7E57880D5F4B06AC7CDB4A3AB1EB9694D51161FECE,126,130,4,0.8025873486341526,PASS
B4CED3EF0FFD08AAF3EA295E296565B6355399D58177FA9C37115E1E4F884580,122,134,12,0.4532547047537365,PASS
27F1A937A46285CAFB9CBFD94D4EB6B866F06BF2B048B72A0F1E8E30E91EADA,123,133,10,0.5319710580974012,PASS
ABA5E387F07D328D6F05074C68062D29D79693AB623C152CA26748F0166E92C4,135,121,14,0.38157390570502125,PASS
CD4AA38141794688CD12AEF79C9661C498D8C47E36A4BCAB59E3DAE2C2A2AF19,131,125,6,0.7076604666545525,PASS
73D66FA1ADC07322A74981CF15F43AF0D9FFD653FCA34D48AA22FA78DDA25715,120,136,16,0.31731050786291404,PASS
64D5E2A6D08C81394CA94FAA98E29877E02FB98023CDC0E1CC9222C4B9E261BE,138,118,20,0.2112995473337106,PASS
9D4209AB105CABFE60CE8C44A1D854BD46AE8FEEE8F37FD1AFB0C536940766CE,125,131,6,0.7076604666545525,PASS
1F9B842B0231CDBECC7A9DB86CFE6736B281DED7C2E35B4BDA548C74189E16CF,121,135,14,0.38157390570502125,PASS
E83DEA19ACACCDE0055F1EB46A4CEE41A543E6CAE338EBF686BEF75D83ABCF5,119,137,18,0.2605890342736178,PASS
B58DE477553DD7A033E5C8806AEC2AB417CE408BF12EBFE859F5BAD08A7B715B,121,135,14,0.38157390570502125,PASS
AEE64C3CABC7397B4DC7F0C34CC3348459A1D86AF3889F4A9A9D6A21CEB6805C,128,128,0,1.0,PASS
6D29C33F7428D33384457CCE1EABF7750CAADBF29D1D1FAAF3A8F30CC07C7DDB,116,140,24,0.13361440253771617,PASS
78CCD3A459AED6AE09466FB62FE0EEEC5E987EF35FBAA662AA94F57224016CE5,119,137,18,0.2605890342736178,PASS
2E7DF0883F16A51554D7F9EDC8E52057AF0C06E32EEA7DDFD07BFA6BE4E7C9E3,113,143,30,0.060792723530522785,PASS
4A34FC55C5EC937BAE0C01F3FBFCED722C285ED80ECD2CE1B5D43FBA44D17,126,130,4,0.8025873486341526,PASS
3740299C6606ECD251B3934734D6E80760712E5A2A52D829014F8572C2D22AAF,141,115,26,0.10416255883043901,PASS
FEFABAC233C8B18ACCA16C74ADC38CA814FC57558DDA94642E32A52EE7C588BE,126,130,4,0.8025873486341526,PASS
CD2E7B2DD2743E03835CD4982D009ACFEB809EC29C438AF7F513B850FA697E17,127,129,2,0.9005235503397743,PASS
CA4A16046AE549E5D62CB070759886C396437D3623F49F54206FFFC54172D17,133,123,10,0.5319710580974012,PASS
5F145736CE18754013E688EC539F83AE1C955F3970C656356DB2C0F4B832CF4E,128,128,0,1.0,PASS
25EA73195D1BFB488349494433244766962F4AC6898B7E5124B44E44E5128F92,138,118,20,0.2112995473337106,PASS
D2A2CCE4A9DEEF0074C7E5FCC7026A8CBA51387831BA7987F390B3BACF01C898,128,128,0,1.0,PASS
AB5131D6895FE4E88467793FA4FF3E32ADB29892154C23FAA2D1D33917651662,126,130,4,0.8025873486341526,PASS
EAA06FC8E48252AC9BE220DFFFBE980B11BF065C32DD167C539B54A07A9506D9,128,128,0,1.0,PASS
29D126931868F83006B73817C1C31D3845C86272F89B7EB6206231810EE7B5DB,138,118,20,0.2112995473337106,PASS
EFEE564673B5F3353C5266DA1969E0545A9D52B33F0D871C7531D4174ABD6D93,120,136,16,0.31731050786291404,PASS
1183AC6117FE060F68761B95284495DC2AF47B602A305B98EA5D39E14842E07A,139,117,22,0.16913144470267139,PASS
8FDE7133C83FDE1E4CBDC72D02097203950453CC9A06169713F4735B21D58F5D,129,127,2,0.9005235503397743,PASS
5313CAAF7931128E2BC29B1C2DCE416A732F3D5C0144559D449366E15DEFF1D3,128,128,0,1.0,PASS
E90C3D60F28AD1E83847C74BC1A483E0B79CFB0218FDAE75C7A0B551A13C4C27,132,124,8,0.6170750774519738,PASS
DD21981079459181159C9EFA8063E018A593CA3292F08EDDF474DB5D3F0C102C,139,117,22,0.16913144470267139,PASS
53ABCC841ABCAA0D2A1071038B652429B27F6CB5014EA11BC1C6A19712A9E657,140,116,24,0.13361440253771617,PASS
DF25758188DC26495D7DF067BE5AAD829DFC10569332AD2D446A6FDD658EAF40,124,132,8,0.6170750774519738,PASS
8485940E90A8B015DDD53D24928683AA36686A8C5B7A1FCAD5FE094DC7B7D811,135,121,14,0.38157390570502125,PASS
6AF7307D0237A0ADB0CDCEF8009F148DF013C56414BC38C68065D21EAD34B1DB,135,121,14,0.38157390570502125,PASS
BF579B5C2D6EB488D49769AC611E2019EF2B317EB7206978CB7CF98584B6C07E,123,133,10,0.5319710580974012,PASS
3F4D470751378290DF2472F91E14B69C85B2C95DC879B69F906E3A4F8F8BF711,124,132,8,0.6170750774519738,PASS
1F22BA25B06DC32BA87DF1F24ACBCEE0CD9B1355C851E88BBDBDC7775378E5E7,117,139,22,0.16913144470267139,PASS
E94832B1632D30E12307406B65EAD7C932021344253C8A74A1B0B5F4EBA29445,143,113,30,0.060792723530522785,PASS
BA8C40BBEEA16A469926210B9AAA78CC199D4A095903C4019B6D3C59EBB8D3DB,135,121,14,0.38157390570502125,PASS
FDCE7CAEBAEEA5D9960D902964B0939F30F94EA2820DCD53D1F6344DF6D47B4C,121,135,14,0.38157390570502125,PASS
E75DD96C2081BCF1BDBB9BAAACCB8A9A8E29E5CB7CB504ADD86003FE3FECF6D5,116,140,24,0.13361440253771617,PASS
A1D3BCB2392E97F5D8F28891F31A8E6247DBC4BA8A75F84C150DB7E3645BB7F2,120,136,16,0.31731050786291404,PASS
67A63016FE59A022CBB5CD607B511A257B10594D61B1A4ECA546EFFBD50A8A8,133,123,10,0.5319710580974012,PASS
815C1C3DD95475EE919097996AB1FB3D85847443CAC88B07BA34FC11816D80FE,132,124,8,0.6170750774519738,PASS
406D10227503C5305E20AB7B1D9E161085B4F915251134000EB18F5700840A1E,155,101,54,0.0007381569085501356,FAIL
24AA4641F7CC1780F9D0BAB192BF0813BEF2E8CFD5438C95EE99C0BC8527C800,134,122,12,0.4532547047537365,PASS
5A225CD220456CAB6B0B4BD499CB517AC877AC8DDC0EEFFA3104E19B4F404EDC,130,126,4,0.8025873486341526,PASS
70483AE06A85B59FA1C3F939C61493737E7E8B08D758E9472A70FE63433A9556,127,129,2,0.9005235503397743,PASS
439B79A82E04B0E84590CA75878DEF85B400F4ADD11C77DB1462C9176ECC1A6F,132,124,8,0.6170750774519738,PASS
3996EC286D6E307C0591DFC75C08B7E72F38C69DA29FB420A855F2EBD9DB2BCD,121,135,14,0.38157390570502125,PASS
FE0210CAB580638AB8A5DBB70C96D566B2F4A299BC5720B6CB49864DBBBCD88E,129,127,2,0.9005235503397743,PASS
B52B1912F47EA07FDE2B9B4A97921CD41CD3BA254BB78FD0BD904641F7AC5763,122,134,12,0.4532547047537365,PASS
64AEE28478DB30CF41765B3644EEF89BD8DD8A2EA229C90DBB2A9DE28934E308,130,126,4,0.8025873486341526,PASS
915797449B412B891075393B241B844039A346BAA381FDB27FAAC45FE206291F,136,120,16,0.31731050786291404,PASS
BD8F641637C115ABF324717D912D69871DB7843597D0C0130E16BB646BD13EC2,129,127,2,0.9005235503397743,PASS
2B3AC47087489A2F9E20D5D03767534DC86EC42AADBFFD2689DFE5BC554529BC,124,132,8,0.6170750774519738,PASS
C9A9586E78FA2203A9798B40148DA363B4CC84C0E4091F27FE5230CA5CDDDC5D,135,121,14,0.38157390570502125,PASS
6969EAE284639A1AF1B9781E88FEAFE64FCF62D9C8579ED6823AABC73E978D9C,117,139,22,0.16913144470267139,PASS
5789FC5BC2029152DD9CF714AB4FA5F24B19E82A5B3D40BF593B5242430C6C20,133,123,10,0.5319710580974012,PASS
8DFBB7E173BF0D76B844B0718EBD94216E598FC41E141B0B7C1D29B307109567,127,129,2,0.9005235503397743,PASS
10F925151D362754964E39957EEC544DAB81AEDE9046A59FF70C663BB68C5E1D,126,130,4,0.8025873486341526,PASS
63F77068E9BC02D9C955352540A30E47F57C7A0091C373838DA3EA518B6052,140,116,24,0.13361440253771617,PASS
18DB6309B5F327D3DEEBF0314F8BA8F2292E81A81F0158E31A8F89E407C38ED4,130,126,4,0.8025873486341526,PASS
198346B3E007F5D1BA2F1F0EFD8B77FD96FDE0D1CB6DC1E8062B65F100A14339,124,132,8,0.6170750774519738,PASS
678BB3BA2643CA58A996200D40DE54AD3688F01E80D31242014ADA4940E68193,149,107,42,0.008664896726025117,FAIL
388188FF6E09439F8612F046CFBD28089C8CDF78591DA581F7F8AD305F970B8E,129,127,2,0.9005235503397743,PASS
1342750B523AB2EAEBCF7E97D21104E46BB1CA95B472B5C674972866B34A2FF3,125,131,6,0.7076604666545525,PASS
88E0740DBEB640E0A86031530A5818BD76ADF1B21B7969D23D957C22DC88C6EA,136,120,16,0.31731050786291404,PASS
DD0AD4EF0D785B3C6A36A97929EC8B9E3A140F22195F63266329C6E46AC8218,134,122,12,0.4532547047537365,PASS
88458CC8FFDA660857920B5918B22C760F22186D806565F57EA8DA7BB129D35E,133,123,10,0.5319710580974012,PASS
A8A923F1A53E0DE35A3FA48C252286FC0A2020BF80A64F31CE285EBFA6459D66,135,121,14,0.38157390570502125,PASS
3DB54080E41F8ECA6A377D5FF30BF433EB60C35C105ECB3084F58104AB1F140F,132,124,8,0.6170750774519738,PASS
444BDAFF7E4D2F8181972111C2A0E5A036274E43C0492C594BC8F309B1DE0B83,139,117,22,0.16913144470267139,PASS
D1472944DE7CAF9B5A183278F953CB53FA94B2913A509FE455513CAEA746782B,125,131,6,0.7076604666545525,PASS
F2D3CEDD8FFE74EFBD2A0B1746BEA546C4941711C5A0D834026FCEA5A14A2E1F,124,132,8,0.6170750774519738,PASS
3A6D39F370E9B6FDE460B6DA3F4082A3342D50907A189E9CCB2600C66B5625D5,132,124,8,0.6170750774519738,PASS
AE3971C1CCD688E2CB9BB927B330391B796FD954B2FF6A1AB9B79A44AA06DABC,120,136,16,0.31731050786291404,PASS
CAF5718D4CF0C19D7DF9CC0D8275DB6F5A9EEFB2F42AC8A67AC4943DA54F4089,121,135,14,0.38157390570502125,PASS
F55C156585937961883A10E7CF980B85308C9198ED5E203604D74C50B8800D87,145,111,34,0.03358661289689768,PASS
C6877EE5AADD6EA631A02947A5621ACEB02F1BA27618FD2BCBFD7320E2C973AF,121,135,14,0.38157390570502125,PASS
999D08396F4865692211E6CD427257B41798462C76688646ED3D9C6BAA60D3ED,133,123,10,0.5319710580974012,PASS
9588643F72E3AAEF7CFC5347FFD87279C6796F6FE326E2CD416C434B73637F2B,110,146,36,0.024448945310089426,PASS
5770BC6B4F7D39B4DF5155D28D501B80E593C0E14A553FF34DCECD331841614C,128,128,0,1.0,PASS
4CEC5A8C1BA0FBB77674A36781FF9DA8FDEAB4E8D8EF64B97A21BF12CF37B9CC,111,145,34,0.03358661289689768,PASS
9D50973D7A2CE7BAA955D9D4BE6B137C8D91BA05001EA11C6442A0DAFD3F0B50,130,126,4,0.8025873486341526,PASS
B9BA963BE2345DEB54CB18204905A984D20D6CD9223F0280EB2A8BFF77A410A8,137,119,18,0.2605890342736178,PASS
7BC1497BEBD9B79614CE1A3E1CD84CFE62E1B01A938A67E6F38DD60C928B9060,127,129,2,0.9005235503397743,PASS
54948D1D9559D785DD855CE3849933423AA7B70BD70CBAFBBDE2FFE2691D19AA,120,136,16,0.31731050786291404,PASS
1483D950896646C27B611DD248F371AE6780D30679479C9735324EDAAEB214D4,135,121,14,0.38157390570502125,PASS
7977F5497680E4526D288C4F98CA3D0A67C93399E1A1727539846F4207EAFFC6,127,129,2,0.9005235503397743,PASS
65C90786B3CE2403F98A498F0F4F5014EA2E6579519C3813A40EEB73A69D1412,137,119,18,0.2605890342736178,PASS
FD291E41872545482EA91140863899C8BFF7192AB30EE76D74AF4450B3906B87,135,121,14,0.38157390570502125,PASS
60676761F98229ECF2D23182D6CE0A08A87C400EBFBA07CDFCCDF29D15711A46,132,124,8,0.6170750774519738,PASS
209A171642727A606493EB6A01347D07ADDF815489C7A1B1A65CFE14E0421A6D,139,117,22,0.16913144470267139,PASS
631E70E782D1BCB646136F1D3674B3156995776145D5EE3FE3F593310560642B,125,131,6,0.7076604666545525,PASS
42541ABEC037A8E5A3F10BC51D7665484654EF06892D25F8C888A3CEBC21FC7B,133,123,10,0.5319710580974012,PASS
BAA8621419945EDCCCAED8B2D3C6291D151D21216B4F2A82DB8824BC5B8A28BA,138,118,20,0.2112995473337106,PASS
F506F2EAD9AA21D7F69559FAD9374E1CC85EE02EAA32710B1030F67CFF0949E3,123,133,10,0.5319710580974012,PASS
9453506EE809FD7B9DAEE01A65B7B50AF7378E74645F88E8CB26BC6F0D4F3616,121,135,14,0.38157390570502125,PASS
3B227552C64ACFD3EC6BB34A0EDE69A0636FBB799DF9AC386DBA1AAF80C462E4,121,135,14,0.38157390570502125,PASS
68C0F2044FD7E7D18A33189A681028F7D8D7256C8F47E36829E54EE3AED67643,129,127,2,0.9005235503397743,PASS
7098DB7409C248D9F5AEA0F3375CDADC3BD1544BE80D1EEDEE3E0EDCE3AB66A6,120,136,16,0.31731050786291404,PASS
4525CEEC09DC618DD23F56BE46FE8DEFEC6E24B3014D42E948253C78474E01F4,129,127,2,0.9005235503397743,PASS
C7ED987BE4EBD69A4CF46B696BD9551D6CC214F5968F67D3E7A4F50D0A3E7ECA,113,143,30,0.060792723530522785,PASS
5751EB3FAB0B849B38110167B7A9DF28AA953191EB44840A65CDC5E9FDFE0535,127,129,2,0.9005235503397743,PASS
9FB9322DCEE2E3C55CE25B250E84B4589DCFFF9DC46A72BB78DF7D114226B1F9,117,139,22,0.16913144470267139,PASS
19C4219E6477144FDB1125B87B6E5168CD5F7D4FC1576B2630E96EE649A70F37,123,133,10,0.5319710580974012,PASS
1AD96B79156E8B9C3109782C5F0D73347C97BE383293C7DAEB5DF231586A1E9F,121,135,14,0.38157390570502125,PASS
F60EFA1AA34502C3365BF85C5ABC564F083218F22A033D8FB28392E73EA8339F,130,126,4,0.8025873486341526,PASS
7A42AA3918837AEFDCFEA63BD79C4434CCBD6D1BBBA19B4CB757B90CE64868D7,118,138,20,0.2112995473337106,PASS
3252B72AD1688C64BA7FBFE272C6DFC4E80376C21123DE4FB224493FC899C9B8,127,129,2,0.9005235503397743,PASS
B613D1C87254D67BDE0661032C62E12843FF9705153AA30C83A2BD31905C8463,140,116,24,0.13361440253771617,PASS
A024F95B8C53767351730B2A0F1C0CA9FF8926ECA803AA3A9D91E867F234E22C,133,123,10,0.5319710580974012,PASS
C9683AB979669E4C62681A63602F92EB66F4DE026C3815FC4CF747939F0101C5,132,124,8,0.6170750774519738,PASS
68775B19552E3D091428C002DA0488886C8405A51EF3518CB59D731F9AD7056A,143,113,30,0.060792723530522785,PASS
7676161A11E07E6A949A249082306845E9740B03627394ABE0CA9CD997C31B3B,140,116,24,0.13361440253771617,PASS
4C4B5726AC31E7D942170F9AB34CD95B8FE238CC4225872EA9C3626D967CDE35,127,129,2,0.9005235503397743,PASS
9509E2703B3814F8E2C84B61A2446140A2B0A0D5DBBE5CC4C16FCCF3B889F001,142,114,28,0.08011831372763423,PASS
B0F375D6F5794E581163E9A1D7B74B59DD97F402284A6BCA5CC2DF4D74918DC8,122,134,12,0.4532547047537365,PASS
161264C226D1FE957D9B53A45FF88D08A1F0E132A7C7A1F0A198E7498AA52A8D,133,123,10,0.5319710580974012,PASS
E27DB2A90E1F05D3074BC0331C7E894338884A7D48BBA82FF453A67CDD218D18,133,123,10,0.5319710580974012,PASS
86DA9DDCA6ABE2540666D974E3EBB90C3965DFECC9226D45D515805D2B90B3EB,124,132,8,0.6170750774519738,PASS
E65574A75D9868A79C7131BE152FBE94351D581FF138926B2717BAA3DD5214E2,124,132,8,0.6170750774519738,PASS
217BEA473A6D67E62F122D3C2CD8E9D51412B8765EA5032A5A21E512FF9231D9,129,127,2,0.9005235503397743,PASS
604BC3ABAD6DDAE39ACBB8337340507447E505E75A70EB7A89F11EB8370826F7,125,131,6,0.7076604666545525,PASS
EF9ED99565B68D286BFD5AE1FB764EE6EC34EB87AA9A364D8838DF59DD79448C,113,143,30,0.060792723530522785,PASS
96F9D177A2FBA15E1EB9FEFF34845434774483FA2BBDC92BCA9F3A64BE2F3210,116,140,24,0.13361440253771617,PASS
EE01058520F2B63B8555EC229F02A900C28A17FEFEEB0930A21FE63723CF23E9,134,122,12,0.4532547047537365,PASS
D1C9A84356F8802AA07F69AB99051788A42B9323715639C89E41EDF414575575,136,120,16,0.31731050786291404,PASS
735CA996A46977EC64AF6C2F94C1F70CCBF869880C4F84380954A37C144472B5,133,123,10,0.5319710580974012,PASS
9B8B45641390BF8505B489AC9BE4D66269770B6458790B384F662F7DE3B8BE89,128,128,0,1.0,PASS
ADA7B1D16EB1D205414CC443F974A90B5A3719CEFB5372ACFFD6C13F8A020650,129,127,2,0.9005235503397743,PASS
C55FBA1EA14A658FAC0F9CA87660E6C1E2EE091D08AA7C1BED545E8CB75161F8,128,128,0,1.0,PASS
A7F1D8683FB4CBC2B0E96A9C6D12AB636F2A3699C169A186E436E786563D31FB,123,133,10,0.5319710580974012,PASS
89BC320CD654095A5B21BF7DD0F2907B88C3C378103C9E03BEBCC48593F04C65,135,121,14,0.38157390570502125,PASS
21056F6783B27AFAF1CA0B538E24DB4C1CCD86F8647FA7C62B8D069A37C1151D,128,128,0,1.0,PASS
7AF1FCE2583262791A225CCD69442A0E270971E059C30E6F38DDBE3A57087522,134,122,12,0.4532547047537365,PASS
32466597DB8FA159FC55F3F6DDD8B7AE0F0B2E63A686536213AAC69C6A766E79,117,139,22,0.16913144470267139,PASS
33D61F2898875DF3C91FB5144D2B7BA98809A47A402859A245466780F8B66675,135,121,14,0.38157390570502125,PASS
5F775F8337FF4D6CFB4098B58B8BE9DBB466E8F982FDAC37EBE127E004B5896C,113,143,30,0.060792723530522785,PASS
9F8250170CC62503B717467E70C82985C8EFA9D6932A0BF5FD0DAC5819E85C56,133,123,10,0.5319710580974012,PASS
4C7AB531F50FEB53F9B57A8429BAF066B373D3A66569F9C57AEAF3EB94416CE1,114,142,28,0.08011831372763423,PASS
B9F02D79E2C29A75E42115E426BB58FF818BD480976F92EB7812F97E46B617E1,124,132,8,0.6170750774519738,PASS
40EACA5D85C90F49B37DA7F6C0CBA4544F3B3A9BFAF30E0C00A237B17D5A62F5,125,131,6,0.7076604666545525,PASS
AC02FF7FB74DFE3C4DB1EFD375595CE71E67C50EDF379DA571F13DA72876EDF3,101,155,54,0.0007381569085501356,FAIL
BF45E175BEBC5E7731DA8D9C2D2A55BD93D542A9DD57A84DB5EF1493055671C5,117,139,22,0.16913144470267139,PASS
ABAF55A2D48D325B96DEC1C5C593B65AEAE58F29914828A555AC24C3F4CE2929,129,127,2,0.9005235503397743,PASS
D7BC76970ABAA06B1D631C1A14CE91A8FDFFD3FE5D402FC61020CE28F89FAA0B,125,131,6,0.7076604666545525,PASS
E526D0DB4004912165598CA12653052EC67BF4EAAE3376C3C2190816D68B7836,140,116,24,0.13361440253771617,PASS
3305C0DECA75179D5C8651414BEF6FEB31271B549DBA65C63CEABF549298D678,123,133,10,0.5319710580974012,PASS
B9FCD0712B967E231FF31D16056AE2EA6B3A6EFA50961986995ADD252E7D2E2A,122,134,12,0.4532547047537365,PASS
F422CE65FFA83841A2FAD2B4C1F7C675AFB3FCF4233FC74FB5CB896D273A7F9D,109,147,38,0.01754895019147673,PASS
2AC016276645F3471257B6C595A434098AFA89D2D7C1F7A3B400B72C199BAD16,134,122,12,0.4532547047537365,PASS
C69DBE28082ECEB878257A4C43E6337BBFF836FB9C525EABE59EE2E62CFCC2E,118,138,20,0.2112995473337106,PASS
A80FA80A7E0C3217D44858164114511FB22A8886F5CE91D9A8CF7BB7237A4C8F,137,119,18,0.2605890342736178,PASS
AC1B05FAAE83D217D67969BC3EE6D69DBC5CA57DC098CC9E99FC3945D60F2F67,116,140,24,0.13361440253771617,PASS
F1E1B79D70EC4A42A65BB59A981E3A1AD4EF0694F3B2670BA738E5B4D275E306,124,132,8,0.6170750774519738,PASS
95842233C5ED81BF474FB012DB25AAAD2E3D1F76A2A6944631A4F36BFF99AF19,123,133,10,0.5319710580974012,PASS
EDF0028F33D64BD8F9D3DFB79F16EACC96C755B0BC5DDAD5B06F7148A1D87C6F,112,144,32,0.04550026389635853,PASS
E56A4D132CCD739B87E7BAF187BEF90504298DEC8E2C5ED3BF7DF16DF134F0D3,114,142,28,0.08011831372763423,PASS
650C72FEB45F0EC8F98C5173D1D036AEA7CE5176C72A7102153F3B5F79F955F5,118,138,20,0.2112995473337106,PASS
5B847BCFCA9C0EA7D8FB69327436BE089B94D1660C2519992CBE57264CBD0B71,127,129,2,0.9005235503397743,PASS
FB5CE14475AE2C43DD5EDE15141907A0146CFFE01BF108C7E950999F723C778,129,127,2,0.9005235503397743,PASS
3923C17D491A77CCEC187B603276B1650AD485A3725568C0C3B5C5D2B6A4A05D,135,121,14,0.38157390570502125,PASS
D6A0D7B85012887165B9A80A6B62EE95F47351CC536C2EAE04694F4A33A6DC6A,133,123,10,0.5319710580974012,PASS
E252A0808C876DA5E9EBF1D68055D70DA000A55DE79590DAD708C1799B9218DF,135,121,14,0.38157390570502125,PASS
2AAAFB1C5DDEF228242E42AD20331B24E00B716C0B1C9FE00B499C409BBA0F9B,138,118,20,0.2112995473337106,PASS
A1C37CE02C13EFAC4C579EF6ECCA7D7CB310EBD63B501D98ED0EC539DF4AF3EE,115,141,26,0.10416255883043901,PASS
8F2DBF0F01DA5267BD8A8F4C19EC3E0C2A0807BF173FB336B884B9D5133A6154,128,128,0,1.0,PASS
F87415B152DD37E1A95E5DA6A80BC497801E6265573874F9F45B534A65153635,128,128,0,1.0,PASS
A820BF0F6D804B15FA28D8592FE5158EA8554D9A3412C99A8C63174BE26C40C1,140,116,24,0.13361440253771617,PASS
E44F779F972E35E94DB83875545408EA46344E253418D1C9708C562EE79A0FB7,129,127,2,0.9005235503397743,PASS
CE94849482394819FAFFAA46EB8E3C85E253BD3EDB41F4B354F8460B1FCE29B6,125,131,6,0.7076604666545525,PASS
8C1FFE1AC11C22B7FA5CD7FAF71EE974CF95C349FCA80EBB1CAECD1016EFB199,115,141,26,0.10416255883043901,PASS
CB6FADC9B2B90AE2D4959596DF8173869B07F8A15B7FDC4283E622F7D269A0DA,121,135,14,0.38157390570502125,PASS
FCE194AD828938EB7E06F4142C752C2073F50D45053B06FC8214E4BA283EFA9E,134,122,12,0.4532547047537365,PASS
B44493DA5CC0652E7F8554B422C41C6DD517F6978324C2BFA580C8354659D826,136,120,16,0.31731050786291404,PASS
84F55DC01029A8C8421E2568EF20ED880BDEDDDB193D80B08177D48E04921F44,143,113,30,0.060792723530522785,PASS
3EE723C1CED04D6ACDA32FBDD8833005830ADC557C4D711F198E6B54C8328C08,135,121,14,0.38157390570502125,PASS
F52B38AE7740589F4168946CCB195A77263CD06E1D2E66FC4D00BE18062D4F26,133,123,10,0.5319710580974012,PASS
7BC284680647C0A688AD851FAB00E0731AE0E4D34AE546837D796F2A3E991029,140,116,24,0.13361440253771617,PASS
3F456A0C8DC47D8AAB7ED546CCBFB71A2EF8242E411790F4425285B7E525B13A,128,128,0,1.0,PASS
CE5DEE6829CB2D8B1BF9A4709F5051B932F0DB71C2803A30F4D54A7058E6D503,131,125,6,0.7076604666545525,PASS
5504354E13678EDB4173956E75DC9F4EA98349811B83EA39AD6F8EFC8912D0FF,124,132,8,0.6170750774519738,PASS
C95EE6D4C6B68FCD66471630546A39B418ECE8EF52EA25EFD75F25F0EF592C1C,119,137,18,0.2605890342736178,PASS
E103DE4803EADEB103949B87366AAF6962ECAEEAAE2A74D5CB193E2FB51E0733,124,132,8,0.6170750774519738,PASS
9FEBE433F379BA21B8F51560BE6A2DB9EE64A1D611B9DA7F84796025BE85B3D1,118,138,20,0.2112995473337106,PASS
2DFA995041905069D167D0AF5E28C06336AEC8A925BDB48AFF2D2FF37DDE3E94,124,132,8,0.6170750774519738,PASS
384EA0E5CC8F79DA93BCE983F4B3C54AEE57E10173AA976926FCFAA445C4AC7D,121,135,14,0.38157390570502125,PASS
C253D0080E72BD906B9A3D2FBED5186874D03F8E7ECD545ABDA914EE32757769,124,132,8,0.6170750774519738,PASS
E6EA2D66D4C19DDA3A7BF1A5EC1E5E17F30F656AE089FC8B23CEC839FE4FD1EA,114,142,28,0.08011831372763423,PASS
356896D61E4B4D6E9CF75FA685AEB37976D5194052442DC5CF83BBC839FE64ED,119,137,18,0.2605890342736178,PASS
70C36F0D349CA083D4B962068D6D4227DFB9FF97AED13A012C05A014AD100B49,139,117,22,0.16913144470267139,PASS
5FFE11DBE34DD6C81DC859F4F8927773F3F100FEBA8892E16E129D05325BC7FF,116,140,24,0.13361440253771617,PASS
61A2BE7E3F40955C5EE5E89DC4DDEE1FF879CFC151D32666700ED05AE5AFF852,118,138,20,0.2112995473337106,PASS
F01CE647CF7A89F62B12ACB33AD315A9AA6FCE3BC07F933FE63F0C675743960C,118,138,20,0.2112995473337106,PASS
50135C7D9395EA10516584E4D7911FA64746D4958A096587AD167D36ACF01D96,134,122,12,0.4532547047537365,PASS
460B63D3D280D001A1F083FA737BB51825D93BD353315CFAAC60634B8B6916D4,134,122,12,0.4532547047537365,PASS
99B164433E7EA875B2FC88DCB107938492E3388D54BDBE6B47DEED95586CAF7C,120,136,16,0.31731050786291404,PASS
4281EF04661FD4EE887564F6C7B777C179D2F54E2B792F3E8BC37FA6FF8588F9,113,143,30,0.060792723530522785,PASS
8A7FAD3589B5A0DE4D3F3C183C2E7371DDA91C6E08DA8C7CE4FADAB1672AC2B,123,133,10,0.5319710580974012,PASS
833C0AFE5863690D5C0E2B4889F5BA8D23E2413DB510324DB2B7F37EDA0BDB38,129,127,2,0.9005235503397743,PASS
950C68DAC839B2B1EECCEF6FC8109479BBDE77B5CF39599F0EFD6AC84D18E13D,117,139,22,0.16913144470267139,PASS
BFC2829481CB6FA668DDCDE9D835A0B98B56840354E45693F4A52B9BC7792E69,127,129,2,0.9005235503397743,PASS
80FBCD320AEC5A406E277F995184CBDF043A5D78A662BF58DBCD1313254D6E88,129,127,2,0.9005235503397743,PASS
968D736D8276EBA69BFA93CF862AA8377B183DD00F441723E2736FE5755E66CE,118,138,20,0.2112995473337106,PASS
C09D6FC506121556F0DF7C6A2F8A71BB8FC18E3A50512FE01F853167A0BDC22B,130,126,4,0.8025873486341526,PASS
1683F5E9A82C939F2EAAB7F485B8A35123A334B52E53817184281EE5231CDFF5,129,127,2,0.9005235503397743,PASS
857A3671917A0F6FDB5078143B082175A9315AD905DD66CC6D09E5B015029C66,136,120,16,0.31731050786291404,PASS
68B6231C9EF0445205D554DC0BFEC25F855DB08A6010C5F8D2BDB0F1D06AEFB0,133,123,10,0.5319710580974012,PASS
6181EC11CBE0F057B24A6ADDAF59BDA59F1A5B3C4D1BBC96E1DF7E7B9083ACF2,118,138,20,0.2112995473337106,PASS
58A5C0BEA409299957DD2B9434133B2A331290300BC0977A1C7653E850325A8E,143,113,30,0.060792723530522785,PASS
34AC935D1935432488841B7292170D3F07F9CD909F4578588B0F49BD5510FEDC,134,122,12,0.4532547047537365,PASS
781E76A89BE8E5A18418811D698DCD8E0A9BFE744D2DF91612D48FDB66E29BD4,127,129,2,0.9005235503397743,PASS
4EA33B3B2530BD824C60DC10E79EB125CEB039FD5A2B4F4961F2F249F93A33DF,124,132,8,0.6170750774519738,PASS
5DD034F397B37363359BD01625A8BE05A77936299920102526C195D59661811A,138,118,20,0.2112995473337106,PASS
8A4CF44B1C3F27EE8A0AAE8A8B6CFF7512DBB34C07B6A85DEAC403757A09D105,128,128,0,1.0,PASS
D33D6FB631B18237B49EDC83B2856E2D74297CAC5AC4EE18A5D8FD8B7CFF1A75,117,139,22,0.16913144470267139,PASS
68EA9367173DD684B625F0BC43A0D67E654048257E090CF775EFDCEE4BE369D0,124,132,8,0.6170750774519738,PASS
DD5DC43C6D1DAD0819A78C0A3C0A416C78E274D8337A9C37CBAA37F603A05E2F,130,126,4,0.8025873486341526,PASS
6D2F1D71BF50D2CB6B66148570FCD0B4512224FFC9E27790BDE50F5C30CFCBDA,122,134,12,0.4532547047537365,PASS
CAD46A4BE089016E54F13291BD7BC34E776E9EFF01C5F93C702378A289157004,132,124,8,0.6170750774519738,PASS
B7BDE2925A87CACF63B972B3498E0312B85E5D8AC050E2E081A552D1631F8A20,136,120,16,0.31731050786291404,PASS
1DA07F3445F993D5F9DFFEB662377A49F94046905D47DBABD6E0A5FC5504ED4D,116,140,24,0.13361440253771617,PASS
2DA3C50AD8F45D85EF18A3CB56485D700172C8CC9348D806342858AD363610BD,141,115,26,0.10416255883043901,PASS
BE53414E02C5D9A4C78281D8A3509C832B64CFCA9D0599045C4F8975190E8AF3,140,116,24,0.13361440253771617,PASS
C9C66BBC0D7862BB287816F9DBEEB87F58DDA28389F34517CCE3B2C856BE322E,120,136,16,0.31731050786291404,PASS
C60D60EC79C8C1F121275CDF704119874EB621F368079A230F6E8023F6281F0B,138,118,20,0.2112995473337106,PASS
DD2BBBCB08576B1B0729D48E1469CAF05BFB234A6A2368FFE71D7D895B2A0D4,125,131,6,0.7076604666545525,PASS
75F084759E863D51FC790F1BFD0B1FCD8FC6735AC6A0EBCC831431E6F62F0866,122,134,12,0.4532547047537365,PASS
52C08719F4A0C6DBF965495C25A681F782BF71AB4ED69E7153D7FD26AAC7B121,123,133,10,0.5319710580974012,PASS
B1881BD00F156B2933E724799FBB3E0FE88E6AC330DEFD87642E72A35F885DF,123,133,10,0.5319710580974012,PASS
7B5568C1E79A842D8C9F31B19D5D0FA6241239FDEDDEAE9B068BA0B59627A9A,126,130,4,0.8025873486341526,PASS
96355230F539A3B50E4D4E0B7CAE42AC524EA4D8B5A31E1B3A5E73EDA7E9501A,128,128,0,1.0,PASS
86A963CDE0FC60265386CB9A850DF1B5E986EAC08CAB96C907439CEAADB0959A,132,124,8,0.6170750774519738,PASS
B4FBF819A7F037BDC2D6BD423ED17C234A4609A54ABE838A452857A96151E0BE,128,128,0,1.0,PASS
AC0EECB474545C37F9A01FCF68087E5456D856BA7DBB12A299A1C01B5FE7504A,128,128,0,1.0,PASS
2920FF5AEC5F27AE207EE459FF83295B4C66D328FF667EDF1A687B5CB9602BA,118,138,20,0.2112995473337106,PASS
B8890C0A53B3832E2C0CA5B3F752E1202548E6A1881E6E91E71B1DCE5AE7AF58,135,121,14,0.38157390570502125,PASS
5E5B8707A2790EA698FF3314847A711A3EEAB642C5D8EFFFE78C755C0FFFB933,114,142,28,0.08011831372763423,PASS
B5702152BB6273812D5B254CA0147102F9C938BAD96AE942B1F6A27B73A8AF3C,132,124,8,0.6170750774519738,PASS
A0EC6E0570CE02619A520AF25B7AD8AEEA6180C0AEE5020B5F131E0C5FAB26C4,140,116,24,0.13361440253771617,PASS
AA3D60949FE24DE77DB3C9923AEDA9E635B7643CD7910A5684AF67ED51D133B7,117,139,22,0.16913144470267139,PASS
3C16C37F3E69B2FA9545D6E8DB4ECD395023C416595EB15A24D820A613FA5E84,129,127,2,0.9005235503397743,PASS
1E53D225B4FB7BEE43F6301BCEA8B28A7D37FC2C14CC4230E93A6561BEF31834,125,131,6,0.7076604666545525,PASS
DEEFA5DD01D06C868DCEE3E0334C9D4177F16217925BF30DAA02C004A8EF7452,131,125,6,0.7076604666545525,PASS
2BF410CA7846B1AC9A2F8EBA8A0B9AA7AA8C75E52C44AF7D486B671D2013AA22,134,122,12,0.4532547047537365,PASS
384EC9AA6AA547DAC15FBFC2D264F0FCB2F9BCA67842C8B402E7174F7D57C7F3,118,138,20,0.2112995473337106,PASS
46B0E6B7032ACDE43A742462BCC30B4F2E6D401F772439E37571D8434105271,138,118,20,0.2112995473337106,PASS
517E515C8A2131A095AC86D7B90407B7091B37FA07EDDB6A0170C2F82B124ED5,135,121,14,0.38157390570502125,PASS
748A70ABA17732CBE9341BE52FF46936A1FBB2E1C58B60382416F87637CDA6BC,124,132,8,0.6170750774519738,PASS
81788EB19049B72D3CA30BBB26BE95B813BD77523D37D401F50ABE95CAD3A980,128,128,0,1.0,PASS
3E7D3426E821DEE7DA6E134F6BA9FD4180F3F0D8ABE852CA7374E83D949EE0EF,118,138,20,0.2112995473337106,PASS
58E324888EB4F2A0951299E9E9B87BAEF7864D72EAC160698EDCE739F6E58876,125,131,6,0.7076604666545525,PASS
EBB9D218DA516F9005FFB7AFAC2C9180DE95201C0D4B96544F21F5DD26DBB5FD,122,134,12,0.4532547047537365,PASS
331A5E2EE68AAAC282F46199E624E8A053A4B1BFE2693F3DCB8D0007C9143D9A,134,122,12,0.4532547047537365,PASS
C8BA80CD2EB7C2F2CF63BDF173275992370460705BAF17A7E983309AAD42AA6F,125,131,6,0.7076604666545525,PASS
4ACB7201F6EE84ECF2743CE39287AC6007CA255F0DCB80823917B44DA29048D9,138,118,20,0.2112995473337106,PASS
502C65BF398A18E2AF81A7ADEC5DCA2C91AF94D93E518937F9FBB0BED8ABAEA8,120,136,16,0.31731050786291404,PASS
11A3C3D8B6BF6DB83FEB75288F85D01C5992070F6EBF45FE75ED212054E15418,126,130,4,0.8025873486341526,PASS
6EC2BB778212C9144B4DBB8B0461C60D2892BD813018C4E04B35145A1995EC3F,142,114,28,0.08011831372763423,PASS
3C06ED701BCFE7DBE6394C6B3A81706A64C482B0CDD55C7F44FEB8B1F6D6D6A6,120,136,16,0.31731050786291404,PASS
56CF96129290025258B7C8CAC256DE53CDCFD81AE400C8CB857013CB2B3ED40A,139,117,22,0.16913144470267139,PASS
57BB48A28DC1CEB1D1FE0E7117D080627A9AA96BD3FADB72BADF74B7F0C67C64,118,138,20,0.2112995473337106,PASS
398985988B9C966C1F00C0D976EA2E0124924B4FE92FDF0C76ADFDBC2757D445,129,127,2,0.9005235503397743,PASS
55A952D72532E1548DE8FA5091875A2E4D9D89886B9C6ABC0D1AC5EE8213E216,135,121,14,0.38157390570502125,PASS
D20112D054488BAB1125B32FCA65958E8E4C63D03A4881A4CCD822637CED4AFF,140,116,24,0.13361440253771617,PASS
F3FD07B13BFA315D8E24FA557D625F179A8ED2E58D3B002A9C7498345EFA0F79,119,137,18,0.2605890342736178,PASS
D5C2708005BFAF6E7F06E0CFD3E9D13D77C71D125F0EE0A8D75A970226D8C1D2,125,131,6,0.7076604666545525,PASS
665158CDC2DD921987DB0BFD2B6EE7D3DE034136CB22D90D0C4665CB4996329E,128,128,0,1.0,PASS
88B3961B8D50F47FED5C976F3C9E80B3D9DA3DD04523E495D2227CE944358517,126,130,4,0.8025873486341526,PASS
83E1A1AA80A9C510026AA28DC304D26B19A2840179069103FC72DD14FA59CB8C,149,107,42,0.008664896726025117,FAIL
8CBA4053734FC492B994D995BD0E22D950964D80B149979C248021B2C820ABDC,144,112,32,0.04550026389635853,PASS
8598D3C802D9216BF64097A8361AD446156977EA1CCDCEFD08406E85ABB186EC,135,121,14,0.38157390570502125,PASS
EE525AAF18459055EA1466C7F713B89806C58C37DD6526F64F055ED110A78345,132,124,8,0.6170750774519738,PASS
708F2588CD8D2AC17FB39E1B95109BE8ABC10A7B6D897568E191BE69ACD0F1FD,125,131,6,0.7076604666545525,PASS
F301CA9F3560A672AB72910212F3AD0DA86408EB01C48AFC1BE2C2F020B9E1AF,139,117,22,0.16913144470267139,PASS
61FFCC5E07930E310100C9332689E92BE92747A642CF51DF67A951528BF6A6EE,129,127,2,0.9005235503397743,PASS
4F640F48190CEB053AA63DD238B6F17E17F39C09FB5159AB76398AC493B9F0E6,125,131,6,0.7076604666545525,PASS
E5E74ADDD287C0FA4A143668328D58A872E857162C81944E42CB006306C69BE9,140,116,24,0.13361440253771617,PASS
C9D82BC3820203662BDE4341E68CC746EBA5FA3FAD724253EFFB9DCFD6710F02,124,132,8,0.6170750774519738,PASS
B084F87F574E00BA16E3413085220E38C30E0D3A5491E8581D69321D393D99A8,144,112,32,0.04550026389635853,PASS
18EB7EB7721C78C3A1171892D89D5CF6E76BAE5D116AD3A42A6E4F50A324F6E6,123,133,10,0.5319710580974012,PASS
46CF2EB471B0FF08F75996650FE3D29AA9F22C02B80DB61AE90A8E959C7709BD,126,130,4,0.8025873486341526,PASS
A49F0885D53F42FCD6587FCC825138FA7FF20B817A6209531A48C1B632776420,134,122,12,0.4532547047537365,PASS
DC4592B9056C0BEADD2BCD723F4DB0D010A1494241FF24FB9E997766CEEF4EA1,125,131,6,0.7076604666545525,PASS
30B3D4A21678569D573AE7991072845FD25A02660C0745537872FFD1754C936A,133,123,10,0.5319710580974012,PASS
995471BEE3ED6F2A4BED0DD3F362C92F9AB1C4316A13CD3E24DA9CB892A0AAAF,122,134,12,0.4532547047537365,PASS
525E9E930FCAFD73C87A0A81D13A988E128C4207A49CAC16F21A89C6934CAA6,140,116,24,0.13361440253771617,PASS
23819D6CDA5DA802F81F334E2E801B204078A1A16BFCB6E6924EEC17BA3A289C,137,119,18,0.2605890342736178,PASS
AC710D6D131A411C98F2D0FE26B21EBD7DDE81B8FA2687A6139FFD3491BE5A4D,123,133,10,0.5319710580974012,PASS
6E095EF7445930284658DEDF3B6F439B037C2F4CE999269188EDCDBBD23261F0,126,130,4,0.8025873486341526,PASS
E8B545A724EFAE2BF2992F58B8ADFB22E546B818C4AC23316C3314CDB9C7651D,126,130,4,0.8025873486341526,PASS
1C6BAB27DEA1BC4F785C1C88E688B348E6DFF786B1CCE18B1F96BCAAA3E2019D,123,133,10,0.5319710580974012,PASS
327DF8D0864AD839D736E1B21754E857E7B69D778DDCC57495F517A7DA8EC633,116,140,24,0.13361440253771617,PASS
732AB87C469B56ED0E93B1539AB612B694A28E8713B5C8083E8ABED5CE3E8BDD,125,131,6,0.7076604666545525,PASS
266E5654B65223E1D6560EFBAC1F72B5AB1FD5B81948AE0BB6D011AFC98129C6,128,128,0,1.0,PASS
233EE5FE5DBF7C280A685EA8AA776B78295539366522B10FE882CD9C5E00E82C,129,127,2,0.9005235503397743,PASS
8247155F91C24FFF8A55085919D9E5E12938E57D73464956EF426B167953274B,127,129,2,0.9005235503397743,PASS
9D66FCD5F777CE2592A4693111877289E3500F09C03388040F4F15908A3E7696,136,120,16,0.31731050786291404,PASS
9FA9DDBDCD6E8D8C8401E41095AE42D703D0637CE770502B72B1ACF037D71C9D,128,128,0,1.0,PASS
31EF6AE8FDD3647B0C0B24DE22DC7775D4B4EE8A900BCE1390895F177B6C5B71,122,134,12,0.4532547047537365,PASS
1925C8CE433492DDA517853AC4AF2ECCF0941A63DEF47036785055D352D9795D,130,126,4,0.8025873486341526,PASS
905F1F8439F75470932776F2F0FC5598EB70D1E19EEF58579E93B02B901C4480,128,128,0,1.0,PASS
1E8D73368CB0F2A72560331F92A3AF3E2EE5370912884266E5F2B103F8E3A07A,132,124,8,0.6170750774519738,PASS
743CE372DFAEF230746F7A24E04C22BACDD77EF1613ECE1F2BF7F06ED5B4A4EE,112,144,32,0.04550026389635853,PASS
54635E2590777F61EC59F1F27AE89A700A1EF983F4CB34303115EEC0E4F5110E,129,127,2,0.9005235503397743,PASS
B8460FBD3E47A0D8879E1B75186AE87103E69ECD18503D67C42F4D22719F5137,129,127,2,0.9005235503397743,PASS
476A109C5D892607C4629FC753861B725522C73185A030725A02D79858E44A37,143,113,30,0.060792723530522785,PASS
C4EC5338D43EB0DD486F0F09DAB52DE6D1B3594603AE46AC86CC3843C0F697B6,129,127,2,0.9005235503397743,PASS
B7001AC77756E593B85BB9471F4B1B2482F8F1D226B86B8FB81FF26E4912F745,123,133,10,0.5319710580974012,PASS
CC518DDD8F298D6A288CE04A9FE7EF2ACB80E7FB64DFD13F148E547ED493A73B,118,138,20,0.2112995473337106,PASS
5D5B4DA8817404900201C294DEE4671A816C080A54BBA99F086B0B724ADB585B,146,110,36,0.024448945310089426,PASS
2FC83549155D85E7E2209824CBF8456A6AB6B73BFD8283EC480F9CD334982D6D,130,126,4,0.8025873486341526,PASS
2C9401A7249E4F88B3F068794004129563524316FBB30207078B407B2526449B,149,107,42,0.008664896726025117,FAIL
BA6762A948323A1EB9356D186F58CEC609BD7A36CCB6DC6B8BA88B05AF545645,127,129,2,0.9005235503397743,PASS
DACFEEFD140DAB830B34B038EDA4D15ED22B443F87A825B5E24F581E69829B39,127,129,2,0.9005235503397743,PASS
745B8E8D111FE6CAC9507A14AF7154406BA6D9CDFD9CC2D7376250405ADDED67,125,131,6,0.7076604666545525,PASS
A4374F79DCBC0AE912F84C96682F353A2E5161377CDA6224448AC2FB17855896,132,124,8,0.6170750774519738,PASS
67C49739327CC36B13A9E6F64A58EFCDCF528F5C929BE0841BA9988F1AA893DE,123,133,10,0.5319710580974012,PASS
45BFDB47157941BB83644FD5586D8E81A06A78998201E80E7CA3107A2887BB3A,135,121,14,0.38157390570502125,PASS
73567237BFFB2B21134FE0CE3DEB8A7B3E1D6523486446290B32C8D7889B2C1B,126,130,4,0.8025873486341526,PASS
B0FFAEBA9012C6FC3DC277C5660A4A1873C154D034A2677C382DA861DE1E503A,133,123,10,0.5319710580974012,PASS
756DECF76F3564F3F8DC2D2BFAC0DED541A0B1A9BB29A837D9D9FE6A9732E905,113,143,30,0.060792723530522785,PASS
2324FF2DDC49AAFABF42C4753C6BB56941245E7AC23FB6261A39B2BA814EF3C,125,131,6,0.7076604666545525,PASS
483211756D832614D7E44466705432497086FC11578A8E3CD9D358509B3667CA,140,116,24,0.13361440253771617,PASS
D33818CC7791E749E399A30494A88E9E096901442362367372D09231AF8D92A1,142,114,28,0.08011831372763423,PASS
F6B63E5217CA3EC95815627D87BC65EA26B4D556E589C1B0F248748D5C75CF55,123,133,10,0.5319710580974012,PASS
EFF0402846340B65C2AAEBE6D8F0F154268ED17300633E08DCB2DC4D280148C6,142,114,28,0.08011831372763423,PASS
9E012DDCA03B9721D44A4A01BFDD7D6D6AD959E40C867A00D578BFEEA1033B02,132,124,8,0.6170750774519738,PASS
,256,0,256,1.2777508801076536e-57,FAIL
E752BDF604BDDD356AD97D61EBDB324D6B46D4D33E54BCEEC179BD3DFB5CBDAA,105,151,46,0.0040402749798920095,FAIL
A7D115D805B4A050537811D722C4D7687F10A3579D4935265011B6BB8B7D3DC6,134,122,12,0.4532547047537365,PASS
CA996EB286E56AF1013E6517C26155E6C3CD8F4C244D945A1995A05320741BA,139,117,22,0.16913144470267139,PASS
EB75DD73C666BA6909C90CFB872D6CF8A92A219684F44618D59C179CE9160DD1,128,128,0,1.0,PASS
3748CD3D35212901881B96FCD49DBC8616E421CD345D91188D25BBC5E1DB35,138,118,20,0.2112995473337106,PASS
7664FD7E7EF3E9FC3562FF916DB3469B1A325C3063F99FBB56DE3375993B31B6,106,150,44,0.005959526470109114,FAIL
FFB9D8BD53670CA675DD53C71D3AB53CB9DACC3F14376B81CB36B4190040D1AF,120,136,16,0.31731050786291404,PASS
1199BF739D34E6C822888336FEF0213B688AF4E3B5ED451FFA3C9F59770A4732,123,133,10,0.5319710580974012,PASS
323992A7D9775FDE30BEB9C8D2AEEA8FF5D2249DCBC7B07C74E322BB7C2FAE39,112,144,32,0.04550026389635853,PASS
FC7F2A0BC9D53E530EFC4C34D2F5B1F504A2844F0EB78E38CA44F3DA74FF6A91,121,135,14,0.38157390570502125,PASS
E084F4809B313FBC1CCF99E151502D47397E97EB3D8792C67DB30DC385620091,132,124,8,0.6170750774519738,PASS
45A17F95F33F3D9C1DC84D668D8886E55ED5E392377CF80BF3034221099F2325,127,129,2,0.9005235503397743,PASS
1184730CB78393B85064D948A8E94BFE9B8D8D90B173D5DE67B4503CBCD599FB,126,130,4,0.8025873486341526,PASS
9AD063A4759EC29424852AA3AC3420763877AD0C7B717F55117CED1FAA59A0FA,130,126,4,0.8025873486341526,PASS
39CDE218D6BCA374ABB13599DCBCBE5C68E7EBEC7B5F40E8824F16F519067CC9,119,137,18,0.2605890342736178,PASS
15028693005F0316BBF446366131161CB1F15720669A74DB05C0627CA6CD15B2,143,113,30,0.060792723530522785,PASS
C3AD6DFBDE3BA4159D08A567AC8598647B456DA38447BAE1EACD76AA11C82,132,124,8,0.6170750774519738,PASS
E1D87F92A8D658A54F3BF9C50A7F13F2B7E680AC2033303E0F740866E9A325D9,128,128,0,1.0,PASS
66FEA85139A01886AF7DB00FF99BF279E2C981AC31A588793E40C31CB766D6CC,128,128,0,1.0,PASS
AF682C9BE94B1DF52E7C907994E7FD32F406593704B61FE7CDEF8C1085D48A99,122,134,12,0.4532547047537365,PASS
42DC595C6E345043604D8C2511A90D949700FE56A71B019139FFAB7BB5518136,138,118,20,0.2112995473337106,PASS
29CA6503AFFF9DC81E9C36C355CFD6ACF62CD838E73B03125A1B53BBB9E620F4,121,135,14,0.38157390570502125,PASS
B56FE748F247EC0488FB5994786693A99353B5E4B1300F5B5C2F5E33DB204826,128,128,0,1.0,PASS
866A323A581EFAF5A4621940DB0194503B9BE89BA9BF11AA87EF7D49DB50354B,129,127,2,0.9005235503397743,PASS
D2FB32BEB6F32867B1C1EFBA8C7D62CEFE675E745035578285129F40CCFDD268,118,138,20,0.2112995473337106,PASS
EE5AA98CE8981C514BEF131DB221AA32495C81CC4679DD4011FA47A0BBD3842A,137,119,18,0.2605890342736178,PASS
777362AD3C6D4458AB2E1C74E1274FCC24E9823ACA508DFC2CC5CD3DD191BBB5,126,130,4,0.8025873486341526,PASS
B655D3B4E2D7C7F8ECB97144D2B8F7098DC21398E29620CFE51376A50E5DBE68,123,133,10,0.5319710580974012,PASS
300CDF670268F22DF8D6E86B5E52D515555106ED2D1C534AEF906205B023191D,136,120,16,0.31731050786291404,PASS
44767CD8BF11C5656AE20C8858F630B25A7E755669E9357D664E546A06E79D6F,124,132,8,0.6170750774519738,PASS
2B98B37D3C5EC2BCF6C59015C3EF079D9EB91BFAD4977E64EA67462EB24076E0,119,137,18,0.2605890342736178,PASS
DA4CF9F9F71E54378FF455BFDACAF72385FFD29C663C7053A54364A55805C19A,117,139,22,0.16913144470267139,PASS
D35BE2A6AAFCF7879FCF4D43ECB3BE3D65E59562CA8FBF60CE0C8828E24A9413,119,137,18,0.2605890342736178,PASS
3E6B4C96930CE42F81F288BD0EB3776BA336A44714171A09A5467220E580ED56,136,120,16,0.31731050786291404,PASS
D4691B96F6B8B73649FCB0769B09D10CA604794C2944FA2337F02011C65F997,134,122,12,0.4532547047537365,PASS
1FB856CB19E2EF6C61369B87F416C12368198A9123B897372F178AF38182255C,132,124,8,0.6170750774519738,PASS
911D74E374B5B0A3C0963352AC6AC6F194B6342FE926100ED5D6E96088CF174C,134,122,12,0.4532547047537365,PASS
2C9EB3FAB0C6BA3D7B5130EE80D9D275F9057DA33265E73116AE6A70F5EC34B3,120,136,16,0.31731050786291404,PASS
22A388E298A9D3CD5ED987FD2BD7A43A995973266F6E7E38AA80D6C8B7792997,121,135,14,0.38157390570502125,PASS
621C2E179748489EC054E85A9FDBF19F6C0564BB5BE1C0F4DF5F5ED5B62E9930,123,133,10,0.5319710580974012,PASS
8603583D6827BCAE33994A593E3C6982FF412BDF30BD5A88009D43A14AEB9880,137,119,18,0.2605890342736178,PASS
8020D40AE2454E430DF27BE63A930096949D8F0793C60A7F78E01530F887F6D9,138,118,20,0.2112995473337106,PASS
6A1D4510A3610886BBE3984A292CC0459F0383F522E50D3480AE46ED5F897660,144,112,32,0.04550026389635853,PASS
C542E03208893850624FFA1F648EBCDB08B945594440F52B81AE192E4D7086DE,142,114,28,0.08011831372763423,PASS
936735055D6BF29036D8F51ED3A89FD8909E679B2081BFBBE5DC87FD499ED50,121,135,14,0.38157390570502125,PASS
4329EF7A97A70A7300DBCB8C3642CD793C308A587109D82CE63C201811ABFBA8,137,119,18,0.2605890342736178,PASS
261C382CC2A03F7A06B9C0FF847514B236545217826FCB1C62136FC83529671,140,116,24,0.13361440253771617,PASS
D8D2069FF44AA84C536A30305F641D7A6DE5C0F82BEC5F4DABA4BB45DFE8BBF3,120,136,16,0.31731050786291404,PASS
BDAAF4151EB31264BF84B2FA336002CA75432053489F62D313DECAA31F61E825,133,123,10,0.5319710580974012,PASS
4CFD5EF15C40B6F4E5A68D11CCDFCBB20EBFD8036D019283ED30EBBC9DB6788B,121,135,14,0.38157390570502125,PASS
B7F231DB8D8BC0F807C7E11CF3E9846D8BA835DCAA3E3314A5545E0BC414DBED,125,131,6,0.7076604666545525,PASS
3EEFF110E6F2294ECC3925D1E5C406F5AFD0FC28B76311CF5B4ED6B5FCBCB1A6,117,139,22,0.16913144470267139,PASS
251EE94808A0D534F00E9EB3F3906CACC54D599AA81C00A180F09AF6F7828E79,140,116,24,0.13361440253771617,PASS
3218FC5EE3D8C836895B36962A7B01FBF83B9B1713F4F503564012F724D3B0B5,127,129,2,0.9005235503397743,PASS
39544B3130CD65F493ED3B77814A738A6F7EF84A386E87F08539057A996D396C,125,131,6,0.7076604666545525,PASS
EB270ED37587567394874A45025673B918A3D30E4B0781B540FE6C8A1021D5D6,136,120,16,0.31731050786291404,PASS
9A2B0536F32BB62191DC123067104225EB3C0300C7D210BD06462B59654EC2D7,144,112,32,0.04550026389635853,PASS
6006B88B0B964838238BC6748E16A78DC8D324A79BCE3C49BDDD62B922FD805,137,119,18,0.2605890342736178,PASS
2E9AF0543EE00BB3A5D319B130C241524235CD70009ECA9592201AEE3C3C7617,142,114,28,0.08011831372763423,PASS
C6B0F57AE4BF517D9F7F5B5831E1BF56F7E879B6CC9E6E936F96D67CC436ADC0,106,150,44,0.005959526470109114,FAIL
641D737B46D8039A49E6C09AA2D01FAF80F3164DB25B33B98DBFC6C9A4323D75,127,129,2,0.9005235503397743,PASS
DD1C1315E3E0C9F33C8E1E99A1C10114217C35F66E89A8AD4E7B8C6E062EFC83,132,124,8,0.6170750774519738,PASS
1177EAA35C0569F394F9141E558A2BC64FA7EA300CF1BC4684466D5337D091E1,132,124,8,0.6170750774519738,PASS
FEF9437CB5A2B2D86E95D0451DB760642B0E103DB7112009533D663A62850C1,139,117,22,0.16913144470267139,PASS
D9229AD0C9CCD3393DD3528E8DB58FA2FFE2A35BC0FAA893A11DD0A727D4618C,126,130,4,0.8025873486341526,PASS
3D31DD3B8C31AD0F35397026E15A6A91A79B0CB79B176E77EBCCEBE7595E019E,118,138,20,0.2112995473337106,PASS
BE8FFE66FB2E2AD3FB3738F65C0C7A9A0DD438B3E2D66391F9206D706D35C55B,115,141,26,0.10416255883043901,PASS
34569670362F03114264142B9287A04107361881962813539692D005D0B3A994,156,100,56,0.0004652581580710493,FAIL
492FC14C70133FE9175135F0F1025C95738C79E7C0AD6C4E9CC1FECCB604BD0B,129,127,2,0.9005235503397743,PASS
4FEBFCA73172B784AB13D5943071B3591809EC5B368A1BD37C032E9C15797AA7,125,131,6,0.7076604666545525,PASS
100FC4411EA74BAC9CB402C308FB086842F0D55DB36DD403EE2890F2BF8861CF,139,117,22,0.16913144470267139,PASS
3226DC6A0F3E878789ACF9BDC55B7B250032E6CDADB061E8874B3F07135E6132,128,128,0,1.0,PASS
51861FC13BF3EC2A2BFF50D379A0D7535E5FE7A5C350A6A9EDBD6050B73FE96E,114,142,28,0.08011831372763423,PASS
348633E5B89DB1EA61445705C1230C3367BACA3FF4E8CF1A8005FDD60A8CD9D9,131,125,6,0.7076604666545525,PASS
4466FB9514921C370CDCF88D101A575097FD83D41C869D764AFC643D0374EC4C,133,123,10,0.5319710580974012,PASS
4E38D830E1102FF07D9C628AE16D0BF2AA2C4AC1BA039D7C78F61AEA2EBC3DDB,128,128,0,1.0,PASS
7FA0DD5B03F441F88C307DB1B37AAEB62BEBFA86699CE63B865A06697A47143C,122,134,12,0.4532547047537365,PASS
C2D5479CB6C94D034E82FBA2B5A4EB76873C7E8E57C26A94CAC9872FFAC47CD7,120,136,16,0.31731050786291404,PASS
7865EED9B345ACB7E5664CB34F1FAAA73B829B5377ABBFBF4495216FF2D0B4EC,111,145,34,0.03358661289689768,PASS
52D73CE4A64A82FBE58BF96E79F33B680AF50C09EF7F69F8A3C32B4AEE4D8062,120,136,16,0.31731050786291404,PASS
8620225A6F8B967CF6FD7FA449AC6B6C077D425C6EDEEE7C3B57805E97A0C8E0,122,134,12,0.4532547047537365,PASS
85E39B0D65153EBE0A4F91C78D23269D6E57B56977FC0C7BF369BAA727F9D177,113,143,30,0.060792723530522785,PASS
8F31BC460ACF161A6BE49823EB00BC3A80C9FBE0A8630A19F6A987CEC06C66BE,134,122,12,0.4532547047537365,PASS
F46C7882EE5DCEB2CE1749219CA6406FE3602DA258C026B190DB9675BE6FE6BF,125,131,6,0.7076604666545525,PASS
110E0C288F63DB1A4BEDBEADCC3533A3C423DAC45E32CCE84C88D376FA3B12D9,129,127,2,0.9005235503397743,PASS
3791973F411A1AF9944D86D5792DFD7FA15A4F80262A6C21F9C501B0E56789D,130,126,4,0.8025873486341526,PASS
66ADA93E4CB8ECEC01D6D1DF7E22519B4882C31A99647F499DBF0D2BAC939E15,125,131,6,0.7076604666545525,PASS
AD1F0CFCE403BD9F885494C5845A14A8E3B3680F614A19F65B10952F69272F18,135,121,14,0.38157390570502125,PASS
3C04CF9380F456F36E733B9E60008FF286EBC36125EEAFE52383336D7D8E81F5,124,132,8,0.6170750774519738,PASS
306B3E68475C1376AA20847D14E1AB62C402DA2B58B1C0CFD8B8271451A8843E,143,113,30,0.060792723530522785,PASS
92F9D3E8945C9C3A6F5509EA326740A054F0AC812720D3F64ADFC0671031B443,138,118,20,0.2112995473337106,PASS
1359CEEDE71E5A035A2E4884611C1BA65DDE96D7F73693D47254623EA94A65D3,125,131,6,0.7076604666545525,PASS
AA22EFACDC90A78D207B54A324B9D52BF747CFEB8F77907D3DBA412F60D59D0C,120,136,16,0.31731050786291404,PASS
2200849C05B2A821B9E7F5D50C60879DC86276694D6734364CF07E890B3D0121,144,112,32,0.04550026389635853,PASS
AB761AFE706EE7771AEF70600D06874336C541D47CC38CCC8F53031E2A6D59EC,127,129,2,0.9005235503397743,PASS
82ECD2C034F43F1FDFD28D20886A47358BE246C632EED67DB100B35EAD9719FE,125,131,6,0.7076604666545525,PASS
A422E4EC3D240ED0C8F3CD4116CEAE01F51258D6BD9208A613448BDD946129DF,138,118,20,0.2112995473337106,PASS
AAA47AFF4196C242B6F51DC9F513DC0632FCDAC81E4786DA1B162E6BFE2CBBD5,120,136,16,0.31731050786291404,PASS
26BD9340614F0AC4DA9564F257193E0197093D01A92979100ABEACBFEDDC0243,138,118,20,0.2112995473337106,PASS
DFB747A6841A26DA51A323F5A83C62BEF61E466FCD7837AB59313E1BE4EDCCFD,115,141,26,0.10416255883043901,PASS
3CDEB433C8B25FDCE281232E1B5666D86FDF26F60A93C333ED7854EE7E414281,124,132,8,0.6170750774519738,PASS
94A46A2DDC33BF022C23E979ABF809657038B4964705B2FD121C714256D5F722,133,123,10,0.5319710580974012,PASS
550BD06ED84C546DDB3FC6A2DD6E9229DFF3623DFE8CE792E582ED51C0D8F778,117,139,22,0.16913144470267139,PASS
87D35986A34E1A5BDDD530F3CD8034B34871B03186C5ADC6B7F027BCB83A8D37,127,129,2,0.9005235503397743,PASS
F2291CAB86537128B940832B40D22C2928118CA5729A014D6FC0D9AA087ACD3,149,107,42,0.008664896726025117,FAIL
F07F3BBB111A5EB6013A35F11186932766E637C9DF605379AAA1AAEF6DBDDB4E,117,139,22,0.16913144470267139,PASS
46CEFC8AB62CE835804CE53A50A6D5B0C0666E59B7F0CC4D5E42A95EAF4E75C5,128,128,0,1.0,PASS
C83F35CC886727260414BD3F3EBF48175F1D860D1AD74838C334F32E7CFA9715,126,130,4,0.8025873486341526,PASS
F98DC68133F1DA11C3AF81373167DA9B2E9FCD8D1AEC79FB4488913B889C82E1,126,130,4,0.8025873486341526,PASS
C9F9A5083541AF74349DA9ADA39F9D92B05D2AF5243B75D0A7A894AB04A69E65,128,128,0,1.0,PASS
84102DD5CAD59756DBB048688C0843FB03D29EE9A92D5847D27C7FD9767BC205,130,126,4,0.8025873486341526,PASS
C04059D3C7A1EF432C97C3490C3A647ADE286B03B6CD6630064C7D85C3F4CA5D,134,122,12,0.4532547047537365,PASS
98561408B2B6667D851AF554C4D092238F50D0F579F63947BF8A733918E9A32E,131,125,6,0.7076604666545525,PASS
E944A63C6488815C224C730D3651745DA5A7868F37E0FFCA3BEEB209F7547D9F,125,131,6,0.7076604666545525,PASS
CFA7956B8EE8F5311D7B19513215987790470AD20E7DCEC0F5838583A44C76DF,127,129,2,0.9005235503397743,PASS
9F293E8A02B84854CACEB928162EA6EA7BBEE882FDA46407FF4A255647FA0741,130,126,4,0.8025873486341526,PASS
789891DD514E865FF779192B5F8640EC5B92DB3038DF74F01B941D1881B3CBD4,127,129,2,0.9005235503397743,PASS
9C4769190F7632559D2849A41B3E3736DBCEB7C09DF6778C8E3B591F8F78E1CB,119,137,18,0.2605890342736178,PASS
9B341E521BA49A470B1274EBD4C1E738AC99E29719EEC3F0ACAA54E7E8122158,133,123,10,0.5319710580974012,PASS
67B91B27B453FDAE8572D705C7001B91EEE211FB42F8D42DD43E657B3AFA9F63,118,138,20,0.2112995473337106,PASS
6D0B1DABE4DA047B4F7E7EA62B601488679604199A7C67910CB671AEE5B8D39A,128,128,0,1.0,PASS
4E7F275C89DE6128B40F1A58D30527C15AA643CF627D157D674749B19A5F4058,130,126,4,0.8025873486341526,PASS
E2A47C36B3CE86B94EE83E607EFE1C2E7311ACED260034CC85A338AE2DBB343E,127,129,2,0.9005235503397743,PASS
DB1808C0086408CABCDAC6331B2A846C1459D991385918E197840FCD7DD2AC73,143,113,30,0.060792723530522785,PASS
C63E3EADC539FB633D4912ECAD8D1F3C3BE4024F9EC89F320E65FC1F34EB84D0,121,135,14,0.38157390570502125,PASS
58CF73E244C3A8E87EB465E81F7F9EFCE6EFDFCB5F9287A6751CBC020E3FBE99,110,146,36,0.024448945310089426,PASS
7E34D91867D7097027F3AE842FA810416A7096373709CB23157F826BCE8B0B0F,132,124,8,0.6170750774519738,PASS
BC84C16365FE275F967CA0E34F25276249C9B2B68A596FC4586096552F9DFCDD,123,133,10,0.5319710580974012,PASS
4F164B7922D670187CC9A3FB3F971EB23468AA5A9AEEA1035A69EDC0C91E2689,129,127,2,0.9005235503397743,PASS
F99CCD634874888D170DAC901573D569FA16EF7ADDB5B6B654A036CF2E553083,125,131,6,0.7076604666545525,PASS
9FDF0AD75FBDB95764C25ECA78FA5D9F809084A9423DC460A3FC4B5FA24AC567,121,135,14,0.38157390570502125,PASS
C3C969D97A7D2DC9D957CB3E7DDD68FD1758A555D1D61072C1B8C1E8F28CF059,119,137,18,0.2605890342736178,PASS
CCF09CDEA3D6C14FF702558C602DFA65B879EE14D3D1156B3AF4A5726167665C,123,133,10,0.5319710580974012,PASS
D3718982B30706664DD6224D3AC2CE41358B065BBB8D71082CAE25AD24CEC11F,138,118,20,0.2112995473337106,PASS
D605403D0527FBFD8CE452DDE2DEA2FA18F44B84CA8CBD5225C8AC3F1B3FBE26,124,132,8,0.6170750774519738,PASS
8D1BB39A774E5C2E93C7466F629EEB4F561045326B2EE53DD61D2531029E8202,130,126,4,0.8025873486341526,PASS
9B9D9C12B07A777DA13EB7A3BC747521A41C326564B5A01F127CC7CAE9B194C6,126,130,4,0.8025873486341526,PASS
EE25E414F5DFB8AAB8F3097248BDF303967DD9750B2ABBED905A4C77F6CF0C89,118,138,20,0.2112995473337106,PASS
4C8670860F27C725FD4B9E8BB8553BE6F314D7CE12B0A0AD016189374C922BE2,133,123,10,0.5319710580974012,PASS
54BF26FE6E011FBC736C3B5F02C9F75A7D7256DD88E67C27ABAE53A462C20DDD,116,140,24,0.13361440253771617,PASS
E9764C909B54DD72B753B420DC7D2F46453BCEBA0FDB3FCFE0E1D2FBA7268E77,113,143,30,0.060792723530522785,PASS
83F3D4516EC3C7AEF98E60D90A34D987FC5AE94426533C87D3F79947EEDA49A7,119,137,18,0.2605890342736178,PASS
EBA92EFE97ED36D231E05B8B863F84D53691312B1A4A0DDB8CF85AE1680F3204,129,127,2,0.9005235503397743,PASS
45348667A02BD94BDD90D6B91F0BF77B98785460E9FFEE3EC3D95B09A8A2C1DE,121,135,14,0.38157390570502125,PASS
A15A880B9B3B4BA8BDCF7624D54185FADFF9E9C950489D31CEC457275152873E,126,130,4,0.8025873486341526,PASS
206EA2B001B2275C1CF452A63BB2D092EE03E312A881C85A5A25E1DDAC139465,143,113,30,0.060792723530522785,PASS
E98349CBA1EB0B62E835795F877D6B4ED2ABFF7CD42016CA13C20C5D44724F43,126,130,4,0.8025873486341526,PASS
65B7476FD2E5F5801DD40E02C428F5E0E85C6905A5D00F791F905947D279731D,131,125,6,0.7076604666545525,PASS
740D26774744FBCF99636D53E7067505491A544160B459FF3AE5C6146FBF5D9A,123,133,10,0.5319710580974012,PASS
AB05DAEDF70922C859C6B18B96205131D3AC665141F5CCF1AF12C596FB42541,135,121,14,0.38157390570502125,PASS
642834912E2A1E94F0C9B2DF595CDA9AAB80A9371C93756E0A67255CCDFC3258,132,124,8,0.6170750774519738,PASS
F78C026FB54E9316331E38E62DDF1EECE228716F2D1107E97245AB95CC4A3A8E,126,130,4,0.8025873486341526,PASS
B8D4E9527E7231A7E6E4B2964D50CD19EB9DB90EE95393C594EE7C0B230E617D,123,133,10,0.5319710580974012,PASS
3114A74AB38F6022784BA42DD895D9F63103098D171EE2A90E5ABDF177360952,135,121,14,0.38157390570502125,PASS
5A99AE0C007C44A8ABA91A315154554716D5F7999329C640223808E5D23BCE38,143,113,30,0.060792723530522785,PASS
1F9C06E447C5D98B04CCFB2A42878DD69B3A9330CD73E573E0F632CF1A850EE7,126,130,4,0.8025873486341526,PASS
FDB77E6DD3B5752532C540218350421A6BD462DBD15672A89D900EC6F3A66A29,130,126,4,0.8025873486341526,PASS
FF79F54D085B0527A84C880114E49D1857EC590D5147EC593F8960D2CB18E823,137,119,18,0.2605890342736178,PASS
6C9807F14F4DB59D87CF78E68EB85F1EC5783C2EEE0470ABE2EF44D7F18480F6,121,135,14,0.38157390570502125,PASS
9F9C4FED01AC224D8FDB29580178839D3BB42B468E26DCC2CFD6EDBDEF9B0157,122,134,12,0.4532547047537365,PASS
B617F8B6EF7BD0E1498B369DF038607A71A055E45F3F943B62DDEC02052028AA,129,127,2,0.9005235503397743,PASS
1F080EB77DB7E035C946061863470B018AD7E6ECE88237E321E0C02FFCA5ADB6,132,124,8,0.6170750774519738,PASS
9783DD6CF9D8F79AD932C1C96214BC4D3B9FDCDDEF2F07FFCC73175C1DF3B8AF,106,150,44,0.005959526470109114,FAIL
EBEEAA135F78737F62B4A9A46850EC015420605519DCC629DF1E788073CFC800,135,121,14,0.38157390570502125,PASS
B22D122CA81961B1B5CDD9B1F24E248FD16DF3902504ED49B121EB3B75633C25,132,124,8,0.6170750774519738,PASS
6F6FDE96E626177B789C0DE40DFCB5E05615167BA1DB71D4363BDD6AD8E56754,115,141,26,0.10416255883043901,PASS
63C35F58F2E365C9C63E240C2BF3BD4FBC110A788E831CD6D5A4A87A860EC850,132,124,8,0.6170750774519738,PASS
5D07313A18F2D7C812E0239FE29EDA7F55B6A5B139672F765108D0541B8F4DF2,126,130,4,0.8025873486341526,PASS
9A02EE2AF8D7BCA9831120FA5974EC8BA3B49288FD700F13487873ECF1445D22,133,123,10,0.5319710580974012,PASS
ABB30077BC6738F7A17CE8A32224BB95625D98D4757F2F4E008A20B43478486E,132,124,8,0.6170750774519738,PASS
60A75F1CCA9D93BF2AF41B10DF310691C7F8624903AF60748BF56E22DBBBBCF3,122,134,12,0.4532547047537365,PASS
4DC95C1A911106D4A450489A898C4DE4352B253E24B36A4B534887BD6E45D663,141,115,26,0.10416255883043901,PASS
6154766C0E41C54EBBDE9E8B970E1CA87A8BF9159AF853095A646DAF4B427586,128,128,0,1.0,PASS
47B6835B602F09872B7CE3B4CE21079820704EC3E19D2F70A58E99AB9D79F971,129,127,2,0.9005235503397743,PASS
68D139F33B65F78A331CF498317543608C46CD024969E54D56813363AE39DFD,131,125,6,0.7076604666545525,PASS
31E66D22A60BE6E115E5283002868826A1CEDA18B70AEED4910C143A0301B9D4,148,108,40,0.0124193306515523,PASS
5E2BFB1EA651EEE323E6C8C629ED6D38380E381B69964B7BEEECB5B93F42E419,119,137,18,0.2605890342736178,PASS
9B351B18A818887DE2020E47C760C3EBDCA9FD36AD338E43B3656C14576C1BA,133,123,10,0.5319710580974012,PASS
209B84C86199019D6261AF7A5309ABE59D8AD9C6774618E0CD5575D2004F52B1,138,118,20,0.2112995473337106,PASS
B71CA4CAEEC10CD50C9D030F9F6C065E261FA23DC3CE7CDFC4F2AAE8DCE5D1CB,122,134,12,0.4532547047537365,PASS
6FFE5E3CBD270B4860A9597118BB068B96D9B105DC0915D34D491F4DC7351761,129,127,2,0.9005235503397743,PASS
ED5BB72B9D70673EF6242543DD23BC5F42FA0C81DBC68FF0BE69F855A3BAEEF9,112,144,32,0.04550026389635853,PASS
E62F63ADF0006DB483E11524AF9A10123FD9A2592B9FE475804FA0720EED6216,135,121,14,0.38157390570502125,PASS
416E30D5714327072A247B6EB3C58D95D9C8F27B53087A5626B99E233ED82AF1,129,127,2,0.9005235503397743,PASS
9DB781D3FFD10DE4F9473DEF8FDDB53143C18553ABDC7329C46CF595600B3483,119,137,18,0.2605890342736178,PASS
36FD47DB2CAFD0B2B6236C2410762A8A59E10AEB05720124E340FC890F46318,142,114,28,0.08011831372763423,PASS
18A0CDA42F707FFD506BB8DEEBDB5D83E8927614072FBFBB7E0955AA9E379FE7,112,144,32,0.04550026389635853,PASS
501BFADC78B8B7C576E8F6B54BCA71F1951650FA4BEE0663FEAFB8D1D7EE9C04,115,141,26,0.10416255883043901,PASS
EF2CBF236B6F91033277E812A2E8BB8F881A7745826B39E800CE4FD0E4B0B125,131,125,6,0.7076604666545525,PASS
DBBC7FCBDA824F2F8360F4D66703E2CB3C3ABEA2B8DD0DFF9FC486A958A5A768,116,140,24,0.13361440253771617,PASS
7495491D0B5E908B8EBF2682B137876321A5B78A057CD53EDDBCBCFCE3BA0D9F,121,135,14,0.38157390570502125,PASS
6F55A02DEC3B8EDC0DB4DDAA5851D7A706FBDBFAF864183C8BFCA4A79E8BE62,119,137,18,0.2605890342736178,PASS
93EFF6F08927E5ECE848BF52645D6AD3710D1E7FC16D396C01202DD242D739EA,124,132,8,0.6170750774519738,PASS
8B9C11B92AF255EEA3EF2A35823B3F2C1745EA3F9D5789DEC6288AAAEF488696,123,133,10,0.5319710580974012,PASS
D392383136B2887CE718A39A7A7D63227170F67F2C5B6954213C2F67C5285E1E,128,128,0,1.0,PASS
5D265006E43F4277983A8D4A7695E845624777949FF6D0503BF6F545951B5537,126,130,4,0.8025873486341526,PASS
FEB6CC12C461C2E501377EE776E1431BA292123D480F07791D7F619FE2D0EEAB,125,131,6,0.7076604666545525,PASS
2F4E945A69C27293AFA1C03500D9771C52616A36AF54DCEBF484A3F952E1D02,134,122,12,0.4532547047537365,PASS
AC6303965B0DA9BC68750163796AAE51E6D171E0F1163BB9D434060EC128AAC8,137,119,18,0.2605890342736178,PASS
B7D3CC710AB7D87A381EDB31FDE4358E006FF2C92EB600AA700F25F3357FC5E0,123,133,10,0.5319710580974012,PASS
5196BF8C9B5ADF7FBDFB62B870F34145150EEBE81A9EB8E7493E4E11BC314D16,119,137,18,0.2605890342736178,PASS
909E6F4AAC0E318AF41079A1CC5D9CA345DD9EEEBF9FB0763BDAF3E52156CD46,120,136,16,0.31731050786291404,PASS
525C853107866FA57AD3F3F911A19A564D8E1E1E92E93F49942D530C3DE93948,130,126,4,0.8025873486341526,PASS
37839C2EC653DF732CF05E118DFF66E357E5EE4CE3EFD36D104F3BC2917AC1E3,114,142,28,0.08011831372763423,PASS
7A43B241E237ABA717AF173E51DD73F652C9D0C9055C3260F4810124A45B01AD,135,121,14,0.38157390570502125,PASS
D28B05972F666214C4D299287B018F9E7E796083EEDF185E2523BC21957F98D0,131,125,6,0.7076604666545525,PASS
4D12D90595B0C5BD2BB34A8B598581CCDEB36619A7FF9271102B3C969518158E,133,123,10,0.5319710580974012,PASS
C93AB5B35B4217AA8DBA598681A342B2431B656FF7962A94675A0608F5D413C7,131,125,6,0.7076604666545525,PASS
5976C2227615DA7A8FD97AC832C39F1CE5DA6B21B5BE41C9FD695DE430235446,125,131,6,0.7076604666545525,PASS
83409D191D687B9E86FAF1505E8CB19F9F8A977CA7BAF5DFB425453C1A8CBA63,121,135,14,0.38157390570502125,PASS
775294D593CE6A01B59CFC2591AFDA460301CA3BAC0EF576EE432DA442449FEF,127,129,2,0.9005235503397743,PASS
23F6C493A49DB7A7C2197C94DBFF1D8D351F597DD9FDB2BAFFAFB4759EDF1690,105,151,46,0.0040402749798920095,FAIL
1D7EB9D746A2B8858306B27F47F84BC7AC5F1D1CB84A59ABCE32F0F9294ECE93,121,135,14,0.38157390570502125,PASS
B9A74BB65FD92B489600D7B0C3DDECCCA9EC713A0C18C2178A5CBFD9A7079AA3,125,131,6,0.7076604666545525,PASS
D76D522B4A1AAE53D6CA1F6FDE1156974064EA499E8CE86BE7D30B6ED9CFB1CF,117,139,22,0.16913144470267139,PASS
B7F0F04FE4A6E772089B076126841A4E4A8620731820E4C782322F6DAC7A3DBA,137,119,18,0.2605890342736178,PASS
2BC08755756DFAB59CBE0355791613DE6F3932AE75448AC9B2B81DB3B123E8C9,124,132,8,0.6170750774519738,PASS
F2522B7C9045ED6CEBB0D034C5B5DB07BBC99D24B30849400EAB2815902FD815,137,119,18,0.2605890342736178,PASS
997D1F6DBFBE0CB295CAA1D6E8291AD04897C984530F402739C163483125B96E,133,123,10,0.5319710580974012,PASS
3E1DF2384E81D58755FAFC91D0C5D2A34A5135FDBB6676EEF338B8DE54531C94,120,136,16,0.31731050786291404,PASS
BEC2C063A2AF9109CF9A6EF3681782651CA95BFE9A501A80569526D29B9AE273,131,125,6,0.7076604666545525,PASS
9FC8921BF4C10114F1E37ADC9426FF5B4ECD4C7058BFA164EA69A8F7396FB078,123,133,10,0.5319710580974012,PASS
789EB263C9FEF55F95FEB57D65DEACECC01C182B42FDFD902A9818D6A88CAB0,122,134,12,0.4532547047537365,PASS
1D1F50BA49A9B715DDCFAE9A1C8507CDC4509D10B90C191D836A2054CE46625A,138,118,20,0.2112995473337106,PASS
858F42E57B61DFB403B309F232FC8BE785F3AD3568938E019CE48EEF3DA315CD,122,134,12,0.4532547047537365,PASS
8199519B4932D1AC889AB82B7EBF8B36C50848648D0AD5B15E8C48B352B45E2B,137,119,18,0.2605890342736178,PASS
D6A9A387C187B0AA1DDA3696538AC33E46E8D3450B6EDFFA183771A5914A8E39,127,129,2,0.9005235503397743,PASS
FB5E2462DDFAB233EC7DF6B4D9E43E846BD96E9AA67B0B485E633C22B4680F84,120,136,16,0.31731050786291404,PASS
D8A4FE20DF1A1405D50BE2AB965C69667D59E1E1E5AB3EBBBC16BA922A0222B4,129,127,2,0.9005235503397743,PASS
6CC134749958ED56B5BE0A3087C2D9189443017B424EFD4326E2D6B72F4E0E21,135,121,14,0.38157390570502125,PASS
20321D289516583339DB37B277BEAC54AB30973BFF0CFCE70F2BBC4E387B207A,123,133,10,0.5319710580974012,PASS
842979642FAB461506B72D17F04C8B845640B2B71AD497BB41B32C75DDDDF610,131,125,6,0.7076604666545525,PASS
BFB3395FAF79D50B46C5B45F20DE91C1B9DC215159599DB5262D474273A10446,127,129,2,0.9005235503397743,PASS
C411F68881FEDDEB058D97D003A449840217F2E517A7EF59B239AC6BB9DA6DC9,127,129,2,0.9005235503397743,PASS
7E37539436EAE4D0A7BA74409AB18BDAC71427A0DD4DADFD1FEE0E4A7F0257EA,120,136,16,0.31731050786291404,PASS
E0D37F50CB60E37848DDDCCE2317BB82732FB6C6C246201E6BB94A25285717B,130,126,4,0.8025873486341526,PASS
E5004C4F6073F60E62DA6FD4DD3897EAC819EF775F9A076E10A9893EC5BD47D5,121,135,14,0.38157390570502125,PASS
31E4904DD4350165280B80D025298A763B4AC24E5899E5FF035EAE0C80675F2B,142,114,28,0.08011831372763423,PASS
3CF6CDC1C613E1F25CCAFB40DFEE94868752E46F2D782D1944158C59F7BAEE3,123,133,10,0.5319710580974012,PASS
CC4744E315C5A716DF77ACD4ED06D32CA3CC7A1CDF0665F93968C525C181F50,129,127,2,0.9005235503397743,PASS
1316A83146567CEFFA78B1768E0A370F5A4E4F555A96C7F206B7F4D877F8DA35,119,137,18,0.2605890342736178,PASS
72E1330BD5E1813236ABF16A6AC8CDEA19468F188C92CEA6DCD93970E9D42D87,130,126,4,0.8025873486341526,PASS
BCE3FE3DDE6B08559D9C6640073D94DF56E0EBB46FFB36330BC9608419631DD4,122,134,12,0.4532547047537365,PASS
668A91B5AB3EEC0EB1FCCBC68C07FACDA83DBD22EE250CD73E74B8C20AE85B0E,124,132,8,0.6170750774519738,PASS
3969047F738E1986CFDA46422221801CE11E776048B2C98F3A8A0DA353F85D99,138,118,20,0.2112995473337106,PASS
B688DD0EECDFC5C48962A10A3D17A815D13036C536280F242F3CB3080EAF8EF2,136,120,16,0.31731050786291404,PASS
771846AC68F9E061B0DED706B0CFC34DE9762EFC2F3A596A9340DB389D231D77,123,133,10,0.5319710580974012,PASS
864CBDE64C197453DD5CD050B814AA8694A00D6156CC54460BEA2344085A79CD,144,112,32,0.04550026389635853,PASS
2A8152F219195ADDD6AD0898E61FC56663F6F295C5FC20618BACAABAD12FA40F,129,127,2,0.9005235503397743,PASS
AC6E726DE63B28172B0927E1D5C4E40E7D0F17DDB088CCCADBFA777EE3D6ECCE,116,140,24,0.13361440253771617,PASS
5D48203E001BFA8F056640912C9BF88C86FF71572D86752791626CD0DA8D1AE9,136,120,16,0.31731050786291404,PASS
F3E8D3DA43889CD0F15B01ED1638CB7815695ECF3C4039C53163A4026093DC73,134,122,12,0.4532547047537365,PASS
9FDFBA1F4A93F441BB8FD74DFB518F27112493A933A6A7CA2DADA5D22D572185,119,137,18,0.2605890342736178,PASS
EA84750AD789CB280E42B57DBDE17C75B557B1AC7481E0E4102D3C0DB5390158,134,122,12,0.4532547047537365,PASS
99DB0844F7A40657ACFD80F1A1BA39D61096A80C6B25CB80C5B5AB6BAB06643C,135,121,14,0.38157390570502125,PASS
295CD60E017431F216F374DEFBC8FCF72326BB188EE16FE82BE6C67BB258858F,120,136,16,0.31731050786291404,PASS
58ADB6ADCAC1E33EFF26413F131FB81EFB13DEC709D041982EB75FE57F07836F,115,141,26,0.10416255883043901,PASS
82EDFEA1D4BB549D693598451A44E1678E16A41EDAE2B8812972B57A407FEA9B,128,128,0,1.0,PASS
5FD12BC6F7B33E7B9E1A090C554E16FA3F3B2C3664F8E9F50BC93F1ED3612C07,118,138,20,0.2112995473337106,PASS
96A097472AF6B1C766BB19643F4B6643A529624887C83AFEA7ECF908206724C9,131,125,6,0.7076604666545525,PASS
12C31EC6721A720D3FD5A3A03A9747C517485E8F8385588B31CECF1E9ED41813,133,123,10,0.5319710580974012,PASS
B33EDAE22A6E0A63E686146B89AE7E544E33B9833F0418F42633E7496C3B0F54,129,127,2,0.9005235503397743,PASS
480F4C0395D2B1F4766070A158CD3E1BE90569BADCCD2B059D3C54B623276FBE,130,126,4,0.8025873486341526,PASS
BCF1A6439B78D1CC7440ED19B50AD27C0872CB1BBCB86B0F326E1C8CFCA6FF73,123,133,10,0.5319710580974012,PASS
3F5295759F0A65813B54A327204290AEA28F711018CA94C83474D9792A9E21D4,142,114,28,0.08011831372763423,PASS
ECECEC120E037C26CD1CC9AFE38CC690412B3A9530787D4822C0EC6516A4107D,140,116,24,0.13361440253771617,PASS
7370A6559B55E7E2B652D061560E8A5F2BD5D1A5FE19CA65B882329292495FEF,125,131,6,0.7076604666545525,PASS
29D76E0B700B3DF058ED8C6BE50B8CC895DBE3E353D4BA152A52CC666AB260AD,128,128,0,1.0,PASS
20A44945000C2466C8FE6630F7B48DCDABC2A6ADC4318676BC8ADD0CBFBAEBE6,132,124,8,0.6170750774519738,PASS
34F72C0D7C8130E79CD6A130D48A17D22C4EE6888B80F481F571D3CF02086C56,139,117,22,0.16913144470267139,PASS
8B07A569C8D525779A8400ED32D8E455B4EBBC709AA952FC17880419B3E7F310,134,122,12,0.4532547047537365,PASS
3148E7BFB7C641E53BDBB4138DDC6169F703A9C9C0F2C9888F64BFB72949E954,122,134,12,0.4532547047537365,PASS
1F6BAA12D72BBE770A9A3DF6C6BF6DBCFB6486FF3E34D91D01885F1F14FD0E09,114,142,28,0.08011831372763423,PASS
AE790C882C73273DBED261ED150C7E3C24DB57CEC0845F43A798B78704409819,134,122,12,0.4532547047537365,PASS
EE25E4F42249B785998F91109FC646A88E861CBCBF043F40EAD76715359837FD,127,129,2,0.9005235503397743,PASS
1618FA66E0EC2A6EEA124B8B0DBC323740C4931B2A631C449EAA4BEA71311EE0,138,118,20,0.2112995473337106,PASS
A1C71B8E350BEB6DF4F7D0F41357F0713F35E9D1F65320E200229AD7B4FF9182,123,133,10,0.5319710580974012,PASS
13E7BA5046A41458AEF3C497E7D90083DF8F106E27EE8772176A537F0655219F,127,129,2,0.9005235503397743,PASS
A0E1D58328000FFBAF65D14019BF5D93784EC41D0A9AD3E980957E0E5C499199,136,120,16,0.31731050786291404,PASS
EDB48541916034398930F5BE73A9E37C7BCF6E82D51331830CB65552C3FBD883,128,128,0,1.0,PASS
BF25DED95303160CAE49E933B1F7D02CEC1E25633F0C4481B0F75833A816C28B,132,124,8,0.6170750774519738,PASS
E6C36D9D6A5EB47E1759FCEB9F43ACF1999BF98FDD2C6F4AA6CEF018F1540A7E,111,145,34,0.03358661289689768,PASS
D509D9BA12EA9A0A73D76D70EA3DDB73E490F9E567266813AB87F5B8AB00FA2E,121,135,14,0.38157390570502125,PASS
8DA60928F93DE3B687335D83AF6F424B22830D51FB6D7A6EEC131DACF5FA2513,122,134,12,0.4532547047537365,PASS
B7F67060E8C2976F960AF495EA4A31045303EB672DF1484879C007C56664E59B,133,123,10,0.5319710580974012,PASS
863875086F59DB57E570D80CA7EF28E0D9AD29F43BC288169827E49647D1D8D4,130,126,4,0.8025873486341526,PASS
D69F5946E82FDA615E91617BAC20EFDCB10A324CEF0E8A8485B36ED262546DC0,130,126,4,0.8025873486341526,PASS
C56B8158FF67141DF701EF31FEA9E6BC66BA7D20E9DB901A4A3FB749F76E688A,116,140,24,0.13361440253771617,PASS
CFA192B9E148E8E5A7DB4B5230991CA878937D7AA88A362A5CD5688BA96EBFB8,126,130,4,0.8025873486341526,PASS
100E73AF5D4442ECBD5A899917D23A8D9F94F80F204587531CE3560F4254B7D2,133,123,10,0.5319710580974012,PASS
259A903B7A9D123BB41AD688388884F9A13A3CAEDAE3EB21BB693206E8FC2272,133,123,10,0.5319710580974012,PASS
21BED8A692A93AD1623F01756C8B7A96D83F720B22FB42409B388B0346EB16B0,135,121,14,0.38157390570502125,PASS
B8952F007B77AFA63DB97733B88D24B6CF000C648D7B1529E5620A8F1A68B254,131,125,6,0.7076604666545525,PASS
A8FF8DF213403D03D802FD2590CE959036352F62DF7AF173C662B2C41204807E,135,121,14,0.38157390570502125,PASS
EFCFA064652BCF7FB80144B89B4D1C63BC35059D9EEE07C1ABDE15FD44E55304,124,132,8,0.6170750774519738,PASS
850DFA25E928791A58C47CE07F3D76017F115DCE626787732CDC7AD410D792B,128,128,0,1.0,PASS
E456D3E97B33966C1E1E9AB3A3A38F5DDB6900B7D72E0E554B4B14660B8A1401,129,127,2,0.9005235503397743,PASS
274535AD8E9438E8D7D586502FA3C5376ABAF99C30EB081F0CD6FEABA500D425,129,127,2,0.9005235503397743,PASS
8188D834DDA7F8B2CB155388DC7FCC676D88B94A9FF4D8963FC7E1F52A636C14,122,134,12,0.4532547047537365,PASS
45E55660727D590CD91126D0DFC1BD8D8F5E04EA307B11D1886EB1D9261F59F8,130,126,4,0.8025873486341526,PASS
CAA1F8E42846E57EEE4057040E742BB40E75FD52B4B80527BEE12ED96118B98C,132,124,8,0.6170750774519738,PASS
E2C635C76EF84632EA5B917F27124E05D25CC029578A365D93F59EF87109F357,124,132,8,0.6170750774519738,PASS
8558F731D09A946DEC509392067A873195A7A343B6B3AABEADE1909A52427CAC,132,124,8,0.6170750774519738,PASS
25D45EB304E23F44D45245CA8A660F9AD7EDEB76CA4D71AF94257D4E2B775227,123,133,10,0.5319710580974012,PASS
64C97A2C2626D219D6A2D37FCF12C38A560798683B72F3CA5CB4C08F8B46179D,130,126,4,0.8025873486341526,PASS
CA00900E2BDE95ECAE2F8CB59306276A8A7020E871B1E945773F7DB02C0CD0EF,133,123,10,0.5319710580974012,PASS
4B96D89F149A592F9D8C37EA05377D047DE44C0AD1DB8C404AE0771CC6D6CDE5,128,128,0,1.0,PASS
831BADF8E0C140AB60367C6F1FBE66E1265E8242FB81A73FE1DB564FA7293FDF,119,137,18,0.2605890342736178,PASS
8F195E5F16E2981CA5FEC26DE889B6C1D45DAD9C92A9C2330D33EEA4D6954496,127,129,2,0.9005235503397743,PASS
74D7C4E8DB5E44228C14CC832995013DB03BDD1BD3FC061B480364D810DB24E0,141,115,26,0.10416255883043901,PASS
4F6586FC44D473FF3367BE3002BB57586EFAF7700B90EF125D415E1D90A97BCD,119,137,18,0.2605890342736178,PASS
512947B7947E97240982FDE72FE5BD51CF0FF20DEE01CE93B38FA5ACD6226731,121,135,14,0.38157390570502125,PASS
A2F230221C1DA1FCAE9841D6EE6202094280F1645DB37FD5C1B725BBD293D8E1,134,122,12,0.4532547047537365,PASS
145F493C694F162430960A59C121E865F3FF62F5D56CA43EEA0C7B84B99E38A6,130,126,4,0.8025873486341526,PASS
48DE9120B8779BB5F46323319D42BBA29A3E604E1BD686EFC7881F8BD6FB021F,125,131,6,0.7076604666545525,PASS
552C9AB7C9C0FD1DB3654D2ECD6FF33A6F90EDF8E09BA7B67573388E1E8E798C,114,142,28,0.08011831372763423,PASS
D5176229289D2D0267799F2EE9B883507CA1FD3B7CBCC1ACB898D195A0156E8A,130,126,4,0.8025873486341526,PASS
78AA6BA2914B788DA4FEA10D3CAEC2BEE12335127C8C25D32496FA8FE63770A3,128,128,0,1.0,PASS
B9E4A02327BA8603CEF67E02CAD147EA6DEDCC4BD7A1B5856B2551D0872992A3,129,127,2,0.9005235503397743,PASS
51C9C19EA54545C893E29A575C49B4F65067EBD5C5B5DE3E45EBBE009A0338CF,126,130,4,0.8025873486341526,PASS
47877C695DEFB0BE906F5D011FE8C9AD2CF9BD77710D126BAB08A1EED0BA3796,119,137,18,0.2605890342736178,PASS
342DEE8CFE1E626F133199FB46036AF9ED0988A78DC4E88251555FEF70E929AB,124,132,8,0.6170750774519738,PASS
78F738F5CBDE2200824E56FA5BDB9BACF2D1F4AD91E0763759C83814B046658B,126,130,4,0.8025873486341526,PASS
97E49C07B36B325F160FA7A82AA9E8F4DBCAE39D55A5BCD6EF98714B736FDB82,115,141,26,0.10416255883043901,PASS
928C6E122D7193A9C97B38010D39E6FF6D76E7F3B45241EFE55A3F7D7EC9FB1B,113,143,30,0.060792723530522785,PASS
EBD8D46955D81D17FC2BD36523C5F77B369F863AE29EEF3638AEABBB27B0AE97,110,146,36,0.024448945310089426,PASS
F0053E9510CFDE1989B996CEAD27FCF33D6E60D0AC5E01B682EBF7E39ACAE1D6,120,136,16,0.31731050786291404,PASS
FC5D851436326E43C2395B5A84A5FC1840C237CD500E6E47AA00829B5C20BC6,144,112,32,0.04550026389635853,PASS
6026E93046F35BD64188C0FAC9F499C205FCF3EE9D358AD4AE2B3AD357CBCD7,125,131,6,0.7076604666545525,PASS
B9ABC8442B566CF646DE1658B4A9FD756158D2E1CCB9734700DCDD2BF29C3FCD,121,135,14,0.38157390570502125,PASS
475A57E5CC50EA77D561164B5C8DA107B57870DD49BB752ED1429C4A1401E352,132,124,8,0.6170750774519738,PASS
F96BE7907E059AC284ADFBDF0F318032EC0ECC24D23C789DEC00AD5A34F1812E,131,125,6,0.7076604666545525,PASS
A9D3FB383BE0E60AB463122E9D2C363A4C58B502FDE7B1BE81EB57129C95CF81,126,130,4,0.8025873486341526,PASS
B0D1E2EBA0062344A71B5CE578B97A065C97AA126E03B915DBB26EC56C4369BE,130,126,4,0.8025873486341526,PASS
F7562511827AA4576E3CCF7E0836D9C5352959B9F5ADE8BE52BF4EB1C80ADB07,121,135,14,0.38157390570502125,PASS
BA91127D1DBC88E00287C2DD5B5FD1D90246F21D2AC80FE3F69CB6EA24FE11FE,126,130,4,0.8025873486341526,PASS
A10F190CFF7E5FDD92F0144918785552ABFC942A04EE2C8323D794939BED2370,130,126,4,0.8025873486341526,PASS
6F43C33DE8C13899164EE78195FCAB944F18C4BD14DBED1BF476224546FF99C,125,131,6,0.7076604666545525,PASS
BC42A650F656519AFD7EE2D1D0273A0B6F385DDD940D6511E811D9DD4ACAB2CD,126,130,4,0.8025873486341526,PASS
C098AD25A8C8FE4E99F454F2FD9E058F325EA5C8A4E4A9CF8A942297D475687B,127,129,2,0.9005235503397743,PASS
1416F66BD7FE0A79B6E693C1D247EB016466433218644C5DB8B801118B8335B,137,119,18,0.2605890342736178,PASS
C697B52A8FFBF974BC5C94A8672652B3E9A7450BD3DAF1F7C2E219EAAED360DA,116,140,24,0.13361440253771617,PASS
830E191A1BB5ACB84EEBD8C9ED82D7CE124E8930D24AE8FDD13E22DA30CD327B,129,127,2,0.9005235503397743,PASS
AE81D3D8CBE45E4046C80FB0627F2BBE222F2D79809075B244ED49B1DD9712CA,132,124,8,0.6170750774519738,PASS
7DBECE55CA591886DA57049FE50949C735168E03E4C7433C8675CC504671E752,131,125,6,0.7076604666545525,PASS
6457C93C5112A342BD8C592E67B35E584124826F432213B1FA1F5A3306730491,140,116,24,0.13361440253771617,PASS
679FCD00ADE188C80427371CB38D5DED1869A38ED8243C30C9E2B0ABCEC7040D,137,119,18,0.2605890342736178,PASS
A3777262263A29645882CDB470D18135985AA46E836D0003F8EFC7DAB67F44B2,134,122,12,0.4532547047537365,PASS
4CD509BF0D3C82EAE0D36508936E5393D5A4956AF3EF3C872721D01D633FD3D7,124,132,8,0.6170750774519738,PASS
2814B74FC8BB1978581FF10A25E0AC40CFE68CBCC04BFF1886C51B66E1D70D86,133,123,10,0.5319710580974012,PASS
381E2C43DE2F94C30F6F9E5E088FF3060E04F1AD1ED7826B5CC6AD7205239370,131,125,6,0.7076604666545525,PASS
B9667513241AE02AC71BCA125AACE3AB1B965B43689DAE6ED65CB435F3A15ECB,125,131,6,0.7076604666545525,PASS
FFC3AD6C2870C4BC22110F08E1D918C08983069D93E3A25F21FB4B841D4B4EF,138,118,20,0.2112995473337106,PASS
F1B9097728BBBDAE58548787288593EE6393D4C97A9C59FC13F39551B0565533,124,132,8,0.6170750774519738,PASS
5F206D46B96DDDFE72096237E4EA55BD2D73FD4A18E82A713A4611182F61F551,125,131,6,0.7076604666545525,PASS
55CC599DC9D18B4643487379814E83A92DD1C5F9395E1E2643F6F1AE86531B6C,128,128,0,1.0,PASS
63CF20B83353F26A2C1F60B505571BEBAA4776037DED6FBAF8ECEBB919486076,121,135,14,0.38157390570502125,PASS
E0B7D9CCC8093FA4D04A75767D57048B285AA545F565673FDDAC4F8F762AD7EB,118,138,20,0.2112995473337106,PASS
EE96286C64F3012F7F219EAFFB4C92CD049F624AAC96BC83F3D14286FB2670FF,122,134,12,0.4532547047537365,PASS
82EECE24542263F7528B5BDCF79C81A96F944835D4B4B75FA2B86EDD86095E7E,122,134,12,0.4532547047537365,PASS
5D7292CEA8B039793CC81502F6D30B3567E8ACAB88463258F2D6BB8C5389CA6C,132,124,8,0.6170750774519738,PASS
1CBC16A2D0AB6D45CCA9273E23CB852ED82D7363DB59C3BC4836C50DAE55DB1F,125,131,6,0.7076604666545525,PASS
49A2312DC1844BDE1280B854CBF8E71B398F81B0985C3F01C145B177E147B9FC,135,121,14,0.38157390570502125,PASS
60A1B765D6B1DF806DB72BAADA5C2027C28092B30519894643AB73F6082FAE91,135,121,14,0.38157390570502125,PASS
22724C82A26DA30A5038CBE0D65EC3507768F182DFC57BEFFA169887487C8DE3,130,126,4,0.8025873486341526,PASS
DD4DCB4C31973F12CD3BECF53853EC87B2FBD2E9BC9B9511C2D71A549BB73451,117,139,22,0.16913144470267139,PASS
7094DABA49BA66F2EC8E252BC90062AC45250F0435D32828896CFDA7FC583BB9,134,122,12,0.4532547047537365,PASS
A11C7670024E1F3C7C2EACB3FA2C6390EAA35C74287A6271241AD2D91479A9B7,133,123,10,0.5319710580974012,PASS
AEFAD12519509F3F75CBFBCD12FEE61B153E8AC9B96CD6B1B82FFD122E0F7280,117,139,22,0.16913144470267139,PASS
BA9532E24D050063453604F2796A8AA44D7DDCFA9837C5C09729DAC398831337,136,120,16,0.31731050786291404,PASS
E2D804380E4763D2B4D3DDA95E9ACF05B3BE46925266EFD008841533C90ACCBF,132,124,8,0.6170750774519738,PASS
11B0DA56F9E7DE1B727A97B3A8E91AA34F515C533EE4ACC309838F588F39C4EE,122,134,12,0.4532547047537365,PASS
55320844868780867A28680F72ECD9C68470AD3DED932CA612512034BE9ADA0E,144,112,32,0.04550026389635853,PASS
6225113923733A7BE1453CAA270D6755B165969F543B52814DA5A26B7E29C6CF,129,127,2,0.9005235503397743,PASS
CB79120606D0BD5425B8B0E6CAE5E4E239A2871CB2F83161302A9B290B84BBB1,139,117,22,0.16913144470267139,PASS
8990C2B2B780E6221B1B3B4FCD574E81C9B7BCBE7F3A03C43B8E6A11A2CBE86E,127,129,2,0.9005235503397743,PASS
1952E4537E9A4D373FD10B415FC98251AA3CDBC608FEE8958591B975C27DB8C2,127,129,2,0.9005235503397743,PASS
B3CFD62DBF5884C744B24FC91E48386F000843893B5BF96EE764C281C398556C,132,124,8,0.6170750774519738,PASS
8F5E5375F301279CF7986B621B9205EC6BB325DDB2478E04E8F06154CA85049A,132,124,8,0.6170750774519738,PASS
E130FE57F097524E09E4B09576D37DA7106BDF4C8BAFCE0CD7D1474AA2316A64,125,131,6,0.7076604666545525,PASS
99B969DA164E680A1A4D87B7D2DAD2050C89D5D7C956A3BE8A0FE989B1CD9C40,131,125,6,0.7076604666545525,PASS
85B02731B8A8EB9DB7E0120BC7E69AEC9B8F8494F1558F47A8EB40D9969CC05,132,124,8,0.6170750774519738,PASS
1C9CC0F016261153DC1736CAAF7A90E0B9B9E9E3C4A1BAE9B70B43DAC746B509,130,126,4,0.8025873486341526,PASS
8E2AF7AA8652BFC3FA262E94C3791C018A6F57A17A908C0947881F74A66CE3C8,132,124,8,0.6170750774519738,PASS
68541D4A536CB639AEA93D50B0FDEEC153DCC607940A5A85B5524D033939D175,132,124,8,0.6170750774519738,PASS
21C08B500EA0C3A9EE8CE7224AB82DF55587FC3BB9E9DA846D23E2A5BB3DCC10,131,125,6,0.7076604666545525,PASS
3A41C83B32298672A5F908DD13B5F9ECED6B68E4E9599CD609B342E12E774513,128,128,0,1.0,PASS
F035A4A10B09A7963818AB6AC542A9FBBF8A3C82B3F5767032ABD3002A9C2533,135,121,14,0.38157390570502125,PASS
C096FE550C423B783BE80C0752357EEDE0CE4548F577773C0B63BB77F689156A,123,133,10,0.5319710580974012,PASS
58D4EEAE1863CF412CFF0E26BF89026B0B5AE53024B1AB46D2C72EAC552F4074,132,124,8,0.6170750774519738,PASS
705BD9C49C67C559278AF0E721839C19F748492F4835A5434FE1FFABBC89D9BE,123,133,10,0.5319710580974012,PASS
F9097F07CD770B68F75BAA8A569C50A452253447DE0131F1727EC9EB2299474C,128,128,0,1.0,PASS
6E5D35CE847ECF50A8217C9F60A566C1B0BA96D4867E0710AAF8AD725234DB59,129,127,2,0.9005235503397743,PASS
32C8F94124F17DB86C2278C2F7AD6E54575562B182FFBDF12B2C8DBD3666C2B8,123,133,10,0.5319710580974012,PASS
857938D5ECBA087DB0130F2ED78A93A9F8AB4D1D6A759CA9426419347B964A15,130,126,4,0.8025873486341526,PASS
FC4F421A04842B8E7978269736235DACC16EB7F1FCDFB29B7F0A3666ED3AA9D6,119,137,18,0.2605890342736178,PASS
703D403772F2C3291E078D6393E265F7C1AA33D5F61C031778EF7F8A68C63058,128,128,0,1.0,PASS
276585C8B9D737A944F6BC2C932DFEA87B2DCBE9F216EDD1BD35915B068311FE,118,138,20,0.2112995473337106,PASS
D279126D655185ACBC2FDE6AEB7AA6016D0827F6F86CAE8F1F82AB91C3D4A578,124,132,8,0.6170750774519738,PASS
8E8E088DC6BC6F372674669220DB88E26562BEB53BA6A14B1679B89BBBF9A678,125,131,6,0.7076604666545525,PASS
9CD154FEA5D4DC851593BF5EE97BBAA75A39E6F1BEF324B9CE0953F16B62D3BD,110,146,36,0.024448945310089426,PASS
D09B535822A887FB072FA948B32D85E456988EB36F78260B9B494678225F15C,135,121,14,0.38157390570502125,PASS
E44965A543B583254CD4DC1B085B820EBF38289AA2CD3540B94EF2269D6FEF92,133,123,10,0.5319710580974012,PASS
35BF102134E7A22A342D531A139AEB5F5E089923D911E8C832CE3DE37B75D3B4,129,127,2,0.9005235503397743,PASS
5B261B76E8368F370AD6F6B5D474C589434422BEC0EC586B7CAED741905D1574,128,128,0,1.0,PASS
592A37A37D4AAA9E618328265F2F0C583EB4F8A242B1038BC453EE13E374929A,134,122,12,0.4532547047537365,PASS
A4B196CEBED746FF08D3BFC5850B2ABF6EC00FE5DC4BA79F96775483545601B9,119,137,18,0.2605890342736178,PASS
34999C050B18A191A0E4ACD1BC14D35DAD3EFBB4B0AB538A5DAEB2C42CA98E1F,132,124,8,0.6170750774519738,PASS
F7FB80A98E84F66974FBDD1B582B96A58F5E7AFE8016CA41729228D53BBEDFF1,116,140,24,0.13361440253771617,PASS
CDE7CE64995A4F13E5C69CFC8528E132DB291988D410C78E70D7FD83E7B752A7,123,133,10,0.5319710580974012,PASS
7A94D1C9954AB365C6FFEA8FD913E520E611187CC4D844152E94FE7F2B4E79EE,122,134,12,0.4532547047537365,PASS
B4A0411C4DB770FB9254916AFBB08039AC8BCEA5B6232B12E97DBDA35EBE749A,126,130,4,0.8025873486341526,PASS
A549E14963BBC26F7073D9FFD19B2F9F77AD92FB9C1183939C8DC9AC3B6FF638,112,144,32,0.04550026389635853,PASS
C72803521306424FB8229F6B98A124FD397ECE5132B9F5A5FDA13539C2A7B3F1,128,128,0,1.0,PASS
C3F90CB657F6F5CF66ECA40E1B82846A242808A9601F8CF935BBF561BB5A0079,130,126,4,0.8025873486341526,PASS
72752DFD20386668E69C957321566EC52E93D7748E3B41B0EAE179A8C0F771E2,126,130,4,0.8025873486341526,PASS
4F985F0F225B786FB90D029463523973A7A1D05617F19BC8B4692B6708FE7B8B,126,130,4,0.8025873486341526,PASS
CCA3AABB3A598D7D9F6F98E1CFBBCA2830341FD241E034AC9B83F9DB46358730,124,132,8,0.6170750774519738,PASS
54AEF1F6DCB00781EABA3B6506AE15752DA021965C5A783F4A18C3E021D8A6B6,133,123,10,0.5319710580974012,PASS
9AD815253E4D7114C4B9D929CEA24627428CB08F36AE79385E3C7AD565ADC56B,129,127,2,0.9005235503397743,PASS
7EE95394C20A0313C82FEEB6EF064C477DBC2CB990E341DDEC9C0D3B7A49BC9D,124,132,8,0.6170750774519738,PASS
408CE4B309847C3DB36FBFA30B3C01EDF239780CC11C09D7144FD4133CAC1511,137,119,18,0.2605890342736178,PASS
29DD173737BA3B649E5E658479281E3799DD37963263FD1165991C8C47229468,127,129,2,0.9005235503397743,PASS
EFC215E73C9001BA87DC5C85BEE7C378CD06F510C1447DC096EA979DED8EBC,128,128,0,1.0,PASS
248B72C81F204273BA8805C0598E8BE0D7E85C2896E61481A23929BDA419D465,145,111,34,0.03358661289689768,PASS
2457450B982B750175584C9B9DCC7236155AA21BE1C140076FAD7B6EA0B1B407,137,119,18,0.2605890342736178,PASS
EA0D583B5041CF7ACCD7B60468CF9DEE67F83F89407F97A3AF3F7711BFC01648,119,137,18,0.2605890342736178,PASS
A2692A8AA086535E69622520232A7F836C2E32711BDF1304BCAAE490EFE1B64A,138,118,20,0.2112995473337106,PASS
81DFD2A019D6AA53B297D5D33E55DF82745CAC2987B9AB8F720F94365760B698,124,132,8,0.6170750774519738,PASS
B4543D7BDC4122CC1C1F1ADD3C3AC72707C3087D93FD7C4885A72D0CFE827163,128,128,0,1.0,PASS
22A904F02B956A195F4FC86BAFDBC5E02B7E3733579A3BADFB43436C06E5F8B3,120,136,16,0.31731050786291404,PASS
A4F1D129CD297BFC9485860682C2D5AF2375A3859CC574C0F6E85FF492510CDE,130,126,4,0.8025873486341526,PASS
698A94D2730C9A854368A839A33B7B4B76F88F4CCEA0968022B5B0B1F54EF9FA,130,126,4,0.8025873486341526,PASS
874E6B3C4B90A028FD597D368BFC0319BB0E6ED70509E85D7D045BBE04FCCA34,128,128,0,1.0,PASS
4475C39A55E6097DE33B5DA80206E6308C7160E19D7A488D5FBB09461D83A952,136,120,16,0.31731050786291404,PASS
87D32A8F8AC3E216826A1C24FAC2B59D2DEC0936837C20A2C17E805AB99E6C7D,134,122,12,0.4532547047537365,PASS
F323EC1CAE194A2C59271D15AB2573D21209C2DCAD7FC970CD1055880F7F3276,131,125,6,0.7076604666545525,PASS
1A5F8B20B68E42D8B3EB6D3C8A71A8734C649A87EDF692DEAF915DB18385E146,126,130,4,0.8025873486341526,PASS
D917BA88296681E7A6161D4B1DB1293DFCDB6032AF411715CC68E5C5B165ECAD,128,128,0,1.0,PASS
9DE769740DEBD9CD4B12CC9DA999CE5E6D94C0674C1F7E0D65ADEBE3D42376F8,116,140,24,0.13361440253771617,PASS
1E34DBE0EB436229289F7D546469F505AEC7B4B21DBE218DDB7BF9A631057D35,122,134,12,0.4532547047537365,PASS
911698B972381019537232C9AAC9461745CECBDB5191D0946C31416231579C2,145,111,34,0.03358661289689768,PASS
5132DE0AEE322C75403D3DC6767A7762FEB4185F92CD24D2348535EE821896FC,128,128,0,1.0,PASS
C81C103CF281DEBA8A099A6054A735060874E76B9DBFC3F77410B14066A21EE0,139,117,22,0.16913144470267139,PASS
F809ED3D8E554DE7CA96B86B3DBCBCD187F693B11E0728F15CB45E00597D80E5,123,133,10,0.5319710580974012,PASS
48B8937395CC48B469907F3A3A7FF90CC77B86F7A925F1D98D2F60F1C4A39B6B,120,136,16,0.31731050786291404,PASS
7181020F9FABFF5949A98E347594D658B0C8935A40FB82952DDE3EE390D55C61,130,126,4,0.8025873486341526,PASS
C7D90B58693E5C2DD2FD437897B97DD35177275F869C44E0BE6BED9092D8F637,116,140,24,0.13361440253771617,PASS
5B1DA0A9099C4A81B1ED0E646A3959320553B624D459C689BE6DEB2AC66EDCF4,132,124,8,0.6170750774519738,PASS
2F62AA279DBC543F67F42B3F4053FF5D813DEFF66AB5475E5A976BAF053747CB,109,147,38,0.01754895019147673,PASS
6D4CA611E59254EB1D610AE72DD232DD81BADA8C686AEFA39B69E2064BEA0D03,131,125,6,0.7076604666545525,PASS
A12D7506585E40B492532D74F74C7B4E1C58918BFA418A6FD7136ACF38592B5D,129,127,2,0.9005235503397743,PASS
7893E300B6A7BCEEE27392E7B2A4C151EC2C575E89E194A46BDB106E0D382D0C,131,125,6,0.7076604666545525,PASS
FB428BA98EC84DF52E1988AD05F3716445E2B3D90E2549F49CF8A00AAC86E70D,133,123,10,0.5319710580974012,PASS
8B4C87A1BA7CB781AB3239F7016A1A18D84FB06BD6E76B06D95E9B9FDDD2A4E,123,133,10,0.5319710580974012,PASS
F99BB0F7BA29F50A96A299654774CE12E5335104639E1430B9CA5FE8257DCE32,127,129,2,0.9005235503397743,PASS
9739B593FBF1588506CC6F0ACCA2A86EF28E6BE0343C051559574FE2DED1DDC3,124,132,8,0.6170750774519738,PASS
19E56386634167B6FE89B63809203550D5FDCC6918B907F02AF0F8D706015F5B,132,124,8,0.6170750774519738,PASS
4CA19CF5E39730D8A86342C68C5012F718899A693D1E4D0DBA740585D4BBC30,140,116,24,0.13361440253771617,PASS
63948DD2E8B3A1A88EEF04E4800350091432CFDB8812940621A3B2FB65DB1A9C,143,113,30,0.060792723530522785,PASS
909B70453C10BEDF7FF97EAF12519274B4854938710FB2ED7766E8205915A961,128,128,0,1.0,PASS
5DD7CD2594245640576D61D6D4217C05F1121AE8A95F49D54D575A3069B17799,131,125,6,0.7076604666545525,PASS
A4EC51EDE467D8E1C5333E37AB10481B5E7ECCBE3322BBBE821D5FFC0E2B08A1,124,132,8,0.6170750774519738,PASS
60D007E3A2A4B75F6755E844016D74EB97A346A703F26C33ACE672B20047E6B0,133,123,10,0.5319710580974012,PASS
BD2F02D086F24F8B43AD6631271C549AFEA876C5D4A0851273B70F9340C75A7D,130,126,4,0.8025873486341526,PASS
C0C60A35012B6AC5583CB622C690EE346FC7E8B0EF721B6136EE5C029564790A,137,119,18,0.2605890342736178,PASS
CDEB6751D6F903B3771BA981A564B346B8C4AA50404FA30130C941DB0E8CB157,135,121,14,0.38157390570502125,PASS
3494325D8F07A57365E8E2F650B34C1CD9984B0B5C8D33FA0D4D9056FF018B7E,129,127,2,0.9005235503397743,PASS
9C3591E8B12C068E4B4595D3C407EDD1B62C87E3391D48A70C27DE0DC25E318E,134,122,12,0.4532547047537365,PASS
2A6B15D9DD2FE2149A1877CF4B11BA0FFBAEC8A439646FE15E69E311EF916787,120,136,16,0.31731050786291404,PASS
ACC20899B291D56CCC398592ED168355C6480584B1455C7C8F1AAEFF4161CF66,136,120,16,0.31731050786291404,PASS
9B469697053FE84409FEC5D1D150777F0FA40E7720D03088FFD56C2696932236,131,125,6,0.7076604666545525,PASS
1F0616E9B80B58459C3440FA787F5084A401A19F1AE322671287CDAB1BC90AF5,139,117,22,0.16913144470267139,PASS
E501E97E3E624186882FA29297B483B74E254B52462F4740EC28199045A89BEE,139,117,22,0.16913144470267139,PASS
41381409EAEF0A013CD75017F689AA2C4E73748F758890187BE3F687B44F7D67,130,126,4,0.8025873486341526,PASS
7B71D07D1A50787F4BF5757E03650D97A7B38F3BC09781862D27CB01FD591DD1,121,135,14,0.38157390570502125,PASS
F8401BC8AF5675EA4EE807102DBDAD2BF3AD74CE2C296327E41E6F4E620EB5BC,124,132,8,0.6170750774519738,PASS
B74813DBB8CF079E7229823D36DF83BEE95E2CDB96B1287F42B61E006FC8C601,126,130,4,0.8025873486341526,PASS
9CBB2A4C808EE2B7C2008A49A6113201CD4B80ABC8B4A3DFAD4D99857288286,147,109,38,0.01754895019147673,PASS
10DD7613ABA1EC099A56C1E68629064650DEDAF2D649026B18E19C491A17592F,138,118,20,0.2112995473337106,PASS
F34C7A9098C68EA90412BE31437D5C32708541B6C3874127934E05C054B4291A,145,111,34,0.03358661289689768,PASS
8661B1F0AE14E793E03789178D5F1DA79BE1FEA3041DCF979EFD60EC93BC7EA3,117,139,22,0.16913144470267139,PASS
7A010E097DE92E86BF2E6476044D3086B6C0BC898BAF4E9B4788D814414EB305,139,117,22,0.16913144470267139,PASS
85AC4281C1BD9AB16C4506DC64161CB6827C519657541C1FC910D589D9BDC320,141,115,26,0.10416255883043901,PASS
4BA88FEF7A5786E2166597461460B79CDA049F1C87D03471DDEAF17E61C5DC3B,123,133,10,0.5319710580974012,PASS
677DBCF326FD805E6ED6075CC6A8E3B824DA2DA4B64AECEE88C453189B9FB154,123,133,10,0.5319710580974012,PASS
17B4B40706F96A07480AC45D17404F8256D3415A4F9DF19B2A5FB685F9F238D0,133,123,10,0.5319710580974012,PASS
BE5F118C2B0122672DF59C6C44BF8A17EA4B089C23B36C0FD192056D250D85CE,135,121,14,0.38157390570502125,PASS
EBC16BDA5CF99C6CDC179CF87888ACA5198C57E169529BB61D934A4ECE42B776,122,134,12,0.4532547047537365,PASS
A83087BE8297A88C89A48FF20EF37F8C99BB22465F2C67A071E0401E94123FBC,134,122,12,0.4532547047537365,PASS
893E7A88E163A4A660F2CB16A18B38E75E0FCB24E70D55BE05B80ABF1C4A5DB,131,125,6,0.7076604666545525,PASS
6859FA8A9AE63EB7A164FDC7EBCD175482808AD0DC29944DB142BB1D230DCC84,132,124,8,0.6170750774519738,PASS
A4FC606C7691BB32CCFC74C47DE4291AB2935217AB40B788B37FD62647E76FF5,120,136,16,0.31731050786291404,PASS
C50DD28A8124A37C7E5B18D6A4459486ED0B7D1012D697DE7F1BA59F6D448570,131,125,6,0.7076604666545525,PASS
783DBC83E0E4793855F1733BE10F505DCE97663BF6082BD2B743F7202648F1EC,124,132,8,0.6170750774519738,PASS
E4016DE0C76AEB300647D852000529A881E276183C66BA7F81E1E477634A85C,144,112,32,0.04550026389635853,PASS
702174ECAB7B0C3918988FE0A7827B701385695AE6CAC90AF083A5045EB0524C,141,115,26,0.10416255883043901,PASS
F51ED3C18BC5D72473815FABECA281F54F16909AEACC562776190ED686843B81,129,127,2,0.9005235503397743,PASS
A31B227C16CC3DA2215232C65770F1DBD29B8607CFDC050A07C4CBB4EC95ABAF,130,126,4,0.8025873486341526,PASS
2C2E5ED7DFDDCD2333D6E184A98EAA53022285BC71612ECE1F393F9EA855599A,124,132,8,0.6170750774519738,PASS
871D11ABBF3E27790F062962D2FF55AF82173DF93D97CA44213991EC83698BF,124,132,8,0.6170750774519738,PASS
E7A57DD278A5E6BAA1F600E51F7C12D016D592C8C31028BD65A035DEFFD942D4,127,129,2,0.9005235503397743,PASS
E64A031FFD606CD85F87F27C74C61E973D9D181480DD4A86DEFA4BFEE1C8CD7E,119,137,18,0.2605890342736178,PASS
31903F83643B7C297F5EAAC9C8173A87B8311BD0528DC909C6145102E9B54F6F,133,123,10,0.5319710580974012,PASS
7DE44362315A1EE9ED9F525AEB7010094C1AFE4E8B40722411C1F11F655F6550,134,122,12,0.4532547047537365,PASS
A57625F1F431464AFB243ED499D18F717A3C54D1C7381FC9D361644AF1429E3,129,127,2,0.9005235503397743,PASS
1AFC8871EA7D7B66B133344A6DA6613E428B8B37CC6853297924147E0A2F5DE8,129,127,2,0.9005235503397743,PASS
2E1A55F6A8C2E8D6702AA751903355145680902DBFA4448C448BB8593F3E7D4C,138,118,20,0.2112995473337106,PASS
4BD0B4D1D331BBA107E5F579DC79D39778840CE977D69A8DC504384DE414E843,128,128,0,1.0,PASS
2AA51C2373A6CE91C34E307D4E0BDC984BBF4A3AA1676762D5E3C2E31E9FF398,124,132,8,0.6170750774519738,PASS
96D5A8D2B424D3E13C2F2C818E920DEA3E46849CD4E00AB92246E59D2F7BB87A,133,123,10,0.5319710580974012,PASS
CC2E57F3A4BD4D49265AE25AD501FA297F9427792B0703577E62B866CF40C8A8,128,128,0,1.0,PASS
5DB451572B1BA04E59F78F34A726FF1376739CA86D59420D105C1CBBC5A54490,130,126,4,0.8025873486341526,PASS
280518D469968518889075F89A93369580F9A9BEBC619C09B8054D77E34D2107,142,114,28,0.08011831372763423,PASS
599FA62A8D8188D9D0EB3B4A3E1FC686F1C82718900C842FAADB60AF8A53AA34,135,121,14,0.38157390570502125,PASS
1A88BCF7660A2BAD0AE087003C3855E33C85C3D76EF014909D7699CC61281245,141,115,26,0.10416255883043901,PASS
8C838181166065FA480338105AC74AFBEE84ED57AC6DC126A3110E86DB5D6E55,138,118,20,0.2112995473337106,PASS
45E71FBE716CAAE7361100B37599EB459183CE20A95B96F63C507C2B4E1486B1,130,126,4,0.8025873486341526,PASS
3E606929C71DE29AE4F187F8DA89CA67E1DA82D5255D3C6E8B4F5D868010E6BE,127,129,2,0.9005235503397743,PASS
6C90A0DBA7105B40598C38A616117B08306E7449398AA1295F508FCDB1EC7861,143,113,30,0.060792723530522785,PASS
D5657E18B8789795D471FE900516D037AB82A9C29090C0D1718BA75A472D7B81,135,121,14,0.38157390570502125,PASS
589F5E7CBA20F60011028B08DD582FD8A09D2CEB63610D869DBF567F965D4A5E,130,126,4,0.8025873486341526,PASS
34FB86AE64623DA8F7BFCC9AFFF622E7A6C7ACEFDAF232542F0A28452BCDD91A,115,141,26,0.10416255883043901,PASS
613EC2CCD78802113902996BD30E054AC77ED5EA08D7EBA3F5413313C90F1631,136,120,16,0.31731050786291404,PASS
4C490AA5DD077B25C88A87DED02E6838993F31A56BF3D9C6742B7A4FBC0ED64,128,128,0,1.0,PASS
4EB26305F3576BF0C4B8B9CC48DE25D0D6AD0C0C87F1CAAFC7FF8572839EAA7,124,132,8,0.6170750774519738,PASS
D417CDA5389C6CF9725BAEB0D7DE4722708A6475FE500DECCFB0B88550F8A0DF,124,132,8,0.6170750774519738,PASS
7C67CFEC6B02E8845DA1850A4E8043CCEB2F33BF4DA8A90AB8469CE0725C9C10,136,120,16,0.31731050786291404,PASS
69D736643C0E67C963387B86EF88BA65C4E8E41FF3DFFFAE0CBBC54F55DD0911,116,140,24,0.13361440253771617,PASS
C332865FE338EE6B574CD26855CAD030401B65F0182C02C263617DF8FA3088CD,138,118,20,0.2112995473337106,PASS
D5951603B0AD43A632AECB40FEED901DF8499DAA9C2FADEE9EA8A6EF384A92CD,124,132,8,0.6170750774519738,PASS
E350218DB9368D9260527BDBCB073DBA25224DA77620E24B5CBDF76F01DC44E6,128,128,0,1.0,PASS
DBE91F3576F2DAD434B83451A596BAA010028056F5768FD60C86952618058263,139,117,22,0.16913144470267139,PASS
A289ED94D8158676664A1882E717F46AE7922D1B76883D069E1BBA93E2CF805B,131,125,6,0.7076604666545525,PASS
A6E6F972F881839805FC57A4505B904B03C85A0FD2B35B8BBF77B81FC4CEC5AC,126,130,4,0.8025873486341526,PASS
3F21E37F809F8E3B578BD7BE819B826D82BF09DA0B510852018A7F8309AB8267,131,125,6,0.7076604666545525,PASS
CD51684CC9F0C1F9F825086AC01B2C4F2EE0DB489D3FA0E76939F1520F1848D4,136,120,16,0.31731050786291404,PASS
D7416467D88F01024851E87A3B3623A737F324904F1EF6AB709F5BCAABFD248D,127,129,2,0.9005235503397743,PASS
7D33F17436DAA9134FCF5D482251B588D29E8EA5741A9B52D923A670272469D3,129,127,2,0.9005235503397743,PASS
8D54D286662E1885EF050B59D5104AC63B3664AE4C571754F5A3C0C6CF063396,136,120,16,0.31731050786291404,PASS
2883D26181D9E03429F673192DEDD6D31268B4361C9CDFD56920B0CB0937133F,133,123,10,0.5319710580974012,PASS
7D1FE9898F923712739F5FB0EAA9171058B25F374ADA088ED57A0DAC5D6BBA09,123,133,10,0.5319710580974012,PASS
D72938431274A800DEC14E79A98D10606615DF3D917B913674936D31B0F72731,135,121,14,0.38157390570502125,PASS
81FB5762621C178BEDFE93205F8797B94D4569A1059FBD30DDAA69475695B67D,120,136,16,0.31731050786291404,PASS
92389CC543DA2DA47D23F6086722700774906BAF7E05B74F271446577ACCA1C3,132,124,8,0.6170750774519738,PASS
D73E160F776CC52B2723B1A6CF99516120F9D07214BA7BC2FD0E1377ED61D4C6,123,133,10,0.5319710580974012,PASS
D2B01DF39392974B6C480814800230D130F2D6ACF91ABDF541202940FA8E2DE,145,111,34,0.03358661289689768,PASS
F32403A34B36328B29921DF692B052C211B793A6C1FC143A1B04EE228A935B8,142,114,28,0.08011831372763423,PASS
95626D4F064D79269896BB775C97BA2BFD7A8A586E9B3585C7F3277C54B6CA6A,117,139,22,0.16913144470267139,PASS
A9B55608F02829C125CCB0B70D2352B3F5D469249CC5E240A8621F0BA332777,141,115,26,0.10416255883043901,PASS
E9D95B5456FD8810D827BB93783BB2163E06988E9415874CA076928B3602C408,140,116,24,0.13361440253771617,PASS
9206DBDEDD62799985E11965560EB4B05DB453F1BCE0A927712F500B538B1E0C,131,125,6,0.7076604666545525,PASS
F3A9660E7E27F654B441D535D653C9F4B2531571512CBDACDC35520D304BF345,126,130,4,0.8025873486341526,PASS
D0C76BF460A0E5C8775ABA5529B9E99D5D4C8887770DC97814F4D95022A266FC,129,127,2,0.9005235503397743,PASS
434D9E09F609AB7F7848733BD7AF545CF998E9498143B7D3EF2793FE3D653F09,115,141,26,0.10416255883043901,PASS
3BBA83C509A6C3CC62B7F9D17941A6681088CABA996BA5AE16A76E8032D6C35,134,122,12,0.4532547047537365,PASS
78A5D4FEFF11E0BB601BDE988BE9E81B3E1375140BC15CA9CB4D8A7541F70323,126,130,4,0.8025873486341526,PASS
4D47D6CC879257F647B80BC4B5AABFD651DD16A5130D7AB6B4C80A224FF000C4,131,125,6,0.7076604666545525,PASS
B6898CBF14A0FE72C86BFFEEC560792B1E7CEE4C762C64AAB05720BA7E94EA82,123,133,10,0.5319710580974012,PASS
5E5FD79D0CFD94DD38778ED1DC5E2FEB76AF449918FEAB2C8908B46A5BF0FA45,114,142,28,0.08011831372763423,PASS
65F3DB480DE0A41FF3B29390081FB5581D522BA946F422D26CBB282A2B74B578,133,123,10,0.5319710580974012,PASS
16949051BB600969E69C43783EC9D2549D6050F8E87D52EB8FB58F0232AE31FD,132,124,8,0.6170750774519738,PASS
6939CBF683EE6A27402E26D4BFABFC5DC16CC141927C49CCA4939263A62D9B6D,126,130,4,0.8025873486341526,PASS
18D05BB9C9C72D82B93065F0FEEED4E889AE2F5ECB9A035B5A083F6F56BCCF49,121,135,14,0.38157390570502125,PASS
6258EF34E27CC25A8664BDD346E272A9E990A08EC1EDDBDE3B3ACF8D914386B7,124,132,8,0.6170750774519738,PASS
D960738D87DDCDF42350D86A115D3EBF948EDC9319FBA002CD691A8274F9D284,129,127,2,0.9005235503397743,PASS
FF21EAE91FE0AD379452BF18E6C85A8F32EBBBF6F05A49521DE140DD43113688,125,131,6,0.7076604666545525,PASS
763A8C8ED44D341043248ACF892202BF8AA5268BEAD0E12F88040BEC32DDBE4B,140,116,24,0.13361440253771617,PASS
7FC923DE11915E9DC551F1F4E95BC83CF7C5317B4E1536777846D23CBA97C39C,117,139,22,0.16913144470267139,PASS
82F4D2FE4E56119AD0EEED33069CE4085C982ECA41C1577472C1D23E5634F77C,130,126,4,0.8025873486341526,PASS
22BBB9A1CB812244F9DA0C6BB93CA8E3111CA86B0CEF6017E09F641E70BA10C3,137,119,18,0.2605890342736178,PASS
3F6B2E9ECBD123845F2A94D4CF677610A0290A875C72729B17F0BAE790F42BA9,127,129,2,0.9005235503397743,PASS
132FC8231BECC0CF540586828F777CE136F5089C239CDBADA36F0F8F91BE6E5,127,129,2,0.9005235503397743,PASS
BAAE120DB09AD82DE6F56EA2BCA81C40244FFBC150CC3098B5C169AFBC3082C8,137,119,18,0.2605890342736178,PASS
B7066B41FDEE5FC2C43207521908CCCB5FF3DF39393F4D91731BBC475B3665BA,118,138,20,0.2112995473337106,PASS
3B71E00C96BD673C0CECC4EB32690024B7F829ADDDD6FC07800F893AEA160BA,134,122,12,0.4532547047537365,PASS
81D414A7A3E49866913998971B0D00606B21EC50CDDD3D0E4430CC61FFD84A61,142,114,28,0.08011831372763423,PASS
73DA8D03AD86335F0F74380AF91E1731920D8EF6D06F188B3021906EB5B3A864,134,122,12,0.4532547047537365,PASS
C0C9EA8CB77BBEF8E4F2BF5D4F67A5B0B1FFBAD3C71035EF5D2203A234AB8C46,116,140,24,0.13361440253771617,PASS
9A35094F2906FDEFC4FF9003614D0670A3E06C806726DE854AB9DF618428A6AC,136,120,16,0.31731050786291404,PASS
88D58A0BB45D23D1B4C6A8BDC66C9E190813324144F3CF53294F9A9D735A3212,136,120,16,0.31731050786291404,PASS
43F4ED9DC097351004BEB4DA7149B6E92AB2E9065BA168CB037630B0EB273270,134,122,12,0.4532547047537365,PASS
37FF5569549F099581352F8F4787EF38228E0FE58F952BFFDFBBD7A6EEC88625,112,144,32,0.04550026389635853,PASS
A95F6008F2E04B2D6A2443802E939624A4942427E0006A4AE1AE59DD5B1E4B24,147,109,38,0.01754895019147673,PASS
75C6DDF2AF96E15C228E97999E7407643ECD8BCFCF77061CDE76412483308A22,126,130,4,0.8025873486341526,PASS
F13CFD832983662C6E5FC25C5AA944EF2CDAD37A95B336CC06EC701523F44604,129,127,2,0.9005235503397743,PASS
73737FA4D3040EBF091DB0FE8BF82EDD0239FA3251F89B093EE7282B0B8D4A81,127,129,2,0.9005235503397743,PASS
26EB4CF536621B7D6EFA82C30F59D1DD7C919C0999358A2363EE8BCB7CBF45FE,117,139,22,0.16913144470267139,PASS
9B4F9C67D3C29114664262B2CA2EE51EC8D57BB3A99C0D06BA87E4A97EBE96BD,123,133,10,0.5319710580974012,PASS
449F76C7FC410460B0B2B21BFAFF658DB785FB2C48331519E8CD30F34018BDCE,128,128,0,1.0,PASS
4FD055568121A9822248CE3C7DCFD9ED7F9429F814D1A4E2501C04A9B149456E,138,118,20,0.2112995473337106,PASS
4795C439016FED88B5B22BF589747D16BEBFBD6189B051EE0D519A1F9CC5283C,125,131,6,0.7076604666545525,PASS
1D407F17A6229DF678CBE81AE3711C3E440D4B62A94C239C3EC1AA7FA016DA32,132,124,8,0.6170750774519738,PASS
11AD95FB0FEC8D12EA38CB1372BA4033762186E115D09B0A3ADA07244ED1167C,136,120,16,0.31731050786291404,PASS
D786F34172E4878D9033978EE73890FC93D8F91D631D0A0E895F3BB99EFB0CF6,121,135,14,0.38157390570502125,PASS
3AF7A5C1D84EEC06303F69C593D78A3B7423A7CE6CC45BD0AC4584DD8E9CB9EB,123,133,10,0.5319710580974012,PASS
37E31C1E780436D2D399A2D14D69005C98B112B3298B9DA7EA8452F8790FC8BC,135,121,14,0.38157390570502125,PASS
82EA04726C8A91A2D834464529C8BF14941EB2C801D28FB3992232E8226A454E,148,108,40,0.0124193306515523,PASS
DD559961560908425394CF44113F2C70CA0A6527FB5C6384E7EDCEAC888CDB75,133,123,10,0.5319710580974012,PASS
7D407D5C13B9C43A8078C8185560A34F4F61535FD1B3F0979262B638C3706716,134,122,12,0.4532547047537365,PASS
BFE7DBE4F0531453A9DAB84BB5704D21FA1DF796370D2AD12987CA572634E821,124,132,8,0.6170750774519738,PASS
89B5EE75AE18FBE8E03FF8A61E826D46E8166099BAAC432FB766F2885CCE02B3,125,131,6,0.7076604666545525,PASS
612AAD920B464351D8E0B0013A62616BE520A249613D6B6FFF013DE524275E4B,139,117,22,0.16913144470267139,PASS
7670DA79CE5A7C69FD9DBA612813E1D3DD6307BEFED5E34AC16FA2E6F35C0593,114,142,28,0.08011831372763423,PASS
D648390345F9324FE8B518326D77EF5225CC698DF1299C996AB1BA59A6C56631,128,128,0,1.0,PASS
803B83053232FC8425BE120AD5D52AC57AE542DA9A5E9C307DBD6D075EBECA2C,131,125,6,0.7076604666545525,PASS
133206F7F191628291340A919F6300947408895A52BC33895E058333F4CFE39,145,111,34,0.03358661289689768,PASS
7289BC8E2316B68206385C311018996CF39E3A086369E8431D9630E58A4E7BB4,141,115,26,0.10416255883043901,PASS
6F51C0E5FF7F341E9BEF6AD0094D9F02A905186C67915A252B4D90729DA53BD8,127,129,2,0.9005235503397743,PASS
8EB75E45B547E1018F7E5B616AA31751386AD1DDA575DF6F1709CADD5A44B9C2,121,135,14,0.38157390570502125,PASS
5630A863AB4432F46AE5D4055439484019F348E778ABFB15264E93F189813C24,140,116,24,0.13361440253771617,PASS
77D72785756A812D65FC72A7EA2B94EBBEAB2DA44E2D221A822854082AA1DC98,132,124,8,0.6170750774519738,PASS
79F2EA7BA249970EA3B86118EC55EBA38A5D12134E03D9559F54D918597E0633,129,127,2,0.9005235503397743,PASS
C0F7220BB660A20D39EDE881AFB47C7CF819F2F2FE006E46613959D63938DD59,127,129,2,0.9005235503397743,PASS
36D2B278096CD01B3B4AC54B4CDDF8183E2A1ECE4395A9C225C4AF34517BF53F,128,128,0,1.0,PASS
36107005D1B38F9C27EFF3328FA88690B5325312D04EEBEFDCE19A3766C5B45A,127,129,2,0.9005235503397743,PASS
55BB21BEAFF66164CB7F9C9C30841C6CD5086DC6D11A125E533685986F30408A,134,122,12,0.4532547047537365,PASS
4ADE2B2FA774639B07CEF673AE67A27F7653E3E483C03B9E9064F0B37492B6BC,117,139,22,0.16913144470267139,PASS
123F98EB05C7991C6FF0650CE1925117FD84B885B85E2BB4D0DEA0B5FC85E8F1,128,128,0,1.0,PASS
FC24B513E7CDD3B3FFB277585CA1592AB6E3703B199B825CA9D9B6E6B78DC22F,115,141,26,0.10416255883043901,PASS
82EF08189FC627DD314A06141C345E78AC0BA681D6ECF26802D1A38DE49E4A67,138,118,20,0.2112995473337106,PASS
6BC92A492F6E1F2627C9480596838F4073E7CEB063892C4A09F0CD47A05225B,140,116,24,0.13361440253771617,PASS
EA2689C029A5A170CD9D2241E0F1D0C348C710CE5605FE46BDD6A1785B5F13BD,134,122,12,0.4532547047537365,PASS
CDED5C274F635426EE437D2ED4B4BA0D0E2D1AE8D68DAF94A58EFB951B1684E0,124,132,8,0.6170750774519738,PASS
C3C043AE56A7FCA39AAB6DDC0C683D490F72644C6A269CD0F5FC895D20E27308,132,124,8,0.6170750774519738,PASS
A1AABA7395AF326C70480A13EA75F89BA36B8A356D556E90A977302B0AD1053B,131,125,6,0.7076604666545525,PASS
7FD8519D8C6F4FF8595C5B4A6C57B7EE27E2299C536305D71C738CF11E53D490,120,136,16,0.31731050786291404,PASS
38EEABDC66231629DDC0949A572E85577EB2B4FC21F2F55AC87D41B29110D26A,128,128,0,1.0,PASS
CAD38E7C74CFDB6E595B879C3BEED77D7BD58F7F447AFFB14F7A65AFB22DC4A9,100,156,56,0.0004652581580710493,FAIL
222D4CF514F3CE4EDB04F3C11D19BC87C40127E34D5909252072D891F30470A0,142,114,28,0.08011831372763423,PASS
1470DDAB05950850166B109485E85F0B47EBDAB3C1DDF84CB60F5069EDB0A3DC,133,123,10,0.5319710580974012,PASS
2A7D5E02E2126EE31DCED33BF199D6DF65C628099A22F6DCD87D9BD68E9D334,122,134,12,0.4532547047537365,PASS
AEE8FA068D2227A0A355DD0920242FCCD3933B188950B4D8206E2B23330EC578,142,114,28,0.08011831372763423,PASS
A21505DA38BAB3FBD08C50C50665E009134D1F1EA5EF8C6F5E20AF06545968E6,135,121,14,0.38157390570502125,PASS
EB5259554CBB4DEBE0AA98F260C57E56F90A48EC06A1B7A3DC73264623D11164,131,125,6,0.7076604666545525,PASS
108798ED90EE2C099B10464DB945E05868E410EC9423A9C93B162EA67C9741A6,143,113,30,0.060792723530522785,PASS
4ECFC1B1A4155D42418E73C5BAB6F20A654C3DCF66D2377A082810E2124983DB,136,120,16,0.31731050786291404,PASS
FA4858C38638E2A255D615385B3E0038F8B5FD463F455D511120A80932729454,142,114,28,0.08011831372763423,PASS
FE91E5A36E813F07DF0E64A46E73088D0BAF81D897291A9F28AA1D450D5B9BEE,126,130,4,0.8025873486341526,PASS
7577F81A534FF2E1DF91C194FA8A2A748CFA6FA09C2D5211409DB92F5DCBAF83,122,134,12,0.4532547047537365,PASS
8F5D3B406359818EFC9920D75B66759FB88E560FBF8891EE0D8FB35E4D712106,125,131,6,0.7076604666545525,PASS
F04BA1FBC51FA6931AAE0A42004EA74A8458CD1ACD9BACF5E36B4B68EFD949EF,125,131,6,0.7076604666545525,PASS
83AB56D3439829FFFC85696B9426759DB02088AD3ECD03E339B663D2F53FA68,126,130,4,0.8025873486341526,PASS
60C24DE7CD891578DE88D80B04B5C5C26DEA340DF572F19518B20054D47E0C44,140,116,24,0.13361440253771617,PASS
F71382F514FC475A975E42419CF0527235F043F221CCD3C481277BFE3F75AA4B,125,131,6,0.7076604666545525,PASS
28ADDD6050B106F3BD66990D5329F578400237B6429C0C6277CAC36F8BCD3798,133,123,10,0.5319710580974012,PASS
66882BEEFC050E0968276D29C0FF66C728D5C77039E40BA57B83B814FFC756E5,126,130,4,0.8025873486341526,PASS
C0B99A26B574E3657799D298C5C822F5AC0C9642A7FFD6EBB349272A1B0EDE8F,123,133,10,0.5319710580974012,PASS
78A11C932B0F42630F00A2F659CC22A76D70A5F545CA35913B15047D8E3514AA,139,117,22,0.16913144470267139,PASS
F153E2102A52F79BB04990AAE71CCD8D6E7288E74462085F0213D52223947FDC,136,120,16,0.31731050786291404,PASS
67E220E2B1DB2DEC05868AC783468C87E0B519ABEA962BA3AA50F956FF5D5295,128,128,0,1.0,PASS
B34F99B69A70913956E80A431E6FC636005EE4B2765D326322847F3B6BF6DB1D,125,131,6,0.7076604666545525,PASS
5908C955D2C0F852CE36DEC205F025BA62CF666EF282E97B034D8C42CB7C3C68,133,123,10,0.5319710580974012,PASS
EB000DAB25A429F3E59C1DF524C4E1B09E3143F2CAB2675C24698C89C4DC4C83,137,119,18,0.2605890342736178,PASS
D0C2D4E74AFB2756E26C5FBFF1CBA7919263533B85A8642893F2E01AF601725F,124,132,8,0.6170750774519738,PASS
E446109AD733452321FE318412B70FF0585DEDC0CB7CBF6D3425016A7618AFCC,132,124,8,0.6170750774519738,PASS
46C95C5FECF0EB45032F15DCD43CAB96E7D0E664982BFBD292234B929399B7EA,122,134,12,0.4532547047537365,PASS
93D000C3C36B4113D69BB9EC87DC3391C5E55996FBF89E33F8468CB45DE6A8CF,123,133,10,0.5319710580974012,PASS
3FD6D6296E2443483D0CEEFCDBBA26D96E0764B0C42D0B20F8FA5FF47F54EB16,121,135,14,0.38157390570502125,PASS
2BD6CB68A2584728E10C27A972A3CF85AF25ED003A2F76CAFE3CAFB4AED8FF23,122,134,12,0.4532547047537365,PASS
8A149240CC519D308B09AC674FA425D44DBE73CD133471D76E39FAF2C1F8E52C,131,125,6,0.7076604666545525,PASS
CA0F63734B3FD146F75500842D3FFDAE88FC60CF2FA446792376F0F98A0968,129,127,2,0.9005235503397743,PASS
54E5001AE62DF944C4BC948D511AFF249E293370EEBB5B9ED8FF3D140D2CEBA0,127,129,2,0.9005235503397743,PASS
ABC9F5CC8CE7B4D2FA758FDC29D2BB41BC9F7222193265448750565BD571000D,128,128,0,1.0,PASS
C17B700D8A131DC80F5B68EAA81F82306E1406855DA0A7A0D839C431B87FFB13,138,118,20,0.2112995473337106,PASS
374FBF5E4A1F73CC72FBCEE11D174D2820B4D2599AA57B915F5AB4BBDEF53A15,114,142,28,0.08011831372763423,PASS
592AAC435F02CE504517782DF70B3097E2D9A929849C41CBA1CB879A393B371A,134,122,12,0.4532547047537365,PASS
D280755E954AEBA74B9CE92095BB1F53918882122C8EAA641E3C9EB4861D1C51,137,119,18,0.2605890342736178,PASS
24B753BEAF5E94FE4115B253C8E512F0722F007D62968F04524322DBE0D07D8,135,121,14,0.38157390570502125,PASS
EBFD2E2F143054674A8E047AED0DD4E7167A652CDA6890EC3FF13ACFF72EA8AB,120,136,16,0.31731050786291404,PASS
7FA6D19AFE74DBB587F67A8CA0CA1F04C22C8DF4CAAAEB8886B960F0FCA70F9A,121,135,14,0.38157390570502125,PASS
6C4D6D1EA72E8E1743DC8D561B83E4F5FE60D74A8BB886C3CEB2D60BC639450A,126,130,4,0.8025873486341526,PASS
4158DDA38C22FE9E5A46E228942A36FA8F6F9E41700E3765F79044A162B80FC5,133,123,10,0.5319710580974012,PASS
BF0449648353887B01F336B53A4F7E2B5C2082D11B5299D4BEB224E21FC21313,136,120,16,0.31731050786291404,PASS
A6D0C7D89DEF2F89299DEE7F1544502D6673395B93037BE4BDF7DAA0DB54F302,118,138,20,0.2112995473337106,PASS
C81ABAB80B9EA62BF4871BCD00702F59B1AC77300F9365A34A41CD3654F0CA8B,134,122,12,0.4532547047537365,PASS
2356177E3D3C45BEF42AB69E58E58B8838D78F0B251CA856E480AD50F66FC032,130,126,4,0.8025873486341526,PASS
D22120BB2AAA0656E4BCCC61D681BFD106F754D4FB2E96F0D1B57293F705ED03,127,129,2,0.9005235503397743,PASS
7A72C5D2D68D1E7A362D0B84B569D6BC426ED2A5B21DBCE67720B1BB2D2CE814,126,130,4,0.8025873486341526,PASS
DC01F07177E58E9501065B59FA46F3308914B37D776DB62DE199187DEE45FC3E,122,134,12,0.4532547047537365,PASS
389AE81D43B03BEEA77337A0E01B941851E8E903E7F84D6C21186FC524F8107D,134,122,12,0.4532547047537365,PASS
F44586A6D215B45EF38A86301E9CC7D93E59E4E28F5DBA3565ADF6530F9D81D4,123,133,10,0.5319710580974012,PASS
1F34A81780B8422E4C78C256B7723F0A0B09975B4B6865A82713FC825C566A0A,140,116,24,0.13361440253771617,PASS
3650BDF176D319822C40FEF9D85B3406C4CD77910776983B25436E805747B85C,131,125,6,0.7076604666545525,PASS
1473D81D7206FC555F6AE205FB5757F178B2F02B07108DC8E151036AFBC4F135,128,128,0,1.0,PASS
10925B4CB77FECAA59DE2ED54D1F1F0F1FED8DC5417C4E55CB76652633DAE48C,118,138,20,0.2112995473337106,PASS
6E5426C37C930B61914EDE2EC5DAFC49E50649F6D686E22D0B8530AF8D4C45C0,133,123,10,0.5319710580974012,PASS
5A513D356FA28318CB60F6A3669283B75C255E72179699D9B2C35B098A2A687B,130,126,4,0.8025873486341526,PASS
D818482A7105F2FFF2AC32B3FBD3D042074E0EC790DA10BE17B3CA731C3272F0,131,125,6,0.7076604666545525,PASS
2D0F168D1ABF7F0B905ACD0E46AB79F9B8DC009027A87040DC1FBD971900645B,134,122,12,0.4532547047537365,PASS
323B9C60769615550E6F537613C28E28E4BAA72571ACFC504BED6C4313ACB40,135,121,14,0.38157390570502125,PASS
C5DA388572500DD764C8B7AD675E1441D118A780325C7029A7219152EE7DDEBA,134,122,12,0.4532547047537365,PASS
C143D79E6F1EDB9AA568D3336AC899674155A7768931375CB922EE962B4D7793,121,135,14,0.38157390570502125,PASS
3D1F8C6E61A603E40096231FE8943145E83E928E768E361176869202834CF458,143,113,30,0.060792723530522785,PASS
1A7D6CE924E8B67CDC0930E57C9A8688C545EED2B750CC9FF30536510E18D4F9,129,127,2,0.9005235503397743,PASS
73F5AA6A5521F224FD66346335C8D7CE9A50C0A4689E30EF99D30A27F75A63AF,124,132,8,0.6170750774519738,PASS
3D970BC1B2F88AB8508C6C10EA65EE7C3951C4309E74F51BD13EC6C6DB2F46FB,125,131,6,0.7076604666545525,PASS
7D8C66FDDBC142C54798DCE3CA49A6D8213100C1E959118719B95C65A565931E,134,122,12,0.4532547047537365,PASS
E9CF3F23A0D51E1A7E7DEB82872F22747FE8FFDCFB89D99618F67ABAF77929F1,106,150,44,0.005959526470109114,FAIL
3F4E199AF3E5479A596BC7928E8E2BAFFB9443E657E203F76E8C270F54C794D7,116,140,24,0.13361440253771617,PASS
C588A6808EE1454107CC8FC000A5D48A38D5BF9C89516CECF48DF59D0C1DA412,142,114,28,0.08011831372763423,PASS
3B6E2453266D529158051E9355F20045E187E45D896CBD8E1349E28AFCA4B7B2,135,121,14,0.38157390570502125,PASS
A9CDAF8196B0B4FA73604759567C67C02425A07537963399CDD348A1A85E6061,134,122,12,0.4532547047537365,PASS
4E84CB04815C7276E8CF3A4C5C7507C8710F0602B567AAFFD602E6D2954E2AF6,132,124,8,0.6170750774519738,PASS
594BDAAD0F03708A7302AA9A44C6C1C3EC0585418535821F7BB0D9A827664CB8,141,115,26,0.10416255883043901,PASS
93CE76641A674D421323BB44D79989C941A51F63FAF64A45ECE142026A511617,135,121,14,0.38157390570502125,PASS
950305FA4FFE42C7132B3C69AF5F3EE8F871DE6EC559AF36EEE448D2183FEAF,116,140,24,0.13361440253771617,PASS
7B4EA00EB391649EC7D725D38A63D3DA25A371498DB91D94664CB753C70C77FE,122,134,12,0.4532547047537365,PASS
F5D86BDE7CF0E0C097E7C2384650EB176C1A7D791D5B48BEBDA42485B5EB895E,121,135,14,0.38157390570502125,PASS
2A0ECF6D2D2D1D0BB9F9A4C8BB0247004EAA68DBF052AD426AB13D76E35383ED,129,127,2,0.9005235503397743,PASS
98E4F18ED4ED03915421ABC9B58D603C8ACBDD3079D332A8C3215BF6A5688602,136,120,16,0.31731050786291404,PASS
1F446F80EABA8BEF301882C33CC48F16E888A4558E78FA3952A3321721E519CD,136,120,16,0.31731050786291404,PASS
627D6B4AD74C4B799CCB5C2EBA0DCAA6185F670518F81C9F7641E83A0D7A6D40,128,128,0,1.0,PASS
8C41E9D9450439EF8CA386DBABCEB563C43B0499BD263F381B96FBF9B1960D24,126,130,4,0.8025873486341526,PASS
F762FBF8A2B10E34434D811E6D18E8E8AC475F8A6BFBA3846F505ED9883B22B7,125,131,6,0.7076604666545525,PASS
4F6CF554FFFC88B15F100C48C6E5EFAE8CB6EC5D4C34764AA908EEA17BD29ECB,120,136,16,0.31731050786291404,PASS
654C8D9ED802A8FB2A8B4B6E0B7F34C74098C491570CF794DBDC54CA96E026FA,130,126,4,0.8025873486341526,PASS
13B120AF25B5F4E185D5CBAE6809A1DBE891DFB1456829E147B44D6D0C1EC461,133,123,10,0.5319710580974012,PASS
486D9E613EA518661413E38578B54D8FC09C5860A6428B3443C53B8EC7B6243B,138,118,20,0.2112995473337106,PASS
EFE7316AA16D3DBB208F6A7578F8BA242ED1967DB5B671D70AD2E92A6FD1BE96,114,142,28,0.08011831372763423,PASS
DB01F79EC9E0F09E43C788A57B03D4084785F8C090CC36201EF03240015CE5C7,142,114,28,0.08011831372763423,PASS
22950FB88179515D14C1B33D0C4A68A3A055CBBB395857EF30C3CD2B106C6E1D,135,121,14,0.38157390570502125,PASS
22020A7EC979329CE27F250ADF529B91A5997F95B1190B838F5FA87D856EA46B,127,129,2,0.9005235503397743,PASS
BB5266F0A5A3D2108647420303D170F8E0CC0710E64DDBEDB06B4A806FBF8D99,136,120,16,0.31731050786291404,PASS
EA27A35375F5E79C9205C22B4A5B791D62B983499222767BCA2DC4CE4703724D,129,127,2,0.9005235503397743,PASS
53BF82EE6E17B038A55F080B42A7FC37095625AB0EA2351D3FD93C24022678B7,131,125,6,0.7076604666545525,PASS
7195A07D4836D35AD6738E219B06326DD7818926C7A3F7D5CABB53EE4CAA8FA1,124,132,8,0.6170750774519738,PASS
EA3368938561EC1F590FA4DDAB6793D103CA08407DFBDB650453A080742DFE17,131,125,6,0.7076604666545525,PASS
8F652C3FAE1236B432F2AE197912C0F9AE99E170094C15B382D26B34EBF12E12,132,124,8,0.6170750774519738,PASS
BF12598A6B6ED132EBB8A24A52888F3A36592C4CA949CF755083FA0D738BCB49,130,126,4,0.8025873486341526,PASS
369A83FDE51C77FCC2910086CFE3BCDB87CABB1DF5BA05E036426F19ED4C69C,123,133,10,0.5319710580974012,PASS
257AF4719BAFB6D3D7BD53E3BC68D0F4825242628FD10A93DF7329765AFE4E18,119,137,18,0.2605890342736178,PASS
172F3CB2E2D302F306162D057E2D72F123578F48341CCEBD0B0BE074E1FC5E0B,130,126,4,0.8025873486341526,PASS
51004FD769343A9582A43735B56BC41CF919825D77D1BACFC391E7A13F928936,128,128,0,1.0,PASS
76E0B1C735F42C6F84608DD1B018D0AF5F80AE22C4419D346900DFC997DC8072,138,118,20,0.2112995473337106,PASS
F0025FF481FEA123F6B23A9EC4CC46333332123C7D897553942DEA440AA13A81,136,120,16,0.31731050786291404,PASS
3457839E24FA6306BF6C0A123C28D6E96E15B994EA3B3AD9A964D89D7586C6EE,126,130,4,0.8025873486341526,PASS
F3ABD92B8FA68464BFF523AA938CFC63FE2CDA32E507C524B4E860C2FB9E3CB7,118,138,20,0.2112995473337106,PASS
596FCC9A01F3760D57B0FAD79F1A9BE8FC4C90A1D831CE29EF582F20A1A7D533,123,133,10,0.5319710580974012,PASS
450BBB080C2B37F7D7678273A420B06BDE027792C8CE86F15BF0EB35E86A512C,130,126,4,0.8025873486341526,PASS
F2CC91BFFA181B82A8C5B234DE3999778252EEEB958060B7941B047F5BA5A2DC,127,129,2,0.9005235503397743,PASS
B3A7FEA5ABDD5891F5E313066651F46BDD58D6470D8BD7268FED92DBE31F6A02,116,140,24,0.13361440253771617,PASS
C626A9ED0CBE2EF89005E4136DF7BB78BA0EAE1CF5D1F21ECFC6078A7EFCABE3,116,140,24,0.13361440253771617,PASS
5FD14EAE9B8ECCF69CFC543396A85890D945D5718A0154BAAF1FE16752A3A076,126,130,4,0.8025873486341526,PASS
F9992F81D2F2CCBBB5C542B6DBD8493D72A7012537162CF954D8EF5335D89F40,123,133,10,0.5319710580974012,PASS
44804A4882C3FD3AF9DE3D56C50194CE11E8021E0DF12B84903C69EC3D29BD22,141,115,26,0.10416255883043901,PASS
,256,0,256,1.2777508801076536e-57,FAIL
216D3E29C62D076CAF4685E96BAA4638A2F4EACA794EC5A4582289D62A4D5333,133,123,10,0.5319710580974012,PASS
8CC9F5DFBCFBA26688ECD99892A669D1C1E20AF52D39D575A4972AD6901B78AD,123,133,10,0.5319710580974012,PASS
A23A2DED6815BEEB9A154D9A1C14D4056151AD1FBA5DE0087ACCC2C4390E1A7E,134,122,12,0.4532547047537365,PASS
C05B3D2F0DA52C7480E508904FDAF7267126F7B0FF531734DE1BD87E0926E972,126,130,4,0.8025873486341526,PASS
C5C272AF96BE60B914F406CE276108423B96D09382C393987EE2BCF7D025EAB2,132,124,8,0.6170750774519738,PASS
D0428BE403CAEA79B45AA6BC020665C8746D0EF83AAB01D85740B3495ED3A8F2,137,119,18,0.2605890342736178,PASS
31D325B4E1A7130A70ADF55F6950CA0857ECA3D2C7C78089245C7B5231234AD0,137,119,18,0.2605890342736178,PASS
A9E8682019BECC5130071C5382DF7828069C70BBA93E6AE25862E1B37DA9E4F6,134,122,12,0.4532547047537365,PASS
6E7A3CB0E13BB263C1F4E5F798461C7A90420A3B1EBA0FCB156E612899B7716D,127,129,2,0.9005235503397743,PASS
DF0F327D5455918D199736FD138773BA2E4ACDCF89173ECD36435E95ECDE433B,116,140,24,0.13361440253771617,PASS
550FB8FCDB7D89CA598422C67EEA5BC7353B4C166C386D976B51EC4B753CF169,119,137,18,0.2605890342736178,PASS
1FA3DB5E7B31B866599805C51E5B43539D271F1F71EE166E4BB27CE816F2EC3A,119,137,18,0.2605890342736178,PASS
D749D528BD41A30D6FCB908B681579E7EFD3EC56522D43F4E394EEA4983E146B,123,133,10,0.5319710580974012,PASS
D86F9A9C935422D2943E1C564C6A01AC8CB8B48A1E173E2F9E8AE66DA865B9C,134,122,12,0.4532547047537365,PASS
200700FC21705B887572F39237A1C63C68CD1BFD7D5F5EE5FD017AEE3B4D8417,125,131,6,0.7076604666545525,PASS
22320D387F8542A10D9626AF72AC82C0B513EE1226B6ED1F5DCBBB0D5A17EB64,131,125,6,0.7076604666545525,PASS
58723288D4F070D5CF11D6260F71116A86F84F43C7D9D56813B97BF4FE4355FC,125,131,6,0.7076604666545525,PASS
390FD319E2835040CA1719ECA6DF33037C06193FA18251CDBBEBB7A55EF9B2DF,124,132,8,0.6170750774519738,PASS
C74D83F404442428DBC5E0EACCE034C5EE85447F3CC63598AE55CA9F3BDC9DAF,127,129,2,0.9005235503397743,PASS
E211E77A1B820BB79B8D279C1DD242B55675E6F849F3875F00F2E83614167898,129,127,2,0.9005235503397743,PASS
468A32BA3DB76BBDED33A7311D22F4EF665D3232383CB31676CA04EB4BDE4A6,123,133,10,0.5319710580974012,PASS
A2A9AB452747BDD914791E4163290E3235DE5620AC92D5CEF398F3BABBC79FDA,122,134,12,0.4532547047537365,PASS
E63754A764B7904294697A49AFE6E835086D19FA8052BDAFBE57055748729190,131,125,6,0.7076604666545525,PASS
433660604638E25C2EF9DACA28F3165EA7A53A6D9DFCC6B17329317728F99CF0,126,130,4,0.8025873486341526,PASS
6B6E71DE0D3982989E7ABC2068ED5654617CBCBEDC2ED5CD41B7852FA80E4E0,128,128,0,1.0,PASS
5D732ABDEF01B39CC11F4105BA055F1F881390DCCD4ABFF1B88BD1637CD99DE3,122,134,12,0.4532547047537365,PASS
657DB8E89C76EC76976894A7277E39256A1E5F211920BDEC75E3054B49554E1A,125,131,6,0.7076604666545525,PASS
7B5CC3BA73853FCB514842B5BF48A18724ECD0CD27366DD5EAF472392DD4B436,123,133,10,0.5319710580974012,PASS
F64EBB51B5DD50C731B5DBC8B4DDF84985413C7E81F80BE1BE224A5135A38C10,129,127,2,0.9005235503397743,PASS
E7F629566E1B27454F53B7D1E65BFAADE08B28949F153F07E17C1C5C49596AE4,120,136,16,0.31731050786291404,PASS
52D474B8A636EEB296BFF89FF2CA795AC619AA4189E666460B5314CC721BA6A2,127,129,2,0.9005235503397743,PASS
267072D7E95DD31F1F61335BC2EC1A8818C40C666CAEBEC0AA639EC8537FCC9C,127,129,2,0.9005235503397743,PASS
F08CF0E9B22C018B8C83F960A682BC7BFCE997659D47C47CBCC5E0392F6702C4,130,126,4,0.8025873486341526,PASS
A38A60545027BF6478D584DF9DBE8F51FBF848EA50CAE601D8C49E3555B82E6B,127,129,2,0.9005235503397743,PASS
A92FB84E2C5B92D40BDEFEE1F4F0DE6F99DF242911ACD83E5CD8EBF5B3408988,121,135,14,0.38157390570502125,PASS
F1E3BF4BD7224B124B79B057545462EB7EE9A4C422B2141DEB22350225233A3D,132,124,8,0.6170750774519738,PASS
9317F517A9A59F85A2FDA441B7536605CD858141DC4D80997ADF80752B5E0760,132,124,8,0.6170750774519738,PASS
463BB67FC18E3A679D120C1F5BEFAE0C8872A139E764DA6B95ABA251FF8E76D9,118,138,20,0.2112995473337106,PASS
26E24C5D6703333991FD1BA5F7EA901174115F0143EBE84090ACF777D0480294,137,119,18,0.2605890342736178,PASS
839A6ECE8CA4A7632B1F1857D04BF29DFC7A5DFEF690DF89A13CC1957E66A58B,118,138,20,0.2112995473337106,PASS
F3B1CDA2247B149C5DA98C8EFD54F81ECEF62A6504828341D5856BDFD28AC972,128,128,0,1.0,PASS
C42469F2701DEC6ED5E6C6989C5073DFCA42F2E3540F0D0496502BA2DFD171C1,132,124,8,0.6170750774519738,PASS
43464D1A265752FD333D46BCDEA219AF41C4AF93A5C0638D7BB49EADA0BFA7F4,122,134,12,0.4532547047537365,PASS
5D7A2FC89F73C6668636ED81FF3AD839915BD3178FA462DB13DEF7B76466091C,116,140,24,0.13361440253771617,PASS
A210944C5ECB011C979BC0CE41E228CF3D9326331EDEBA0E6092D14184AE1540,145,111,34,0.03358661289689768,PASS
EF1E4F4F2E09FEE61B0A977A5085DD92226DB87833B9947F0A62BBA519097D17,123,133,10,0.5319710580974012,PASS
187C2E60697EA74CF296540F4F129708676AB7F7D9655624E5DBA15FD28E0989,126,130,4,0.8025873486341526,PASS
EFA1583AEA27F5D92A858AA52051EEB17ECC6F5D5B30BB3F5225DCD00F1766C,124,132,8,0.6170750774519738,PASS
FAC572E16016A3C293475EB4DD5481FDED5D85A6E9ACBC7DE21691D209136023,129,127,2,0.9005235503397743,PASS
F1D7178127556564BC50AADE977F314E05EB9CAD53D918289FC5A1CD8E4C0FE0,126,130,4,0.8025873486341526,PASS
98BA08E70149191A2072DE8602A55A53F37B8CE680024BCCA7801234EFD2F48D,143,113,30,0.060792723530522785,PASS
14B855F8439D456795FCC5C222EDDFD3D07C9FABF026C9DF588E99951A45F18D,121,135,14,0.38157390570502125,PASS
D3C76C7B251645FE2D922E9A5E37E9C2DE38D3666A3515628177299F540455B7,124,132,8,0.6170750774519738,PASS
453E8E63EBA4B1A4B10F7870C5BCEB5A8FB40E82A331D746CEBE4FD8E8FABE55,120,136,16,0.31731050786291404,PASS
B41A72365D36182BAF97CA49201E2D1A5FBB71ACBCEC9DFF6EF56F274877AA11,118,138,20,0.2112995473337106,PASS
87E04FD329C7CCCA2D0E21BA11D7FC90071683E368167E2F1A192F5AA3BE609D,130,126,4,0.8025873486341526,PASS
5423C26698D4BF8BF55770CFBE6BFBB87EDE9994E8AB4632D447E1D60204C7BB,119,137,18,0.2605890342736178,PASS
3664BEC768E5345543089E86D59110331DA390E1E5F91323322C78F11896A4CC,139,117,22,0.16913144470267139,PASS
E3AF225424B3E6186B818C22843F12FFB2A98331EC5F04A42FC6D5A386C22B07,136,120,16,0.31731050786291404,PASS
B11CBD4AEDAA79F1449926C5EDBC8FD3D6DD5463F4FC41B569A06123E5B28303,124,132,8,0.6170750774519738,PASS
1C5AA3CB4434A5904C94A375A319E2E30B7814E5AC3F58D90775C0943FE330C5,136,120,16,0.31731050786291404,PASS
BCAC2D0E542F5935A942D27F88AE95F03404DD8E270926BAE016EAB6871B0643,135,121,14,0.38157390570502125,PASS
6DA013CF446CCE5EB9A304D5A3FE51483A697F0FF56B0534FADADE391704804A,128,128,0,1.0,PASS
D8B78A98B904F42C3C7A1CE61FF5D566B2988BAEEDD1CF3D1D9BC4DDED6D7614,116,140,24,0.13361440253771617,PASS
9C08FEB7F02A121A09F8D90EC54A6FBE168ABB75DC4B293AF0E16C2F5AC36060,130,126,4,0.8025873486341526,PASS
20E8FD1543FCC0A31FB7A50DBA32EDBF9290C253CF70511A903CFDBD2110B0CA,131,125,6,0.7076604666545525,PASS
7375C41323766183C004C9441562599F9693DFE3F3CEDE7E108E2A298E2CE426,133,123,10,0.5319710580974012,PASS
CC5D2AF3ECCE77844EF8EA31DBDC127BE04ABB22958378042B92658413BA37C2,129,127,2,0.9005235503397743,PASS
5B22B424E3E194F66E1B6301DCD660B3A8D1594A3F242AD6C444685E765494DA,135,121,14,0.38157390570502125,PASS
4E3F48386A6D9F1BF51CBBDC86716CE16BAC94DC768BBF95C78BC659F776E351,113,143,30,0.060792723530522785,PASS
6B867EDA7F1F4452FCE7E573FBB65064BFBD8D69E890B0E7295F7236082A6093,118,138,20,0.2112995473337106,PASS
,256,0,256,1.2777508801076536e-57,FAIL
,256,0,256,1.2777508801076536e-57,FAIL
,256,0,256,1.2777508801076536e-57,FAIL
,256,0,256,1.2777508801076536e-57,FAIL
,256,0,256,1.2777508801076536e-57,FAIL
,256,0,256,1.2777508801076536e-57,FAIL
,256,0,256,1.2777508801076536e-57,FAIL
,256,0,256,1.2777508801076536e-57,FAIL
6F355EB03444BB27DF43CC06FDE2379E9A0720F0A8683B4CCF9BE1B2D828C63C,127,129,2,0.9005235503397743,PASS
8B2381FF59DAAB093AA28327E085E40355A723F068EDAB3057BB97AB3188F699,129,127,2,0.9005235503397743,PASS
38CF037278CA21953924A6F989533D3814D600C0AE617F539FAA15EC200754E3,138,118,20,0.2112995473337106,PASS
6582B1BA19EC3E85FB0EA9168219C075AE4A6ACD629D3280E9625693AA38A114,139,117,22,0.16913144470267139,PASS
4F266A3D29CE3D70D12F40E0C4D16E2CDE9D3FD547BA3C894AD2B12E3D8E39E8,125,131,6,0.7076604666545525,PASS
E28C2273DE89DAB50AF3D354135FC0CC6CADD0CEA851A58B6E0C048C0EEC16B4,135,121,14,0.38157390570502125,PASS
2946C349539B0F700FE69FE9657ADD7FA1E3A3E55A7CC45DBD554C695DBFD29C,114,142,28,0.08011831372763423,PASS
C01FE33B7C0C7ADB0C797D3919D4D3980CF589B933DFD532537FDEE7D17B9B6A,112,144,32,0.04550026389635853,PASS
BA0E475F3EFA4B84365D75F3FE32D336E1633995FF3DF374CA334D455F6112A6,113,143,30,0.060792723530522785,PASS
42BFA6DFC0D50322C879C41522D73CFD8533A63F1AE309281A40669BD4D620F9,134,122,12,0.4532547047537365,PASS
A399132CC9D3CA808F7FFB1D8A986F001212ADA1EED1E2C62220BD42C7C17C5,137,119,18,0.2605890342736178,PASS
FFA1EF09BFBB6E365EEC9552544FD4D51CBB2052C4FF9C157834636570B587DB,116,140,24,0.13361440253771617,PASS
1BB4F1E8D4A8FA4FCB6361EDAD6520A1DACC609F8AF8B5E0CEE226721A333159,127,129,2,0.9005235503397743,PASS
4DFAF3024B14052E0517A882DC0E34CCD3F1A4ABD0037DD2E7B97D4EB08DF0B6,131,125,6,0.7076604666545525,PASS
C54E22913A24F0A7C38CBAFF2A5FA03B6389B9E49313C6ABB2309D30533CF973,128,128,0,1.0,PASS
BFE060E102700592CE285897F42C28D5BD23D86E08A3CFAE4726C621C4A9E12B,139,117,22,0.16913144470267139,PASS
FA9AA80FFAB82B07D9CB46889E52A3BB375B9B6E2DC3AE8A15E77A83F6EA7BB1,115,141,26,0.10416255883043901,PASS
72EA91FBB9291543CADE20B4548F3C91560FC60247686683BE6E74ADFC2FD0B2,128,128,0,1.0,PASS
12E4637C2A353ACE743583B8D784241DE9965509EB9FF404EE456CDAA8820776,132,124,8,0.6170750774519738,PASS
30792E9C4880EF85AF9E125A6184C2B053CAFB9A92D0A208EE012C95C96A696D,140,116,24,0.13361440253771617,PASS
29C05F0E37CFB081FEA9F26602AD32CC21063CC342DA01847D4B8261F016632D,141,115,26,0.10416255883043901,PASS
A9502C413C9B29AD94E5FC9BB683E6C05A4C1334CF395FE6AC6F744D6841F8AD,127,129,2,0.9005235503397743,PASS
65CB24AFE536DB7D16ACCE932B5E82DF0F2D5E42A89A2CA74470B6AE282670D6,126,130,4,0.8025873486341526,PASS
8E238AB8809BEDD072E02F47BC180A476A00D5E5953533E200AE867EE5C5C82F,137,119,18,0.2605890342736178,PASS
A330998ACFC76E54517D55CB2AE6FC1235C609AE0ADE3AF77474CDACA830FD89,124,132,8,0.6170750774519738,PASS
EF95B3EFEC135BB65CB9DD1BCF113DC1B498F68C675A897BAD8F659BDE128D8C,112,144,32,0.04550026389635853,PASS
8D2E04B50BD66CECC190288B3B763A577D94B2151A82F54A5D5C10405DCFF0EE,133,123,10,0.5319710580974012,PASS
D24A3561994BFD39C26AC9EBBD40BE0C3B9A5D8E8C02A5E4060153BCE55016C5,135,121,14,0.38157390570502125,PASS
49A4E89EA51A2F6527103EE06EBDD4B84832C800A64740F556BD4E4FA1D6015C,138,118,20,0.2112995473337106,PASS
19FB4E2337F4EA31C9370D484EB1FD19DF6B6C541CF78E39FB377D169B5972FF,110,146,36,0.024448945310089426,PASS
4BA5A852EBD6AFDA83AA17E9B2E4966EED0FF04D9ED6669C488D3CE43976F148,121,135,14,0.38157390570502125,PASS
D63DE2FFF5D5AECC887E55AE6B0BBF3CE6ED5DA977C7B0DEF1D717C95383D1DA,103,153,50,0.0017780505982168669,FAIL
8F95144A9038FE9B889C3D294FA26FFC8A1AC581FCB1DBEA6F0FC6BACCDE2CD,123,133,10,0.5319710580974012,PASS
F4633EE4870A695DBAE1E4394E8B0A72C7D9D2A0F859DF0FBAF7C5929318C332,124,132,8,0.6170750774519738,PASS
4B8D09130D327F6720D62C1A9A7C56FE96F7FBB31CF1AF14B3EF326612791338,122,134,12,0.4532547047537365,PASS
9EFB9C969A89D6F76A9AEDFD0207052B1B1CFA66CF97AD2FED2474286EF22CE0,118,138,20,0.2112995473337106,PASS
F73FEE64EB4E6231409D76FE8E2383C66B5CDD7BC1E11B10457D86590757E8F0,121,135,14,0.38157390570502125,PASS
B9643BF95B0D6DC61D5DBAC1CFA0ED724633E262E40A38FD3B920B28B231DCC6,126,130,4,0.8025873486341526,PASS
FC588FE4C41D3FFDD90EF6711E4226862283741E78465513476CBB0F12628652,132,124,8,0.6170750774519738,PASS
8218A7668E6CFA3F8CC2CA4D57F2B97810AFE2B29AEB53B17FB126A934139217,126,130,4,0.8025873486341526,PASS
479D4A917AA4AD2C153C4C134F21262935262500E0A11CFB9067825599988B30,147,109,38,0.01754895019147673,PASS
88453BF5F0412BEA54031C2541AD20CB297986E0D889FFE78C4C5D392B3CE98A,135,121,14,0.38157390570502125,PASS
10C7B8C61887906B5724751EB8B0C5DE168F881E762FE3730C63CF7EAD88D70A,129,127,2,0.9005235503397743,PASS
D5A212556B2B4DF087C464319A54FC10B0B0BAFCB34DBF29AF72A84DD83C6620,132,124,8,0.6170750774519738,PASS
C663C16691C6FB94D9B673426E65008D12ABE37E9D18ADECC34DC5077314F0D6,128,128,0,1.0,PASS
17C35B955F2BF90310A6EE0FAA00C52C8CB70F4AF41E895CA6B0EB5E0F7EC557,126,130,4,0.8025873486341526,PASS
9548F8EAF9965D6CB13493B028A62EEC84C5556453116158DAC9048EB95F8079,136,120,16,0.31731050786291404,PASS
647D723F9F89D9496679B031CE562D92F341CCBE4685C32A35A167DF1E5E5C3C,122,134,12,0.4532547047537365,PASS
DFCFD545CBF3BE7ECEF22C80C0D014058B4ACF70DB08B6A851FAF0F9F86CC843,124,132,8,0.6170750774519738,PASS
15190B1DA0EB2BC0CCAA538DB62335944AA40FC866F567B2FEF00251CB561938,136,120,16,0.31731050786291404,PASS
E31BD9324363377D6ED2E8D6F411381EA9CD21AA9C1F677D7F0A190C580315DB,126,130,4,0.8025873486341526,PASS
69EFB17D65D865CCBCD5C8EDE26E63802FBF7A7A87F7039D6236D278B6143217,117,139,22,0.16913144470267139,PASS
4546D3A517880560B5593E101E3E68F987EF99263DFE36CDE6B178E2DB3F30C2,125,131,6,0.7076604666545525,PASS
8EAD8A96F95D3E46C120DBA07CC746A8EA5B77DD5589BFE9C63394A0D2694270,126,130,4,0.8025873486341526,PASS
302B4B32C3E294A602FB853EFD8C2FB1D07F90DE5E3B58908E600FDA389E2C57,129,127,2,0.9005235503397743,PASS
1D125A55382258542DCF420953D3D176B935F603ADC4EB2A6DE6ECCB9878C423,132,124,8,0.6170750774519738,PASS
A87A53CAA7E8093AB1AAB63A1BE531929828B7A46B1B31C213A5F4C437C68CBB,131,125,6,0.7076604666545525,PASS
E15F83808CDC234A62A637CA298430B64598BF793C1D5350D08DD75772B6265D,133,123,10,0.5319710580974012,PASS
28513CF9EFA622EC5868255EF265DE61054F53F1E5CDB30C87E46A9EAA3ECB8F,122,134,12,0.4532547047537365,PASS
4E898BDC9CDA512DC2FB63B0FE5CB2ADC45804252788A6F7B1AD44147A634CC3,131,125,6,0.7076604666545525,PASS
28439F17FECF22AEEF87672E2831BA9612414EF757BC03F13908B00C5B76CA09,129,127,2,0.9005235503397743,PASS
D14AC4DBFB6A7DB6092F7F0C82BE73B8FA7BEFDE1A3962F7DA39FEFFEE51779A,100,156,56,0.0004652581580710493,FAIL
31DA735392C964F87AEC9812C213446873134C8CB8C2EBE4AB204DB87B38FE44,135,121,14,0.38157390570502125,PASS
F25E7E3C14A71E10825092FEAD6B68137CDF778062DBAF1005BA3289A4DF21A0,132,124,8,0.6170750774519738,PASS
771C976CD3F49275E90144B36C13C9497E1895D868FB0BCD48DE826060C2DF0B,132,124,8,0.6170750774519738,PASS
72EBE99D3F04681240703CCE130B307B228F681B73A218A2934BBDDB498BE71B,133,123,10,0.5319710580974012,PASS
E387ADE5DE292E21672373B6FD90FDE72375490262688EC558AE54A890D37103,129,127,2,0.9005235503397743,PASS
34DC2C119BC42A0F79F543761FA020F1AD87846A3CC38D26DC245F648318C969,137,119,18,0.2605890342736178,PASS
DDAEE07D681AE628D96454314201883A92D9A8C0C375E3FC79964890398C1BB0,140,116,24,0.13361440253771617,PASS
6A5C34485472C99017986CB17187DDDF93E5CBD7347CE9C7FE1A1538C622BC46,126,130,4,0.8025873486341526,PASS
5659492E5D515DFB5295A1AE4EE913938BB69A8B48D2854A2C2B1F62C51303B5,132,124,8,0.6170750774519738,PASS
DFD9AA883F09999B682F0751DA16AA31C2D635BACB499A620D6A29DC375E0459,130,126,4,0.8025873486341526,PASS
C3973DCF1FF31EE25496CE6258AAAC06CE5B9537CCC2E99B1883CF05E9954201,128,128,0,1.0,PASS
BCDE65916514209286DDEE05144BD289CD3304806135C2A2801937AB3E51BA9A,143,113,30,0.060792723530522785,PASS
95DB6955C13B1C5E881699AF77087B2BB606C4999B99A60280787C30D465CEC9,133,123,10,0.5319710580974012,PASS
DF7371ED2C62927AA108216623AF819F9D4BB7C559C3BC793088B9AD1DBE450C,127,129,2,0.9005235503397743,PASS
6D6F62CE241E5D6B7E892398C01EFD4A0C96936AE1E7B0F9534C8E4741777B89,125,131,6,0.7076604666545525,PASS
724904D7DAFE832BACBC5C06344BDAD4FBAC13DD1A42E786B2969B65E07F0CC5,125,131,6,0.7076604666545525,PASS
A5B6BC517F01E290F7EB497D6934B976323BE3A640DDED03A2A65970F46540D2,126,130,4,0.8025873486341526,PASS
F14531DC31C6B611B4CB3C97BF79245783CC0E911F43C3CCBE01D5C487924068,134,122,12,0.4532547047537365,PASS
189A6CC9382ED3835ADA6A6FE39FE8FE8FA86E776C9243ED5BCFB39650CD0A89,119,137,18,0.2605890342736178,PASS
5044F896BBD75EB52061EFFDDFEF471E5BE81DB345A6A73A6ECCB7170B39AF4B,111,145,34,0.03358661289689768,PASS
D5FF5260EFF7AF8E9C3E4A08074529C47B877AA8944045F13621D1C7F5A1A7A0,128,128,0,1.0,PASS
61FB5106127E22C002EDB40DE4CF8BABFE38D86818D0461F7C32733AB4A84C26,136,120,16,0.31731050786291404,PASS
B64583DD839F942DFA38D87289E1B620A12B7F9034C98BA4B2C5D400EC364D81,136,120,16,0.31731050786291404,PASS
443080079544C8370EBC11633E4096C8089B3F6EF4C9C2A6305419309B0EDEF7,143,113,30,0.060792723530522785,PASS
35DF2DFDAEA38BE0643C3501290B5F28E6C31364E82E1B4CE28302E2FA7F8C3D,129,127,2,0.9005235503397743,PASS
13E8BEB244DC70C76714BCAA22E78A67B4FF506EE8A433A7AA20B39460C4A223,133,123,10,0.5319710580974012,PASS
1DF8F305E303129CDBFB27DCF4364DF3EB73A1804E3BEECB71F32B76C9358F81,116,140,24,0.13361440253771617,PASS
873978D7F814FF44BBCB8911AA2B0269086E4AF9A3DA13A0C518555D9004D28F,136,120,16,0.31731050786291404,PASS
D6DC534669974B798C304882EA9A301E5439A9EC475F4488E7B3D1A26AF7E705,130,126,4,0.8025873486341526,PASS
2B783929C0BA9D3007E844147DC9429EC85C0F0D0FC117858E01F0643786164,147,109,38,0.01754895019147673,PASS
A778D57DD5F983FFDAC8CA6FC4D703A95044E57E335DD4FB7F849F3A6489F14C,113,143,30,0.060792723530522785,PASS
194D409AFE41C99C5141B9A519AD0D6974759F07287D52848AE0F7B5B49AD18B,133,123,10,0.5319710580974012,PASS
F0116E7AD09DDDA5213B02CA4122340AFA8CC62A588381846C2FF3AF036C9C79,139,117,22,0.16913144470267139,PASS
882409227A66C39F94A49873BF265D9C676CCBA10F300C1906656EF160392278,140,116,24,0.13361440253771617,PASS
E88EC607A8AE53F59FFF050BF677BD56EB53F5D659596DE23E88243EA32C66DA,114,142,28,0.08011831372763423,PASS
4ADCF1A18FC05BE650ED906971510610BB9494E7A06D2670706192DEA0642367,140,116,24,0.13361440253771617,PASS
BAFBB53B735B9F75FAA7990FCF6DEBA56503E5DF955915134726EE5CA4CE3686,109,147,38,0.01754895019147673,PASS
B2F4191E62D211F15687941C356104DC83C023D65CE3525150FC9360F804537E,141,115,26,0.10416255883043901,PASS
D6B59FF73F2BA3287A80DDFF9B0109E481A7A1EDF05C5CEDEB4AE0468DA26C62,122,134,12,0.4532547047537365,PASS
FBAFC1B9E920C68373AD20E541AF854DF0E69113F7CB7377C47AB3300B217CCE,123,133,10,0.5319710580974012,PASS
442EA6293A94C479199FA28C41F298F68A2BF897F0D8711612D52848C050F82B,141,115,26,0.10416255883043901,PASS
84BAA3F171E15BF98A60F6DDF12D8C585E77D20227C13C64EF0036E06E4F4DFB,124,132,8,0.6170750774519738,PASS
804D8D7E8170F3849A05FE7B32A6DC7146C08F7FBF602050CAB0126650768500,141,115,26,0.10416255883043901,PASS
9974DDA4E41B6DB5C31231D062A27D1ED2642B3774807A756748B9E1F2B4E771,127,129,2,0.9005235503397743,PASS
C744E62BBAB69DA8C99313A5FC2FE7EDC4BD07F7915680D5CBBE98754DA377BC,114,142,28,0.08011831372763423,PASS
F9F9B29F03D6EC48CD707759D44B1083EB0D6BC252ED28513DB270A1DA51C982,130,126,4,0.8025873486341526,PASS
9811F1F7E4A4B60F361F5A565E70035FAB5FBCE687615A36319CBC2211D3010F,128,128,0,1.0,PASS
15FEB264CBA928CB2F97829C6D08E8F5D40FCC8CFA98F26B6B7A29901627E88C,128,128,0,1.0,PASS
17A75EEA87E6619625D15AFC5C900CD756B3B0C490C2E3CB05B6C96F4F20DD0E,128,128,0,1.0,PASS
6F14700685250AD0EF4C8D2844BE6ED3A0F0CB1549CC2CD9E0C7B3513D57E758,134,122,12,0.4532547047537365,PASS
B3D26BD2E75164B3D0A3FE70D83CCF9B083C3DDF7DEEC8539CAB6EFCB7683CCF,110,146,36,0.024448945310089426,PASS
9DDA542D0001A74138AFD1C0A9C805AE3E65D6FAFA56EBD44B782E3203DCC89A,133,123,10,0.5319710580974012,PASS
1271CDC1DA0CD08EE445544D6750B008B5BC079C44B92CC8C7311048BB7493DC,143,113,30,0.060792723530522785,PASS
472CC8817D155B2AA149261D4C4123A2C39294B27319822333775DD238D8B479,141,115,26,0.10416255883043901,PASS
65D304E7BE3E15BAC71DCCAD250E9EFB1DD09744CB3C4B7C51558998F92EF630,122,134,12,0.4532547047537365,PASS
AD576083D7D028E793C89D253D98BDA980B13A36C77D0B7CBE8F0682CB9B4D7D,124,132,8,0.6170750774519738,PASS
49DC7ACF5ED37770374A5780C9306B2EE3779102DE362ECA7B3BA5430A0A5EB,126,130,4,0.8025873486341526,PASS
ABBB93E586E14C7431DE7D6416FC5AC7C9C9AA309BF730DD247269B8EED83B2C,120,136,16,0.31731050786291404,PASS
7627C19003866B551C1585F91B47FF4920CE527EBB3FBCF8A22E6C95E9B129E2,126,130,4,0.8025873486341526,PASS
F8D4F3892DDB2495B6914A0D5EA66807E43ABDD9B7DF24FD129768519850AD7A,124,132,8,0.6170750774519738,PASS
EE758E746E5C4A76B8E80EC0A844AB4F2ACB9B8E8AB1881AA7995426181F4BC5,133,123,10,0.5319710580974012,PASS
E89A47FC4FE68B05A0869F1027979F1CA1E04C16596880A4BCC601476CDD0BA,140,116,24,0.13361440253771617,PASS
4E976F32037804162695DFB4398923EA5E905D3D43839FB0E3B7BFA0E640F54E,127,129,2,0.9005235503397743,PASS
30FA3B837D01CC80EC88B3755FFA722A4F1CEDDBC79932FCC302330E76643785,126,130,4,0.8025873486341526,PASS
8BDB844F1CEEB2832FD77159B555EE907ADFEF61882BB30E15E91AFE94A0B5E,120,136,16,0.31731050786291404,PASS
CFE3DCB5A9E5404C0A48FC702ADB79F5C6D5CACF6F9AD23192E067CB67DE6CA2,119,137,18,0.2605890342736178,PASS
2D4F013CDF3418761AEF882A6E378664889D25F73055108BB34E0CB7B2C1DB5,134,122,12,0.4532547047537365,PASS
250B36F14B0163B78A5CF607E3AFCB5C48467B0B2D637DE2993D3D33B515AC97,123,133,10,0.5319710580974012,PASS
8C7CA2ACF861D9391296A60D5A893F62EF29D115D17180D8EF661B3AAD3257EF,126,130,4,0.8025873486341526,PASS
848503D384400C568DFE2A938D10C717BAEE37441D90258FAFE6503C1446840F,143,113,30,0.060792723530522785,PASS
19074D26CA0C553E6D81BB34027D0F13727BE440805084782C18497AD49629D1,146,110,36,0.024448945310089426,PASS
10B9C72676FE2E0040193F6F234E494F86FB268688A84F8930266342ADEA844A,140,116,24,0.13361440253771617,PASS
5E6D970B4C25598BC4513D49628257168FFC6261F23722B9D53CC2D08A54AE99,133,123,10,0.5319710580974012,PASS
D4E9091FF2C90E9F2778BCC8AB12877BE3F256131858078E2973C3065A86D412,133,123,10,0.5319710580974012,PASS
D11423D2A2A8E2D102982193AD700C12020F3FDDA4B37E0418F76678722F25C1,143,113,30,0.060792723530522785,PASS
1626701913D8BCFBA0236562FFE8B824D2585B032F2F76960C04F505B7979E78,131,125,6,0.7076604666545525,PASS
4FDDD72A45E1D5690D189309250D37E2A0A7C1D9F9BF02D03B85FFFEE7304F52,123,133,10,0.5319710580974012,PASS
CEF5E60ED4B5C5CB9927CE6944A49F16254091368F00F7CD25F600C4DDAF04C2,132,124,8,0.6170750774519738,PASS
F24EAA80DE65A7A7AFCE5BA89D566CD1D61BFE3B8463D138960E8841EEAC373B,121,135,14,0.38157390570502125,PASS
40A671EECCC1B3986BC45A07DE0B95352131A56D0C07D0C51507442415DC3FB2,140,116,24,0.13361440253771617,PASS
8D490218F1B2CB96DA02A5DBEF004FF3B1B290ADE7EBDC3FF07303B3338D635E,123,133,10,0.5319710580974012,PASS
FA94E50781A4C20C62B6AB22A825247F4BC96A0B71163611A568093CC3511D68,144,112,32,0.04550026389635853,PASS
AF979DE47AF42661B59B2EE7AACAF9210180027348C7FC3D55F7915ED2F5DD4C,120,136,16,0.31731050786291404,PASS
8AC5758CDF0CF1AEB0A6B84CB89EA3E514E6A84064FDED70C9E233D2DEEDBE3A,122,134,12,0.4532547047537365,PASS
F63C52ECA098B09C87253C750DF61711C42B9DE7B112A5E89011A62BC55E5D05,135,121,14,0.38157390570502125,PASS
6CAA0A89371A1CA1ECDED653DEF05E3B80A473A33A6061074BFF0333EF4DEC2A,127,129,2,0.9005235503397743,PASS
FEE40881AF62997F37603F361D53A91EC4BC0C23B84DB42DE6EA31CE895AC8CC,128,128,0,1.0,PASS
485ACE9248A71A8854A8A4D251C8291874E705D75B59A81412B26AFD50566711,144,112,32,0.04550026389635853,PASS
34D3A6D26E2D702B49D501D42AAFD4D72823FA1E0F7045F9D47925E784136A7B,128,128,0,1.0,PASS
B9BBB0AF17E31D643793196E21AE484D67BD3764726D8CFEC59D1F8B51E4A491,121,135,14,0.38157390570502125,PASS
7B526AF9B8EB579BA39CDE7951B736245B899CBFFE3A0C54DC18171B92815014,124,132,8,0.6170750774519738,PASS
72D18708781F58F7A17C9694460D152DCCA1D782908CB0D1A0280B8F4054CC71,145,111,34,0.03358661289689768,PASS
2FCDA5F57B392662155D095C717090E2924684E84651A32118E45AB1532FE46,140,116,24,0.13361440253771617,PASS
CDB8CED71DCB511CC7E656CE1722CC0B09F26B72A52AA3ED69FAAD8667B00C47,124,132,8,0.6170750774519738,PASS
950BFA464C94997C1841FBF14A7884D844EFB185F3DE019994F00B08C294D8D0,139,117,22,0.16913144470267139,PASS
AAE39738ECEE3363860B6369BEB5AA679A3173F998D3893A7403FAB153A1D82D,122,134,12,0.4532547047537365,PASS
E73C4582B740C4AE33836089DD7A1A87567E31E02A971711C5492F95F307EC5B,131,125,6,0.7076604666545525,PASS
FC1598270FFC28E0F31684543C923F10927E59BB8F56DA58AA6A2320C78FF995,129,127,2,0.9005235503397743,PASS
2142B258B7A0A9E233CFC3571476193C75F884A43D7B2AA1F7707D1044FD71C,132,124,8,0.6170750774519738,PASS
A265BBE4C4EBC252899138E4429D124D5E20C32B7E27C31CD68603C9609C853,142,114,28,0.08011831372763423,PASS
ECD5882297AD35707E0A05924BF594523A348305078F445185001DC9898A480D,149,107,42,0.008664896726025117,FAIL
7EE4A943AA4BBAC2E07DD889CCFFDBE763F3C1996B03028302EEDA729B6D8174,123,133,10,0.5319710580974012,PASS
6F0BF2CF57D2B6732479CE9BA844664F94D5599585164130E88F5D63FB4D135,126,130,4,0.8025873486341526,PASS
250D6A5FC8208F87E496C23D836758E2BA5EAF9E9FB009C236F88F6EB646201F,128,128,0,1.0,PASS
5AF87B717674B331F097A13E979360CCA28D11E3734149AA00D4D6F9F79BA87D,124,132,8,0.6170750774519738,PASS
88004A80E8F62D7D18DE8FD8235244F4F36216DDE68170418D736C7BC869B50A,137,119,18,0.2605890342736178,PASS
19FC5772DD68E2986EB7AB229D2999C4BA325E57AF5F8482D9CBC5D1359AC39E,120,136,16,0.31731050786291404,PASS
44941DAE56DB735E86B054C76745CD936EC4C816D0153091BCD75C8A09951BA1,135,121,14,0.38157390570502125,PASS
CDB9D1435DD2661271B212A078D860324D5C07CF9740954B548AA7746F119608,140,116,24,0.13361440253771617,PASS
A297A2B26154D1597FF2214293FD5F45FF5DB1373E6D20351D76DA8ACAD55C02,123,133,10,0.5319710580974012,PASS
FB64B73E4F81A9C2811767DD3F5865719B405E5D190DF7836962CCD64FD90643,124,132,8,0.6170750774519738,PASS
CED5D390E53217A9FED064B9013DD1D95245D35DFE4F940F1C361D232D86E997,124,132,8,0.6170750774519738,PASS
2EBA9D8423B0564429336F0AFAA6082ED3A8852FFD670D7CD0E879704ED9A230,133,123,10,0.5319710580974012,PASS
7B9EC5920E45D44814261D7774D387852A478480DF83B768C925224BC9B214A3,139,117,22,0.16913144470267139,PASS
5285E45750C87FBF81CBEA2BE13892F26B9A2A545F225F03F65441A124044EE,136,120,16,0.31731050786291404,PASS
F3FE8ACB29A878C9B8C526F9A236363445E8729D2ECECF72C886891585E91B50,129,127,2,0.9005235503397743,PASS
D1E5A180CC0F58997563E4F4F4071E6E32FA31F310BCB662BEC64E922E6AE8E2,128,128,0,1.0,PASS
3F25971A8C6F7FD5FEBAA3690BCC61933408C6AFC0BBD0CC46AD4BEE6CCB53F6,118,138,20,0.2112995473337106,PASS
8E0D9F2CD321FF69C4587829B3D635B5D584D2BAC6F39855D7BAEF89B4885D3A,120,136,16,0.31731050786291404,PASS
C4ACF4E1BEA68A1BB0C9C51B4F1E194F4774331989A72531114C53EBDC4F3871,130,126,4,0.8025873486341526,PASS
4C80542793C1B82C1D327E5E88D2543837F3F4A0C3096A52F7007DB1D693941E,137,119,18,0.2605890342736178,PASS
78E7DA8DF4BDA0A82F4B67EA7EFAA5450C9580B4AC9DC843995B59D52B6540AF,124,132,8,0.6170750774519738,PASS
2A42223E58343DE434C22C7087FD81FDB78B86CBE8D317F641867516580D2EDF,130,126,4,0.8025873486341526,PASS
15C3CD497AE6573BE6A38C625FDFE50EBC92B82C238D860E00017A1EF355C3E7,127,129,2,0.9005235503397743,PASS
FF24F1D0D5CDC8A916EE5299DE8321C164E6B295F84298B10EFBA2F2925A35B,129,127,2,0.9005235503397743,PASS
44F8D759AEE4DE56B7B3D86AB24573DD6CE89EBF24A95B262DB6B257C11887C9,118,138,20,0.2112995473337106,PASS
47995926CE46235D4AD4FF83F9F48C7F06FC2BED447CA0ADCF6ED97496C4E7B8,117,139,22,0.16913144470267139,PASS
F5DA10FC7298E826440607419BD769D4129F33FD142A50354E5F24C324863AC1,138,118,20,0.2112995473337106,PASS
89F0590B90285E7ACB372C86E4A58599E36C3C8FA2461FE25139B81B721C864E,135,121,14,0.38157390570502125,PASS
3872FA4D70D6B2E5C4CC19F1790809FADEBA2C93AEF8455B4560D670DEE8CDB1,125,131,6,0.7076604666545525,PASS
9BA515A0EC6256A0384FEF15A4C0559EC9056581BB171CDB118683564FF25064,138,118,20,0.2112995473337106,PASS
366E57A44639A4116BF2F6F4AB14E1E317B99599B2B6B61337748B974BC0A38E,124,132,8,0.6170750774519738,PASS
15FF1F7AE1EB6ED672A26CFFB5440D0AF11F76A7408B7542BAFF4AF076569565,115,141,26,0.10416255883043901,PASS
5DC8F279D46B72E2017B92B6C06C7D76F16EB702D4C55B39C9E94E47B3178FCC,120,136,16,0.31731050786291404,PASS
795472A3B047EDB3105FF063CFF65CEF4CEF334F09BB6142023675BCE7831B9D,119,137,18,0.2605890342736178,PASS
C3A8482F6035E7ADE6525490F4513A10BB0261E6370ED4A78B3774D395299A3D,133,123,10,0.5319710580974012,PASS
7E7071AAD4FC175047DA8F09BA77893787ABBA7711E46036F45FEAD5803A9879,122,134,12,0.4532547047537365,PASS
91389334366481AD4C0DFC8810F65FB41FF93ABFA7E97A3B31F211E333E77A9F,120,136,16,0.31731050786291404,PASS
A7C9E341AEF2C5B79F3DCA617336C209C1BFF598F810C4200E6527B35E9B306D,126,130,4,0.8025873486341526,PASS
46B0CD06672CB55ED5253FA9E049027231A98EC3F163CF26B271DBB7E699A85,129,127,2,0.9005235503397743,PASS
7E8A6E982EBBBFDBBE4A530817C783AA30BFD3012E0BED440CC0DA9D5AD8B26A,126,130,4,0.8025873486341526,PASS
C92D7BA8F999B3BBDF713EBC8AFA4B25ADA3BE451E594F7933DB42B4B65C87A1,113,143,30,0.060792723530522785,PASS
23F2539635607D333D11FB48309FC3E758FD1C9FBCCAC23E94269D3D4E2A756F,120,136,16,0.31731050786291404,PASS
A53DA6B870D4870A4FCF2EFAD1C759248830D9FD6313809142B1C9DBF92C44BB,130,126,4,0.8025873486341526,PASS
54E24C02454F893C9BFC24F65D0781B3EC1ECB50A46B9211BE4F288065BA8EA8,137,119,18,0.2605890342736178,PASS
30CD6955C5CB26311323342CBF32ABFFA4DBC2125ED95FC6DABE7925E726F607,120,136,16,0.31731050786291404,PASS
DFA37BF60CB8108E37A3E58107BED56D257998DD101118C37AAC3229D5B6512F,128,128,0,1.0,PASS
6E277105F2F0FEFC5D6A4DC7298A31B8AC7A364A7118B4B11BF1E4FF72064791,124,132,8,0.6170750774519738,PASS
CBE3C269D175EBD499B1846DB48DFD8F3B7D9F2502EE6A880FE4C90305056491,128,128,0,1.0,PASS
EE6F6317A038266EA43A57A9484F184A9A7572E55D295F19686FC44F9354F59B,125,131,6,0.7076604666545525,PASS
9D4F7DBAAC1440201E1B84807FF03B486C18CC15B024A2BDFC26504058566306,146,110,36,0.024448945310089426,PASS
198B1DC2976471E17567F3571F8A0814294B23839FE72BF214F0E22843046A47,136,120,16,0.31731050786291404,PASS
AFAB11780B0CD92E852FAEA31B683B83ABD1D93610B760243E56E3F95EE70BD7,124,132,8,0.6170750774519738,PASS
FF5E8F444B79846C2E12408CDA107D285D13E7780361C06085C1320C3C8C3225,146,110,36,0.024448945310089426,PASS
B9E49DDE1B682A266AC7BB9B120C4E69BADB62D39C789A6C17925984C6630806,132,124,8,0.6170750774519738,PASS
882915226B8024159177441371F7AE2D519BCC30695DAF3D60E1334845BCD0D9,139,117,22,0.16913144470267139,PASS
DF705C1B816CB58C1F99207B1C6789C1C7721DA9E12B7538B80ADDBE4EBF27A6,124,132,8,0.6170750774519738,PASS
54557782505C005974FDCE9370B3B33E7BD24CC7CFDF83EBA299D7F6C111C8D4,122,134,12,0.4532547047537365,PASS
407DBE779C847D6279970E25BEE92AEFD869B2D2FA4A70D36DA701D56D894855,122,134,12,0.4532547047537365,PASS
CD6716E713FA1D5FED922B14D0665D937BBB11C014AEB9E43360B2A8E7FB355B,120,136,16,0.31731050786291404,PASS
D0184EF1170EDC51A365742274076A6657F416E9E25A78A50185F832C07D460F,137,119,18,0.2605890342736178,PASS
B875928C770BDC437A69F81F69FC1347215CF6BBF564C51D312DECA7E4358EE,121,135,14,0.38157390570502125,PASS
DD13F91279D1833522DF334DD3139EEAD1B5A36D60893EE0A5185075F03C773F,124,132,8,0.6170750774519738,PASS
45CA1C102D723C56F33A322D739648B58FDF2A08157EF45F8E8C6FE696D22517,127,129,2,0.9005235503397743,PASS
543AB05B2A5D8571214FB03BE171D0A809EE6505236C9A6D82E3F2A7E351DC04,136,120,16,0.31731050786291404,PASS
EC2A911FF3E4CA8B68ADC1D33CA3A11E7D07E41330B872F6973EBFF95E9E18FE,117,139,22,0.16913144470267139,PASS
5CAA7A3F9EC35B3CCA9D7228CA4DB53F6EDC84B7CF5A47EE8A9A3CC240C7C465,120,136,16,0.31731050786291404,PASS
1F99311DAEA4BF39B7F9AFE54D7BBBC5077E3BFBCEE1726449C301100FFFC8D2,113,143,30,0.060792723530522785,PASS
7F581C234A0D4DB7860197DC8CDA236D06229CFF0A82938A5D49D4E2ACC793F0,134,122,12,0.4532547047537365,PASS
BF6FA7A1A16E410592BEF56E07C83E9BE1B943A658CA34495AD063742E9A05E4,129,127,2,0.9005235503397743,PASS
6642291C70364BEA67AA88A3B22C15CF20F23F802FF707E13C2ABB1E5427E88E,133,123,10,0.5319710580974012,PASS
F37E5FBF0384B4808F55DBDA3FCE42A669027F7FEF6006B45F67D0213F701E96,118,138,20,0.2112995473337106,PASS
5E6B42B24286ED48FD677DABC0E86D96567D9233BD2E78DF0BBA668911DF229C,121,135,14,0.38157390570502125,PASS
A296B2DEB0FE4E7E32D06EA60C8946340C6327F7A5F29C0778E2B0CE51939BB1,128,128,0,1.0,PASS
124D2DB7FE2B82720E9F1C216CF2BD6B9FE66F6E052C34BA882E914B4389C2DE,126,130,4,0.8025873486341526,PASS
514085CD1992DC8AB0102BC4AA7B492E0D931AD8FC9CE4CBC97768249E258047,141,115,26,0.10416255883043901,PASS
BA54E7E5A0B30DBE3F7C7A020186E5FB76C1B66DAFC49DEAD299434F11D03CC8,123,133,10,0.5319710580974012,PASS
5DA42D85F6EE53A96ABD98FD886F46531EF7BCDC971E009B0D2F63005D2BD426,123,133,10,0.5319710580974012,PASS
551CB78DE91E329DBC12775EA38B0A73CC1748DFD9B179EA07059C8424B900F,131,125,6,0.7076604666545525,PASS
86D22216BCDB56570B2A48C61B4A01779CFF74EC5C0CA509F9A9AAD9136CB5FC,128,128,0,1.0,PASS
DEB7E00F5BD0EA8280DC9D545588BF6767A6DFD67AD7B48C1A796621F3E3A6E2,118,138,20,0.2112995473337106,PASS
B5624D8453E3F5B0E639E5E2EB3009FE4BAF5764250E6AE33A04EF667B093681,126,130,4,0.8025873486341526,PASS
6424FFA9E17358845F9E15304E3EC5D4AD2667E81D59A5B6BA5D921500CAA8EB,129,127,2,0.9005235503397743,PASS
502A48DDDDEB5256EBCFF80151761F0673B31C6787C36B20674914CD02C88055,135,121,14,0.38157390570502125,PASS
A450CF821427C30F422A050C09C4B7512777F8B876AE414FA75F4F4DB1F4C5A7,132,124,8,0.6170750774519738,PASS
A6DF5ECBB370F2379D065A579A08217484F9502FC79A195C698D9E56C20DAF54,127,129,2,0.9005235503397743,PASS
26762ED2398A3E2F3F6287BF4A8A9A04998664588EEF65B3BBE9CC670ACA1D91,126,130,4,0.8025873486341526,PASS
58130EAE6A96F301CD43814A5059197E1DD8F8BB1520CB1E3D0DA962F8B6D2C2,135,121,14,0.38157390570502125,PASS
9C60E0ADC07BE823DE488E6EE97B14725C7D423F966FA4904818E03410C1E086,140,116,24,0.13361440253771617,PASS
6B70021303B16EC1E0F82A22A1928C0ABFD2BAB7D7C62A7CC38C8A948BB3FB3,135,121,14,0.38157390570502125,PASS
25FF79B289C8BA625B623E02888EA07BC28938755FFCE4F5C2E206DA36B97B7C,124,132,8,0.6170750774519738,PASS
4499B3EC6151379FFB8766DDE42B0344F0BC97A1ECF9B0B0EBE41C46E5B7A067,122,134,12,0.4532547047537365,PASS
7BEAFB17BFF8C44D5B543ABD867DAC3C1E29878C297D83536B3B7EE0697BAE2A,113,143,30,0.060792723530522785,PASS
C2FB9C16122525B5B5783BC4B7D08EF632B26C3AF6740461060741BB7E5CBF90,129,127,2,0.9005235503397743,PASS
B22A2FB78858D7D94B3A42E1B7D1277A740698BEB53EC95BF32CF50CE917B0F,122,134,12,0.4532547047537365,PASS
EEB38D64EFD03FFEF46C4814CC6AF7783FD03F7A35069BED8D71B89327A0DD2,117,139,22,0.16913144470267139,PASS
A5F6866985264E84CDC421DBE72190A79F5FDBD7DA08ABC7CC408594F43C2698,130,126,4,0.8025873486341526,PASS
BF596D7207AFBCC4C3090B7348D8F2A32AF7B56CE8D249349DA3C39D788F2A5F,121,135,14,0.38157390570502125,PASS
533AFF463DB59C7FDF099C48D028C2C73C6EF6B9FB30EB561A104BD98BB27555,119,137,18,0.2605890342736178,PASS
3D558C69CBE13C271A3A88B303C73E22E2D8D13DE12CA65BDDF18E2C060179C3,132,124,8,0.6170750774519738,PASS
36B145299829EF2B430EF4C7F91632489FC7FE227655F0560CEFD568C0EF4991,126,130,4,0.8025873486341526,PASS
A1108D35A7747D376DB9C46A14D7CE7CC887DF8FC222DAAF0D02EEA510835BC1,128,128,0,1.0,PASS
5470AAF453EA0A314AE7ABD087C7EE4458AADF7996F9376D7B56FC74CE5D6E31,116,140,24,0.13361440253771617,PASS
95B706DB4D37F950DAED185303798899E7D750F1F04E0E2DB5CFBC1F4789F025,122,134,12,0.4532547047537365,PASS
13DA6576394A837A63523FBDCF13ED8F4ECFB0F7429D5C567B65D91698D13115,119,137,18,0.2605890342736178,PASS
D7011AC904A28BF2C3BC9C2AF214831A5B1709C14878DEB29E9C2FF94243C142,140,116,24,0.13361440253771617,PASS
615536553C9C14C6418DC7E0C66DD3DCBA8011DA63AA8EC3E1757E01305FA510,136,120,16,0.31731050786291404,PASS
918FD3C78EF5A95D4069ABFBDA00F627E328683DD683A5820B4BA1BE0258C245,132,124,8,0.6170750774519738,PASS
AA02EFF2A094BF786801D8792609D723457D12AC0CC3E500167F250349319B6F,138,118,20,0.2112995473337106,PASS
A9B7B80614AA04A31F862BDE3EA14009FF4E1176F7319F75A51CD9B1B96ABE67,124,132,8,0.6170750774519738,PASS
ED472F1C48D41C6BE2ED7E682DC804AFD9E68AD8A2446B495728298FC5A76A70,130,126,4,0.8025873486341526,PASS
EE682E0EB108C359E192036BD8C8DE7C9B0534801362526E26424DC251BC4D36,142,114,28,0.08011831372763423,PASS
A4312A8F6509D3ED2761EB654B4811496E33413D89C4CF49CFB8E1C8B51AFCD4,131,125,6,0.7076604666545525,PASS
402B1743A8632E12BD52943E1221437FB20EC3245D8CC58781CCEF4352D1AF99,138,118,20,0.2112995473337106,PASS
F4A475BD04AF3F56BB52173BDC1397F85EEA1ACCD99900CC6A42D1BE62210DEF,123,133,10,0.5319710580974012,PASS
34BEC4E15C0CF257115A84D1AA5692C8ABB08962BE74D96970604676CF107D66,135,121,14,0.38157390570502125,PASS
A0212B652126DDA059D0E4DAE3312126E6C4F3E9D7FE2C1DFDA653AA73A1FF8B,124,132,8,0.6170750774519738,PASS
BDCE84A284DFD55F0926A6C5AF12C9D25FCD2DF2374215F645A11D71FF0F2F31,121,135,14,0.38157390570502125,PASS
8730899B87E636CFEDB92365CCF20BA9A5C4AF65336CC15D2D6D1B19F0D08E10,128,128,0,1.0,PASS
FEF47D75DB802B05C2FF19AE9952D925CDA3F9F28EF7ADD785199355CD240F8C,116,140,24,0.13361440253771617,PASS
445A929DC6BA7CF8D8C172B7E877D580AF9A02F4F6177BEB481D4447308310B5,129,127,2,0.9005235503397743,PASS
DB4D5A1C18025C07A1215A108BF5CB5AC5193D362DA9B8E1F1EDF4A1CC5025EB,134,122,12,0.4532547047537365,PASS
E4382A30ADA4A08DF6B5B0A82668CBEE9C3786E1238AD6907D7A4D614DCC195D,133,123,10,0.5319710580974012,PASS
24B19626AEEBB02ED3039761EF78F38C579549207F61859D6685FBB498D125C5,127,129,2,0.9005235503397743,PASS
E509B666A51520FF29198CEF73D8B3E8B3CEB60CB0D424A828194F39F153E64,132,124,8,0.6170750774519738,PASS
79A41A7AB7C266ED4AA79A13B522CF10CCCAFE7D9B1DB17D6DDBF702B69D3E42,116,140,24,0.13361440253771617,PASS
55B2BBF12771B30506B6952F953E9327BF8B70F50A722B2BCE788E891B19A07E,124,132,8,0.6170750774519738,PASS
6378418D9F20D108399850903FFB00F0E3134CB202935FEA906E51C97EF41756,138,118,20,0.2112995473337106,PASS
D2E4219B59D6D7FABBA539E60E26BEF10E6072B46EE452280FF8E281BB24E969,125,131,6,0.7076604666545525,PASS
92362EB97F6E182A8EB4C21EEDF277D3C3ABFBF39A9CDCCCE52262CEB528B05A,118,138,20,0.2112995473337106,PASS
32E45A00833E494214E77A5B0C0F434403BE004A10090EAF69C13A50283BA850,155,101,54,0.0007381569085501356,FAIL
E343ABE1B387255F68E083195F7C6BB8A6F7D4B26214CC3F2877750B8D6B233F,121,135,14,0.38157390570502125,PASS
F15DCB1F164FB97FF80E9E0C84DB2523C84F79C9D8D2ABA66D1F228D499EFCA4,120,136,16,0.31731050786291404,PASS
C5D683C072D0DC107672781657E3049091E9DC60EBCBC3D35B15C3E81CF1DDA1,132,124,8,0.6170750774519738,PASS
B651BA40F754F444EA2D72D931F8848386CDCC3A9AFE79F09B00BF15CE37DFF3,120,136,16,0.31731050786291404,PASS
B9BB1100E6CE16A745216230C0665C5ED698DCD8940C664DE5A06244416F4B02,145,111,34,0.03358661289689768,PASS
D6A3A241A04753FD6D3360C9ACFD05C6ED0D69EB3BE2F57A12A75C09B825DD13,125,131,6,0.7076604666545525,PASS
6484CC77CA81A2243DFEE1AFC9F4DA83A88195BCCACD413AF0841F9192A76C89,133,123,10,0.5319710580974012,PASS
47F666B662E9A9499A1C6527DD1EF90250035DA154D7279210F00B89CBC1D90E,135,121,14,0.38157390570502125,PASS
15BE1A5E10B28F4191C376FC64ECF26789149E69C53ED2479EC0B4641B854176,132,124,8,0.6170750774519738,PASS
2F0586858930B5C89330074D38E71BF03BAD3B192CF595BD984F9AF3DAFC8A0F,127,129,2,0.9005235503397743,PASS
6A5F3ECB3E0D6559CE941A8DD0A945525E3C39BC52E185EBE519D0CF6871F9D1,124,132,8,0.6170750774519738,PASS
F29957FD7BFB0511A769B508D91F908B54109E408DAFA2D8E9042E4DC2D83CB,132,124,8,0.6170750774519738,PASS
60E0464EBCB9314815BEC361963A9F3340C33C815353C560BEDD5663CDCB0D79,132,124,8,0.6170750774519738,PASS
EB4C6F0CC8648EDC78E5A120D710D8A66D6E8679DACBFECE13A8CA59C37FEE51,122,134,12,0.4532547047537365,PASS
13C9E9664C6262668AAAAAE2150921E47B71E84877FDCC0B8DEF9970D6CBD8BC,128,128,0,1.0,PASS
4DB2191C9C2E3D2F96A7D38F13E993936232491E260F26D051F4D44904F36246,135,121,14,0.38157390570502125,PASS
BAB864292B69B058562203E5907B78392DCA5BEB33A97D561EB5B4A3EC017740,131,125,6,0.7076604666545525,PASS
2E643A64F45C4F58C62FDE81AAB8F8E5263939E4BFD4CA3CB9106ABBDD32EA75,121,135,14,0.38157390570502125,PASS
5C41457A411B15B344CAD4AE6481A3533E761E4C3695F8796CC3CAACE86D6BAE,130,126,4,0.8025873486341526,PASS
66D88C4D84979B18C78DF5AACEDB72E54C59EE36192205178EC0A5410BC8B16,136,120,16,0.31731050786291404,PASS
685527ADC0426B5D03A0D203783B98E07018D8B71AF7473D4469692D9D6A150E,138,118,20,0.2112995473337106,PASS
B0FF4B4DC42E5A59400CF60F292253720FEEC8E95A899DFF1BB3F57D0612BB7F,120,136,16,0.31731050786291404,PASS
9986331C8C8A5E20B4A29B52386CDC28F3A4827E5ED2C3732BF58B1A8F807980,137,119,18,0.2605890342736178,PASS
92AADB46FAF4B16FB431964735DA3CC6B2BDB9DAEDE9028FDBEF769EB7BCAB95,107,149,42,0.008664896726025117,FAIL
1A7996D0D94AB1E78612CCFC898807AB755389AFC917C93128D41996C13F6F5A,130,126,4,0.8025873486341526,PASS
44F9C1D11BE6573970048A8674E8EA0E5B495C40AAEFBE18CC1CE78DEDDFA519,128,128,0,1.0,PASS
FDC30345B84D370A627ED50754A3DB049641BBA890BA4D7D70A8B9C16305A5F3,132,124,8,0.6170750774519738,PASS
214AF18A215134C0BE0514598BBFB080D3428FB7B55AB9027F39E3DE1197E36B,132,124,8,0.6170750774519738,PASS
81A9DE406854294B273A833007BD5EE457080FAD293686617A5A52F9852BE22C,139,117,22,0.16913144470267139,PASS
5409D8EB59401CB6C97542A68C26BC2631A9354416A408D9F53EA0B1772C4337,140,116,24,0.13361440253771617,PASS
E2756B8418324E41DD5A8D7BCC12DE6A8C78215C0C41221CEFC7736597688041,139,117,22,0.16913144470267139,PASS
7699BF6AE8A9B9E1D0BB56873E6BE7B9CB570835915541184A336A2F6438E21C,126,130,4,0.8025873486341526,PASS
5D512918BFF06370A37E438A1AFEC2025BBD3E07871F3427CB074782C9D92746,130,126,4,0.8025873486341526,PASS
621B47D49AC40BB861708DD6013DF8D78E342883F2B0513DDFC6E7E5E35B2222,131,125,6,0.7076604666545525,PASS
6B7D52AFC7F43ACF51D3C3C17F714D217C9A672C44D63F02B7E47EA2D82CDE21,119,137,18,0.2605890342736178,PASS
A66BA2B7D648036A7082846D421E101AB1173EAA1C1528F552AEFC567AAFA69B,134,122,12,0.4532547047537365,PASS
A5794156E90470A52345BADA937D1F815291E1834CE0AF25257A7CD7FDA3F404,131,125,6,0.7076604666545525,PASS
D4F39E74CFE0160A1EE8D12D5F27074B94D874271D6F8434FDBDB2FC318CD847,123,133,10,0.5319710580974012,PASS
FA109E75CD8588637C554D4D03A101486406EB31480CE16E34512A4E0E8F0552,147,109,38,0.01754895019147673,PASS
7AA79F167C3325D6155749970FF5946F3345CD653043207025E51F8831BC1973,129,127,2,0.9005235503397743,PASS
38139858FAA584ED2CF771F3974DC7738A20C3E00E7C8770774632996932E434,131,125,6,0.7076604666545525,PASS
7C8ECE2E2E0486A89628ED1D910A8D8B456B0C459F4F74F229EC11EBC4EAF1E5,131,125,6,0.7076604666545525,PASS
701E11F94FB99502D5503602DB106E5F20871241F3AEF6C6F664C68E269B0D6A,134,122,12,0.4532547047537365,PASS
8AC60072495B58D9A81F9B7C2182F39CE88456FC28B0AD29E56E7C0FED885738,133,123,10,0.5319710580974012,PASS
B4CFFF174AF4E516B7136D1ECC1E8AD9B3718A57F2EA3D3DF2A91BC58EB9ECE8,112,144,32,0.04550026389635853,PASS
D2627D1F37DD8693F3E7D8B98569F7B990066B34B49BB7005ED2D99A774B5C44,119,137,18,0.2605890342736178,PASS
DCD3943E90A5038BBFF1E6CBF659430E361D277125574E79E6A00C74C5224658,130,126,4,0.8025873486341526,PASS
471DAE263A92B2465A18BDCB5F8B336BFA80C2418850BD3034B0B9636CD2B19,137,119,18,0.2605890342736178,PASS
345648AD37BA369F23D0D5E16F917D5FE7F78C41EAD6C16F1FAA658B481ADD8D,117,139,22,0.16913144470267139,PASS
1A21E9B86896946B6CAF87E7807661E21916CA9952CE62B6E0CBCC02591DAF18,135,121,14,0.38157390570502125,PASS
880A120B0D982B18DDEE034003955FA5DC615B088F7C798A955F94B77D539942,137,119,18,0.2605890342736178,PASS
27F433AA9DDB0253C0FF9D534A07434347027B8A93E2D659D1DD9994995F8AAE,126,130,4,0.8025873486341526,PASS
F3B280B3355C30A068D34711E4898BC934ED0E40317B1AC011179D272DF1FAF8,137,119,18,0.2605890342736178,PASS
ED1790FA7172DE8482EEECE47706159883B9A21E9B14779BA9F4F48C3BE1910D,126,130,4,0.8025873486341526,PASS
90074C78F890630553BB00E6370C5E6E22241AF3BDFF6B31438F0AF2592F2CCC,133,123,10,0.5319710580974012,PASS
B80FA4BF06A4CDEFCB32F3414D9E18787E854FDBC05A60BFADFAF538ECB40042,124,132,8,0.6170750774519738,PASS
878B0922C735044B09FFA0CEEF395A5DC657984C6BFA44C73404076914188973,137,119,18,0.2605890342736178,PASS
AA9B39922BF27CA33F8B19516D9791F296FF45DA34C6F0AC3886FF71A6634EB7,117,139,22,0.16913144470267139,PASS
406AA73ED8C164727140ED02ADA1415B0CD17C77F9B6ABF7CC6C3EB6750531B1,128,128,0,1.0,PASS
5B067D50B6127FC60AD04303FA7817D96E932C5B4A7658148A012F4AF526F667,132,124,8,0.6170750774519738,PASS
8599704EA3694B9F93BC0B46D8E67BA54C1D7FB87B5667D47864FE3F5E09AC0E,119,137,18,0.2605890342736178,PASS
B6DC84CEE372D4358EFF135ED324859FA44A426CE8FD0BDA5F041AFE4A6062FF,122,134,12,0.4532547047537365,PASS
5A41F3E6733D14BAFACC4A3D4D95795690FF80AC150410892B18A3578D68DED0,133,123,10,0.5319710580974012,PASS
75C0416A21F5B284CC4EB7BC5811133289CC8E7285ED906B0F671E3644260400,145,111,34,0.03358661289689768,PASS
2B53EA997F849EF57F13A3AB81D7C5C08FB1DBF38FA7DF4CE699C86CE883E46F,112,144,32,0.04550026389635853,PASS
CECF87E1A6C82BB9F7BB0B11FBC63BDCFF0430D22D3B4FDE1C7135321818E720,122,134,12,0.4532547047537365,PASS
66908D0FE06AC73F68C193004ECD07DB3A0F8D9CD7DB7820A0D9B7C6467C5795,129,127,2,0.9005235503397743,PASS
629E3195875E73620D105CD64DFDF7E145A900DA2A19C45528FF89A011C4E9D2,135,121,14,0.38157390570502125,PASS
3B47A0A6A979211026ED83EA8AB258E4684BF6757A6D50DF5012CDB4CF3683F3,129,127,2,0.9005235503397743,PASS
6434BAF0533BD1DF920DC8DE1E9E227AFB6910473ACE4DD2074F051FC2CC207A,129,127,2,0.9005235503397743,PASS
8C91A863747B161F5A5770D80B64DDFA189B777F2EFE815FDFB3DFC4134FC1E5,114,142,28,0.08011831372763423,PASS
1F23EDE9AF790908CCC173016E94C84DE682FD04F810D33CD9877F7B5C04BC38,130,126,4,0.8025873486341526,PASS
4A241CF5D32E84BC7E35991B4C4CE016E094C474ED03A3B14BE4687BE8BC1091,137,119,18,0.2605890342736178,PASS
F7A946028351325A2436760EB9A1C2F888F9EB5873906B5C8108ED701EEFD4C0,136,120,16,0.31731050786291404,PASS
136DFACCBF4E7201D10762157780DE8C7F261661CEE0F0BA8556276EAE6EEB06,126,130,4,0.8025873486341526,PASS
47F29AF8823839049B69DCA7E330AB0472655EA76D74319483483DEB468E59F7,129,127,2,0.9005235503397743,PASS
6C668952B9923C9039A82E9B9F904DF67277909B7696A45B52E28C136EAFB263,128,128,0,1.0,PASS
4178529D9384934AFCEF3D2A293A82E928A4B18DE941F1849F9A6988FD2A21C3,135,121,14,0.38157390570502125,PASS
D7A75346D9986D6DD47DF43A0EA640A37813C3A2F0991188D836774A286C6022,136,120,16,0.31731050786291404,PASS
FCB07B2995AE2E3F1D81800345B4E69444C68AAE02F406A7C472B5F18ADF9545,134,122,12,0.4532547047537365,PASS
D0A1EBDBFC3AA83C67532AC64242032015179077A8EBD3A6BF620865409BA65,138,118,20,0.2112995473337106,PASS
BDF7B0D70A8BDAB63B0E3EDDFAAC0C28C6C6F8E2E71BB1BC1A2472CF88CA718F,119,137,18,0.2605890342736178,PASS
A0E265FE16B8AC30F2D4352B63B5F525836EA8C3ECABE07FAF952E7952B3FB8B,118,138,20,0.2112995473337106,PASS
C2B1F7D8F0C77BA0E1EB7A3EC70B9ED8FB8651AA341178184A5151B5F225B6B1,125,131,6,0.7076604666545525,PASS
B776E632E8220F6E0D83125C7F8C6C624115214BF4EDEE3A70F9B48BC5CE63A8,128,128,0,1.0,PASS
6210BD74283D8417409B813BAB3673FCC993BD51E0BFEDE9E0CAEC14D9680E56,129,127,2,0.9005235503397743,PASS
1D7D238F82DBB749889167BE4AAB5703F15659B0E9B8A048C3BA84F1BF763EFD,121,135,14,0.38157390570502125,PASS
80FF9437963EC5B3068DF0E81DDF229094D033EDE99451D5ED903CF39DF5112C,126,130,4,0.8025873486341526,PASS
A3C783EFE2D1C0367539230EC7873A8395B83EA2A507AF18A1018C2A24884514,142,114,28,0.08011831372763423,PASS
65C805D4F7DF4F30515ABD9A571933CEAD7738F790BC51B148A8985D35E082F3,125,131,6,0.7076604666545525,PASS
1B855A713158B9B02CEF3AEF18802CC1022ACB4DD54824F3244B01B78083A75A,143,113,30,0.060792723530522785,PASS
20060B6DA143F49E8552AB2216F6D8CE68EB14A2AB765EDC55E2389A26BB9752,132,124,8,0.6170750774519738,PASS
B7DAD509F9071E2F4D69538839B46C440A40E1A11AA71872CE0F54DE5612F7B4,133,123,10,0.5319710580974012,PASS
777283E13E6CF3A8CB6F2997C9CBF77099D6A19DA406E4C15148174B5924254E,128,128,0,1.0,PASS
ED852E335958938A67D6E8811F73245BCD4D0AB5163D805F76E343D0C6CDEE95,126,130,4,0.8025873486341526,PASS
CEE0B82CAA257515763B6648EDF3060C0EDF8C06B5AECC7BECA24B76C1C80C90,132,124,8,0.6170750774519738,PASS
7654BAA0B1C4F1D3F5D579047373423961F56ECEBEE9E6A816021373796EA35E,122,134,12,0.4532547047537365,PASS
FE34F66E8126AC694A618263FA3E8AE5C88DCC278DB97D9AFEDB7B490344F2B3,121,135,14,0.38157390570502125,PASS
3A1DB1688225C602577AC791225306803BC2B825F7CA43A4BF62B458809E8FEA,139,117,22,0.16913144470267139,PASS
42318BA7EE5ED038BE5B23F9C71EAA7A12083C7C828E0DDE7F7C4EC192BA265,128,128,0,1.0,PASS
9D477DFB772CCA0FE4922E211F0839FC8DC47CE34E71F478C0E2015D853C1C95,128,128,0,1.0,PASS
A5B95A91F97849FF551BBC9E8D17D8AD6BD392719292F90E45B40674FDB0C2CD,121,135,14,0.38157390570502125,PASS
98FE3D4C7BDBF093316EDDF9C231A36A3CDE657ED839EDE7DBF45B9D3640F0A1,111,145,34,0.03358661289689768,PASS
18F5C22454765D1B323CF520DF5593872038EFFABDB45CF489B2CE952538F0A2,128,128,0,1.0,PASS
,256,0,256,1.2777508801076536e-57,FAIL
298425BA65D1BFD9BCC8CA9CA02630511492036867F358CD374BE620C090B84C,142,114,28,0.08011831372763423,PASS
10A84292A9F3AC70C5A8968B8F716E569191D839C6118A23D6841C1086171253,147,109,38,0.01754895019147673,PASS
DAF42B4C5404D50762BCEC5E7EA795B4D41BC59F5AC6740AF0E3BA22A6D1414B,128,128,0,1.0,PASS
80E02B09155F084DDCDAB5E6F63F1B948B6A181AA6816FC8DC9A26A129C08C91,139,117,22,0.16913144470267139,PASS
31A147B1FD4F77D9317163BD660D5478F50F66FBDEBBCFA938693D13E5706E36,113,143,30,0.060792723530522785,PASS
F87697B5E16950EB67E9352A0ED0F4FFC8571996D3AD53071ED1C92BF585F918,119,137,18,0.2605890342736178,PASS
13DC016C84C06684DEB91660180854ECC547523C99470CF0D74F271D2479584F,143,113,30,0.060792723530522785,PASS
23BE948168ECF286CA99D1016B28C601A507CF5B2FCC7F329D288A812D43153E,137,119,18,0.2605890342736178,PASS
BA8A6CDF3EAD6BDE967E7DC3662C23DAFF6935D89B34340F3613E79964ACC770,114,142,28,0.08011831372763423,PASS
B9B038F32EBDA8438F15159FF2BCCE5BDE8C625188E4C7E0B8C94B82BF66B43A,124,132,8,0.6170750774519738,PASS
69F92B202E39AEBA80A59B1E8F5C01D9E620366CAB9B329C4D875A2BE7F27952,128,128,0,1.0,PASS
A9F7CAADE0395D727A5CAE2281AD59072D4064625094C2CBAC667B422DA8295A,136,120,16,0.31731050786291404,PASS
6F891D748DCD29E37B55D7647EE4750F5D9295F092C93E060128D2FAAC213354,128,128,0,1.0,PASS
70E779F2AC07E29478F6CFFAB1578A36CF156E06583AF77A8E2D9594C552797C,118,138,20,0.2112995473337106,PASS
F49D3BA0F6938487389A24A06C566F16CC3BCDD7B2AAF537A75983D4162003AD,129,127,2,0.9005235503397743,PASS
27A332A36A5E19430A0C6ED41C913D4BE3D75A60879BA36902DC11A72539309D,137,119,18,0.2605890342736178,PASS
857F945EB1523E52AD8867CC0100CFD6406F5A2771279DC17B39B022D2F1399D,131,125,6,0.7076604666545525,PASS
BABC9A6DC392A8982254705DD4F93DC798198009A4106FC2EF0D22F9C82F038F,136,120,16,0.31731050786291404,PASS
BEE45CEC58C36F72E4257789FE5A8A998D3FFCCEDEF69D9FC756A1D6D9A4D298,110,146,36,0.024448945310089426,PASS
41EE0BC907400B5B437CA26D96993969F03BBA759CCEE6C1D81AA9FB40889B9F,129,127,2,0.9005235503397743,PASS
92A48E3D5B43117997665518FB4DB1770268E55AF64D54FB69B5663F6DB22F65,120,136,16,0.31731050786291404,PASS
90BA0911129C111DB7E6BB8B1BD4F2BC6F070E3E639D6CE3BCA957439B5AD16A,125,131,6,0.7076604666545525,PASS
CB5F7FC8FE68C40E7E3328BCF1E86767F9365E6547B821532F8E18C3FCC38430,121,135,14,0.38157390570502125,PASS
1C2ABF8DC37DA8BC5B671EEF4B43932FDF00D6C0D97507E30A893858378ACF6,125,131,6,0.7076604666545525,PASS
33C2CD0A9ECE742BFC28CC9FC3527CD5F53911A0F532D48A817920F4E768D24E,129,127,2,0.9005235503397743,PASS
DB852187C2248A7DB3236661B6DE6A3972BBFD9A7548EED220EB09535E8C80EF,126,130,4,0.8025873486341526,PASS
12511B4E091F37BC00FC0054FECF3BEA58F77E7ADDFA89293E0577C8F322C82F,123,133,10,0.5319710580974012,PASS
E5E1392E2402599DCEC2E4451D8D68E523491FEE0CA782E462BA03C96D797E97,131,125,6,0.7076604666545525,PASS
33BE12182B30A3C0AD55A861EF367BCD943550D91D59C44857FD710ABCF1C3B3,129,127,2,0.9005235503397743,PASS
C72EFDAB1A9932B6E78F5995352A931756A20EE5CD697759315DE112FD474C26,121,135,14,0.38157390570502125,PASS
C0FABAFF52156B9BAFB6F9C184596BACED263CBFFABA44A4B49F96D1681E2C92,117,139,22,0.16913144470267139,PASS
C84CB26453668708E8057BA249C9FA099A16ADEB2A5E47F8FB3096D974A6121A,134,122,12,0.4532547047537365,PASS
10D773345512593A67FF91A6CF16C78C707BB8370D050230E478728B93E53467,131,125,6,0.7076604666545525,PASS
2373D5290E75551A20C74B5A07BE75D02515BE11D8E1C1D1812EE59E877AC36C,132,124,8,0.6170750774519738,PASS
F27F3E82DF84BB7B1CC4D7E45D7E3E24F65B45AF2E9092E30898F37AB1FB52A3,115,141,26,0.10416255883043901,PASS
1EB93C11E00A4F78232922A3B5A4E11E5FCEC6AFDB023D897D293AC0BEDF1826,130,126,4,0.8025873486341526,PASS
DAFAC705B4FB53AD739F17005FF9A81638E846D0C8D537933818C88DBF4F5D78,122,134,12,0.4532547047537365,PASS
D2B405276984686DBE6DD10D70BC54BEB3E32BC9B5A536AF3EEC4984F7D1AA01,125,131,6,0.7076604666545525,PASS
22AC8FD5B426F5A273E8E69FC3FAFAACD6DEE4AB6A29C81E5BF0EE6DC2AE6D2,116,140,24,0.13361440253771617,PASS
C09E0BCD2A36EED7526E63151EC8088B6D79900D65924535C6150F7852C5B2B5,135,121,14,0.38157390570502125,PASS
BC07321F9ED68C775486FDD0F5BD0E2CDCB152E0AD3346EE3004D181A6184E47,131,125,6,0.7076604666545525,PASS
AAFA72D9A2C0BED0375FEFCC0D53FFB90DFFD449E47F8EFDB081FE31ACFFF848,107,149,42,0.008664896726025117,FAIL
DE612A5E9BA3275F52F3A25B48E3A336907B1F1A5EBE15EC2E35E999A60A0F2A,123,133,10,0.5319710580974012,PASS
EC0CE23902E3527252EDB49A0F3097B187E37D2B0E306C2B74F4C15E75BCE52F,127,129,2,0.9005235503397743,PASS
B105D4B9B302A5DF67AEF8D7710C434523B023C3F7584F99DFB6582EB49496F2,124,132,8,0.6170750774519738,PASS
FC2D4FD80ADEC1427869D1CE0B22A06D3539D51DAAF0DEB2BFAE3CB884303B4,130,126,4,0.8025873486341526,PASS
C0C9006B6E35AFC6EA140D41E06893B1DFA9847512125608A87DA50E8371838D,143,113,30,0.060792723530522785,PASS
1F420FCE1E5EA8265AA72FD5E01D035ABD6119E9098BD1A408744B8C5ADFA6D3,131,125,6,0.7076604666545525,PASS
9F6D49C31CE904746D5BF6DF93F28E33A4195C70AEEACB0A0372C16A8A164587,129,127,2,0.9005235503397743,PASS
1E097923B9FD5D9AEEAFD329DAEFEFF733E3F1FF744B49053825F1A899DD3D6D,106,150,44,0.005959526470109114,FAIL
C2B45B85606D76D187C92285C97DA4E0F4DBAD3E426CBFBC8F9B9A81CD89A779,123,133,10,0.5319710580974012,PASS
2A46CD6394F95DAE928159AD9FBB6491522AF3DFFE5F43879804BEE201005360,130,126,4,0.8025873486341526,PASS
17BAEC737EB51C573E814616A0EE77947B6108EB02C3C5F8B551162BE88E040E,131,125,6,0.7076604666545525,PASS
DA9ADE3D81E5C2DEFE33CBAF58E7CA3E6B6CD2F4D3F69C709E6E217120428989,119,137,18,0.2605890342736178,PASS
421730C51BEFF5D44DFE649094FA2B6C4FC12D9DB6EFFAEEFB8C1B0EA81EA250,120,136,16,0.31731050786291404,PASS
55C24C34F21B034C4E564028DA634C5942D5F9FED0FDEB3AE895EB0324BA5AAA,131,125,6,0.7076604666545525,PASS
9CCD529229D7527C0F5FF192A3C36F13CDBAE31E159678143FC36A6EF0ACEF12,121,135,14,0.38157390570502125,PASS
39373A85E37578BE3BAA88FC3943D4546472C2DAC375DBA70FF763674D56DDB1,116,140,24,0.13361440253771617,PASS
CB5939E25F8BCF5ABBFFD21491781A67C3F9E3E74EE49CB468A98032A611103C,125,131,6,0.7076604666545525,PASS
7B90F89DA2151449B6AAEA55A616767CA309405CF7C5DDCBD8012805D7A88565,134,122,12,0.4532547047537365,PASS
F86C07E71A9670365F7C7E8ED0EAAD0318A76ED29C3D1C9590CE36F2A7FAC6EB,119,137,18,0.2605890342736178,PASS
D5AA2500E9D8C4B62851937295C26720492CA186DCCB311C93A3EB0C3DA17CE8,140,116,24,0.13361440253771617,PASS
87501906FA7E3209D15E625DF6AAECD7841D27F33BE343CAB058689CC2C16085,133,123,10,0.5319710580974012,PASS
DB39227059D45234F896424F5F96BB1348C97E38BFE56C9EDFAB046C202E73A8,126,130,4,0.8025873486341526,PASS
68B9649A1EB36DF6B819AAF303F716E627B4C8001B5CEA7272D43F4BE9ED41D7,122,134,12,0.4532547047537365,PASS
61E1920186E385CDE250A17615835A2DBBAF8435ECFD601D07B1D7CFAF1CB701,130,126,4,0.8025873486341526,PASS
8C31F21886643CB3519A394DFD974E8594C353418717A9345B94D4CF3F31CB9B,129,127,2,0.9005235503397743,PASS
F367989653063EA029A6EA2AEC9E711AC7A51F4981D89F20DCC5537571768186,131,125,6,0.7076604666545525,PASS
A453C18E86E013C26EF0F99D0CC1284B36C5DE6602BAA7C04E06DBEB2673A743,134,122,12,0.4532547047537365,PASS
1E009BCC66DC994D5C5F7B9C43675B8F08210CC5E2956A4377518BF3FD4A28C4,130,126,4,0.8025873486341526,PASS
C10033D159C1BBFA15F8DBCA71E946EEE2F5BDA48D976DA5B7CA573B53FE2BA7,113,143,30,0.060792723530522785,PASS
BB1267C35532423374D80BB5DB2D51F5FBB3D3FA823FD7341142AF9AA1B1DCA5,121,135,14,0.38157390570502125,PASS
4DFCB0EA987A1A76748AF53602FAFA7DF9AD9136C6093E231210F87793FA8C9C,123,133,10,0.5319710580974012,PASS
DBDB1A865FDF3BDB0E1669A05BA4CE6FD1F5BEFA013104E88F72F75F5CEC2A3E,113,143,30,0.060792723530522785,PASS
10ADE4243A6F0862DD1BD23388B31E7B507446BB339005B74957DE2BA4190CC0,138,118,20,0.2112995473337106,PASS
58A4FC871059FEAE568FB7EACFDF19214AAD9BDAAFAC016EDA2F2C1792AA7E46,118,138,20,0.2112995473337106,PASS
3FA9ED0B2BDAF142DD32357F758F9BFF6C39D111C9FA08A1F0BCBB75CA4FDB44,113,143,30,0.060792723530522785,PASS
6A93147C9D113DEC7F950DD3034AB08C58C19CD31BD3475E4492E948AF646B6F,129,127,2,0.9005235503397743,PASS
27AD06A1A9B9772D2ABEF0B8816EE6731093285C58354D649DDEF186620FAD76,128,128,0,1.0,PASS
4454452B3D1621EE4BCDAE8FF4B2FAC07EFC39D6CC9EA1B56C54C20214BFD07,128,128,0,1.0,PASS
1BF112FE1FE716E1914B173E52D81ADE8EEBEB650476DB7717408C776478E5E3,119,137,18,0.2605890342736178,PASS
6E7E2ABA1339ABA15440021914BFDFED765865B3763AAC6AC74FD53C16D70B9,125,131,6,0.7076604666545525,PASS
585F0A0689628E7B0EB9305884EDF8F3D1620BABF3C372BB7E4E57D1175D891,128,128,0,1.0,PASS
37012836F59FFA64CEA3C593E4A10B42F8E27B57F4AA9F9FAB1ECA08542CB577,122,134,12,0.4532547047537365,PASS
92098A06650232BADFD610B7E392E927D22E4B43587107BFCD1EC0CA7217E070,136,120,16,0.31731050786291404,PASS
3E610FC6D265B7C1CC4C12169CBB9B94D190961EF49438D026775A06C580F728,136,120,16,0.31731050786291404,PASS
760F51448F200E7E46F2E5A521BAC236E29878D31D015233C0FFBCCC31A0689E,136,120,16,0.31731050786291404,PASS
6B030792F5D5521DB19408340C1473188309B751522A13A69BE5D35C39EECDD1,138,118,20,0.2112995473337106,PASS
EC6D998952843A345E703DFB173F7B0E6D1D8CA5DDFA2E18744A1350133E921A,128,128,0,1.0,PASS
A9B5147E21B7AF54A89C60FA6B9CF6AB090A897CCBBCF129FDC06C5E72558AE,125,131,6,0.7076604666545525,PASS
B29BA8BF6817DFA12F177048D68B6F815669A9EA431920BCD46958408DAD9375,130,126,4,0.8025873486341526,PASS
564EC6B552D5094AE8CD10AA3E189E70306C310FAA4928D3D1F1B2A8529CA60C,141,115,26,0.10416255883043901,PASS
C15C1AB92B82A17DBE409DC3118CCB40BAA359E9FBE36815E585ACEC7981D253,131,125,6,0.7076604666545525,PASS
32C0A3238C62FD6816D922CC339B0EBA0093485C87EF38B72A2DD30AC8ABEFA6,134,122,12,0.4532547047537365,PASS
DA246F175ABBA6C7E2EACD09DD5857828717EDEBCE9CF297B80AE475D6337A8D,116,140,24,0.13361440253771617,PASS
2AAE42FC37AFBD23FF4CFC057418D50C5C50774E160063A741B8E2ED346BBB6F,124,132,8,0.6170750774519738,PASS
B2E65BA6543745B56704FCC91D80C9CBDD1FD94FF43EB295749C4272193800F8,128,128,0,1.0,PASS
14F112E2177AE429532B5DD60820330D7C0220C45A4B711858E79E7A21A5B2F4,142,114,28,0.08011831372763423,PASS
60FC85B89FC380C3AE0F6092C2546D1CD53946AC5F8B01A8A7CF3CA7C537CD0E,131,125,6,0.7076604666545525,PASS
BAF314CCB4EF34D9C9FC0843822EDBCABE3EA043DDA21A7D61BB5D2BE67C4062,124,132,8,0.6170750774519738,PASS
36DC7E8D4FE9450661047F06381C086A3F60A78016F54E2146C9F1873F400CD6,139,117,22,0.16913144470267139,PASS
C279CCB4A23AC6D03F129DB7DCDE050FF777129338ECEFE6CA284251BB2FB99D,119,137,18,0.2605890342736178,PASS
1E151ACC84E54DA68735DE64A5594C36E5098297692546E5FB4E03B8CA334E64,134,122,12,0.4532547047537365,PASS
7C4C1F26E7409DA0C1A84AE02F04F73C5FBA8788C5187028D5C6D13D239CC554,137,119,18,0.2605890342736178,PASS
9C6EF517DAD3928473B0DAFF57E7F85348D70F2D7E7B701533AEE4DEE826C551,114,142,28,0.08011831372763423,PASS
AFF869FFB0549062447C592D85AC14CD1B71A0B82E04509385342D41693406F7,140,116,24,0.13361440253771617,PASS
8539C8151C17258604F9986B7BDF170227D3001FCEAF2E0C402E9C13BE581787,137,119,18,0.2605890342736178,PASS
DD5C048B1C3EE1BDECAFE9A4EDD4820836AE685E3258ED44E0D6F0116CBEAA46,129,127,2,0.9005235503397743,PASS
44364840EE12B79A1B0F1FC4D061598331E5B83133239D250D60A9768D5D5427,140,116,24,0.13361440253771617,PASS
5F4EC17F0361484F1720D363BA48A4F39A875FEE8BD93B62A012D389E7CA6C5B,126,130,4,0.8025873486341526,PASS
A411CBD2E5104CFE7DBACD566FF1AF54BC04A338EF03A3BF1E923C4107E249A4,127,129,2,0.9005235503397743,PASS
C0E07CCC43B65A3FD9DA80FFC9E232AD78BA0439094DC193CE7F09F0A4E8526C,130,126,4,0.8025873486341526,PASS
734FFFB8DD054EDB6B67B76AB87DDB9AA9B35E7D90A7332D385CDEDED4BD0803,109,147,38,0.01754895019147673,PASS
AB259303682E1B46764C46865F63FDFB51936456E601EC45300C80EC5DED1D93,133,123,10,0.5319710580974012,PASS
D8B2642BA10D4233535408EE70D465A9785FCC4CAC7E3EC2147C212673232824,141,115,26,0.10416255883043901,PASS
EFFDB4DD57664B2A032124FE5A217B670620B2ED075C36A4F462BD4825DA5DC0,128,128,0,1.0,PASS
FF540A2F2A9DFF33A31E183ED054ECFB2906530161EEBF42D961792E912D8DC6,125,131,6,0.7076604666545525,PASS
512C1AABB82C7148F5CF04297CD3F68B16CD0A37E24C2FD381D98DC5F083591A,132,124,8,0.6170750774519738,PASS
DA52FD0A51B922523023CBF42BB2F8283E770DB6F2F655442323E688CCE80977,131,125,6,0.7076604666545525,PASS
F358F3B85F793504545821192020FB73B874ED51C4CC0C82B63BDF0C53E243E1,134,122,12,0.4532547047537365,PASS
8F9278787811BB241E6126FE9DD9500043A7E4A76402744B9E1C052888277AD7,139,117,22,0.16913144470267139,PASS
BECEF9E0804C3FA342A56C999B99EC29CD2127DEB04662E8DC61BA3F099A917A,128,128,0,1.0,PASS
1F174F8F665A5C221FD8F2624C3D0DAED376347DDBE5A17AB300A06723473776,123,133,10,0.5319710580974012,PASS
31590E3815D2F24BD365EE49597D57785EF450EF1428C48181C048263D676C94,136,120,16,0.31731050786291404,PASS
4B95D7D1D33FCB787F46064CF6546CA48510BC2E395787FA86F96C33DC2AF993,120,136,16,0.31731050786291404,PASS
B3FF50AA114106861B6DD03349DCDD141EABDAB03B9FC9394504A6CC43BFB2A5,130,126,4,0.8025873486341526,PASS
C304C33EED1AFFCB05C2E61CA8FDE46C8DDFFCF284E78E1C77D8CB3DA978EA33,115,141,26,0.10416255883043901,PASS
913B4E00A1CB0732C94C2ABF46D7D29BB1FCF2F852D1E7359043E3848954EBF9,128,128,0,1.0,PASS
CB239F9997D3BA2B5F18CFD22BAB2A93CEAAF42AF84C9142F26AF2A244A5C856,125,131,6,0.7076604666545525,PASS
A049435023BC98372ECF18CECB3A80D8D5F44B0002199E47E7DAE7D3A1BBDBD0,132,124,8,0.6170750774519738,PASS
FCE7635C219525DCA823BC8FBF712AE7618FA61069C596B9A266178479EA9A97,124,132,8,0.6170750774519738,PASS
14C3641339BA6CCDC9F5FA9041D321A8043FAEAC7DD73D980960C260508A2C3B,138,118,20,0.2112995473337106,PASS
60F071E94243B388AD107935F15EC0B9E043AEE610D35955ACEB4B2703923201,140,116,24,0.13361440253771617,PASS
93F25D71331D7885AD9F35B753252B59877CFC34E505F0E47F98B569986100F1,124,132,8,0.6170750774519738,PASS
84D1288C0601ABE1638217BADDD11AD854277E1B4520B1422CD2A6E127CEE3F5,139,117,22,0.16913144470267139,PASS
851DEF93DA9BBD9792E38B2A7AD472022DBA90A1872E6153C4A5EF42E84F48FC,126,130,4,0.8025873486341526,PASS
C7AB171EF2CFFB940E4B623273D025A2CBBC54225CD16734E0C00E110FA54B76,132,124,8,0.6170750774519738,PASS
E4CA0E5677955BF834DEA09331FD237BFEA51F72C224F7521222B374096CE524,126,130,4,0.8025873486341526,PASS
1D3DF596F121A382159A81AE0308061D6F6809A449461EB933298A9383CFCC63,141,115,26,0.10416255883043901,PASS
FC2BE0A91F731D8F3848D18C952768E9BFAE40D11892434B88AFED36BBE6FC78,124,132,8,0.6170750774519738,PASS
58DE704CF71E242FE708092B4AB15DC683693B87C774C089815F1CEE19A19099,135,121,14,0.38157390570502125,PASS
84ED57EF5F798F5C20DE4AC26A71628EF140F47A1B6AD7F9BB4614E3C16021DF,122,134,12,0.4532547047537365,PASS
8F02B484943F006BF1D0572962BCAE05D505F82086DA02786320C069A14EE6D6,145,111,34,0.03358661289689768,PASS
950197AC4ACB60E3F26026D1066FA9356B61FD0F66314E05DA735170567BF9EE,127,129,2,0.9005235503397743,PASS
B22BEE2171692CAB3BDACD95ADA1E30B68649D3DE2620F2A957B4D8905C9BB70,127,129,2,0.9005235503397743,PASS
622AC6A4FE2DE4BFFBC48B51A67115A206C4DA1D4CCDED98C39DD7778C002CD2,128,128,0,1.0,PASS
2D59DECD2AB1A2AD346405927A47470DDACE42F0CDC79FFF6C8A5CF213784573,124,132,8,0.6170750774519738,PASS
72D51584D1B2FD0B19FB04FA47C32A410AC3C7C9EC4BF59108CAC23646DEBEE0,131,125,6,0.7076604666545525,PASS
A8AF308874FCF4D0E7C6C944A1D33E4BB8F1827C2898FB576611DB183371FAAA,127,129,2,0.9005235503397743,PASS
979350690F5EB95F065825685AF69B6FA2700C40A84A5957502215AFD0E6DFD5,132,124,8,0.6170750774519738,PASS
A5AF31C24F3270AC60CA1279AF56837E7608C59DCAB9077CEC9D190481FE268,134,122,12,0.4532547047537365,PASS
18EC0526049A1CC267F1C76AD98558BF198BAF072A3808F2A15F1A59FF5B318,135,121,14,0.38157390570502125,PASS
73859F402AC18FB9AC3E983007A3798AA60D990469AA909A323E44414FE7487D,139,117,22,0.16913144470267139,PASS
F79B5A76C85B12327623B33632C25BC754A4AA154027871E6F0871715A4DBBA6,130,126,4,0.8025873486341526,PASS
C2463118435E60BFD137AB9AF5D49D271815ACC717C23B5BB2F7C4724C5640F2,129,127,2,0.9005235503397743,PASS
17AF8FD44211B42C086AB6EA6D82960ACE68ECAF55BD9FFC1297F88171F2F3D6,123,133,10,0.5319710580974012,PASS
8E702C6083DB83FA5017CC810DD71907D06EA30DAB57CFA4A5646B88D9199B2A,135,121,14,0.38157390570502125,PASS
8033ADE48BC17B566B6420FB2050FCC72D94027183AEC1C63C441D8A7E9263C4,139,117,22,0.16913144470267139,PASS
5B82460C5D9E829D17CE52B5CD8885F48C16AF939B5EC0C67C896639550FCB50,132,124,8,0.6170750774519738,PASS
9A49E4D2600562EFDAF1A701F78528F04B16BD2B4FAD02C76163AEDB579447BE,126,130,4,0.8025873486341526,PASS
49D0AF0DD55B71AA5DFB1DD0DBF75DD891F467805033343AC5CC1FE6173080DA,125,131,6,0.7076604666545525,PASS
DC6EB19710E007877A82C8F5FAD071EB6FB6B1D30C87ACB2F2A8DEC6D58FDB3E,118,138,20,0.2112995473337106,PASS
14DF11498881192C6FD1CE75B25D40F26AC1903C0C9A5AB962DCFEE8E57159EF,130,126,4,0.8025873486341526,PASS
C6209D45F0567AED4BF1B1E2D4D28CE49AB92D2C99AF5417D37FE16C50E0037D,126,130,4,0.8025873486341526,PASS
86C0D4E0E29538AF3D750304476077B0A0AC0B02BE5130CD1F2614C1DFACBFC0,140,116,24,0.13361440253771617,PASS
C7330C178A9EA19A3E234C7C08E89013D981BCCBD65492370660DC284EC7DA6F,136,120,16,0.31731050786291404,PASS
A60156DC499ABA4AA8A2CA19C98D92300EC034664D5E944269BB9417E215D9AB,141,115,26,0.10416255883043901,PASS
D643F0D077D11F0BCF203F29D68C7EEF7986E63F207516535727F7AA0D076C68,121,135,14,0.38157390570502125,PASS
EE4C17F0DBF569072E69673CF6944783B56D7ABEC8C240182EA3A6653CF53E17,122,134,12,0.4532547047537365,PASS
77930E649E2E4E9B49B17C6C29031710284D7661FECD106D16882553C877BE80,136,120,16,0.31731050786291404,PASS
764FBCBD2C6BEC6F4C998864D9266C5013E741386C6B89C4E65991682C3A8FF6,128,128,0,1.0,PASS
AC26168AE86DAFA680202B18E74A4D53E728C15080F3115826045E313A075B56,146,110,36,0.024448945310089426,PASS
BA6437E5E075EF28D94753EA645F61158DA00DE0F1ABCDC3B9C865F3EBC5E510,123,133,10,0.5319710580974012,PASS
1A1E9BB80FBE2C8B047EA5F21BAEEEA68815244499E52C2D8F1B8E5683030EAE,133,123,10,0.5319710580974012,PASS
DAAEBE229376836194B1D049004DD54A7F1B3F9CE8DDC5DCD0824497D08E4235,133,123,10,0.5319710580974012,PASS
DF5F7F49C9655A1E0DE126FE231550B890C9289BC1CA4EE7308A31D5CC462D51,131,125,6,0.7076604666545525,PASS
CF52E80E24F76D7A946AEB859E22B79C60B40BC0BF0D5CF57339FB07A3C8CC9F,121,135,14,0.38157390570502125,PASS
6812653A201B64DA61DB0C66300E2B0846E635F57ACD3411BCDE7C864E37FDFE,130,126,4,0.8025873486341526,PASS
2A7737F4A1F43B201D9223C089BD1CF9A56C5D7D6DF42F45CEAC660555826E33,126,130,4,0.8025873486341526,PASS
2BFAE2167BF265527C565235542FE9B4DD3288AC37805FB2B42031BFC87B0127,128,128,0,1.0,PASS
CA6DE05FB6230A76710409B0FDE8E456050318E9123B301987B2BBC7636C6124,139,117,22,0.16913144470267139,PASS
17BBB3AD0CA889A7D04B585707DD44355B977DEFF94387EEC02DF765F59AFBB3,112,144,32,0.04550026389635853,PASS
9B1AF5C649D85A7090639DEEDE0E6DA1B357BCEB43F1DB48FF9EAB3D54AA02B9,117,139,22,0.16913144470267139,PASS
DB057B7099D939BBD5CBDA5968793BB209AC90E37B3B3D95B1B09AADAC009025,126,130,4,0.8025873486341526,PASS
FC0734E6102C0B02E9F0BE3638411C9E123E7176B0C087CD7A5808180BBEA3EC,140,116,24,0.13361440253771617,PASS
4B79ADD29587F3D092CA61EE00B8366305D18263B537D4CBE0CC5AEAC0E940FF,130,126,4,0.8025873486341526,PASS
3CB2BFB64B9C0569ACC26CBA616C713AE7574FF3F4C182E8C939B10E6D264F16,124,132,8,0.6170750774519738,PASS
D85DC54D4954B11D8ACF69D6FD1034805B28198C5A91694AC5E3062B6574A8D9,137,119,18,0.2605890342736178,PASS
E56C4367340B5D90C370F319AC6DCA3C57CFDD60A1A7107AC85461299F241224,136,120,16,0.31731050786291404,PASS
DD025937C3C9930714847768E72A8834DCC1119303725AA31C07039E60DE7110,144,112,32,0.04550026389635853,PASS
393A919721FD3F0F21C4700ADF03989E3457C0D0E17ECDE633BD3934C3F2225A,129,127,2,0.9005235503397743,PASS
11D36DE455C4B6E889A5B7102C986A42E61CF28CD523A42B7D8998D9E57AB1BA,131,125,6,0.7076604666545525,PASS
BFF6FAD25C21D05A6E0E5402F1E36825E9A49527C4B516A392CB526868B81A60,135,121,14,0.38157390570502125,PASS
E8A6678673274A073777661C5EAC5B3F21B927BCCA6216CB4E2C41D749433957,126,130,4,0.8025873486341526,PASS
BB347F6FEB680B66B9C98B333F44B9521255F1803FDB0005928DB9BCA0BBD688,127,129,2,0.9005235503397743,PASS
B68D67870E7188ED917FC4AD5E65F5B3D06745C32725A31AE9251A2BC7C23126,127,129,2,0.9005235503397743,PASS
,256,0,256,1.2777508801076536e-57,FAIL
6D51FBA7B5DB4B382176E32DCE6B35832DA895F7A07FA53E417997A2F2C8B566,117,139,22,0.16913144470267139,PASS
8B79284B61601C9EC46DE0F06DFB5B28EE46641883127956956FB767D975700C,130,126,4,0.8025873486341526,PASS
1A5CE7678C5FFDB19237BDB4A07B530BA4806FD1B7632D43D42AE3D67F43BB82,119,137,18,0.2605890342736178,PASS
998CC576A1A07EA1A1952E6A7738BA17719DA00E1F886209763DE354828EEC21,136,120,16,0.31731050786291404,PASS
ABA95A33BE063B2C133B258D4D103D54F574255C6EB5F02419352ED3E2F141AA,131,125,6,0.7076604666545525,PASS
1C4EA98620E59C4384D2B7475139814EE52246F401B869F2E652B00DC116879,145,111,34,0.03358661289689768,PASS
ADC4895B64AA248D4A0A091B3985551DADE81D3C4CB05B7FA8A7DA0924554FAC,136,120,16,0.31731050786291404,PASS
4343AD8FEDB4B951D8307B65AC25EA3E7159C87F7B7D301C924109A7313C9C86,128,128,0,1.0,PASS
F994FCB16077512A201726E64A14B59103A0C29D2E58A2F9678B47C18AE3305A,139,117,22,0.16913144470267139,PASS
FC44BFC8EA9DB28D4911E5124064462C62905F3A0C3E42449589EDBB13A97F41,137,119,18,0.2605890342736178,PASS
789E023359D734AC1E350A86836928D7A8182EAF63B61160893B9268F5439801,142,114,28,0.08011831372763423,PASS
15F14F166A433DC044A486F171F609619FFCC1DBFAB3653525A8F31EFDA72D0B,123,133,10,0.5319710580974012,PASS
EBF31ABD6D3293221F7A85C66114BB7DD6073F038B4DEE5AEE14D785A06962D1,123,133,10,0.5319710580974012,PASS
AF24C2E87E4CE218E26C8EE4C839672F6F8A3202267E522086187EA894671D18,139,117,22,0.16913144470267139,PASS
5F462A5F155BB29A06A5E46E24D22FA5695B5A81FDF15C4C83FEB34BBAAD2CF1,121,135,14,0.38157390570502125,PASS
DD7F9CC1D1307D46FDE1B0CED58B0F65CBC15EC7F299D82F37B62B55320F34B4,117,139,22,0.16913144470267139,PASS
A0B5B37A3EC4CA1A71937271A153CF8701B1607CFB2A49E8488154605211AAE0,141,115,26,0.10416255883043901,PASS
2035BE14960AB974992055CF9A17703954E1FDA235ED3477384FD7C8BA0F4416,131,125,6,0.7076604666545525,PASS
77EA4F30527A5F4586246430708DE77C95E5D6C8231EDA04C614D298B33AF4C,134,122,12,0.4532547047537365,PASS
61644224C4DB122E3D2837232A79C0F2F0FA396E8A2A1B09828354E891F3C6F6,139,117,22,0.16913144470267139,PASS
BABDA29EFCD28C5128EDADA0C6293224D24304EDA7209143F1BD7BE667DDB28A,128,128,0,1.0,PASS
1FBE1718FAD6C67F4DB448B001BA4C60CDF56C70B579F11AD4BC812CF670A103,129,127,2,0.9005235503397743,PASS
BBFD9C06347409ED7AFB30A4838554181A8B5DE861D0DB825B237CB0878CED66,131,125,6,0.7076604666545525,PASS
905CBC2D71E817F8F10DE7D9576C5EAAC162472B66B3CE04D707DF67AB92F63F,117,139,22,0.16913144470267139,PASS
3D624E2D76B866C3A5AF14BE4887CD304E9BA18B700BCB80173BB124FCCE5325,131,125,6,0.7076604666545525,PASS
3DFA148E8C84E2789D98B60E172FE807CFF9DFA204E8540380F6DE0F67257CA3,128,128,0,1.0,PASS
5ACC1205FEB0343AFB31B7240D24DB8484725FB855E0B9CDE680D499891FAF9D,130,126,4,0.8025873486341526,PASS
722AC320F1DD76511A2FCEB637DE8BF957B27415296F6D8793A7E4C2FF661942,119,137,18,0.2605890342736178,PASS
5233829A72BBA4D13E969AEC32A6ED642CF4894406DCD1DA9DEEE65005D7BC73,127,129,2,0.9005235503397743,PASS
BB63DE52CDDA4B744A0AA30AF4CDDF6352D99093FDDF726F3B701CE91204C639,122,134,12,0.4532547047537365,PASS
3882A7AD01B860A739840CEAA2AA738859DF9404D0D949DE6196589F918A34AF,139,117,22,0.16913144470267139,PASS
5A90C4E7F6B29F8095F4A60037B08A3689E977F5DFE0B18CE147DE1001768571,131,125,6,0.7076604666545525,PASS
E71919922980E2ABE9684890A4D0F6A0F6F3D89EBAE5849F1DF284A2C602C8F2,136,120,16,0.31731050786291404,PASS
6B9892A32C90634DF42FCAB065E5066E9C7DA9BA4624CFB964BB067697325617,128,128,0,1.0,PASS
D99607701E89175A63122FE5F28C887F866272B299FEB800245D66D6EFBD779A,125,131,6,0.7076604666545525,PASS
675E91C2D92CD50BBF6ABE1FE6CCB0822478EA348ECDDE97E0F4F2017471CB38,124,132,8,0.6170750774519738,PASS
B3341BF34ADB6493FDE07BD5D58EDF6EF3FDB4B904FCBF3B863904ECD6C84954,112,144,32,0.04550026389635853,PASS
DFA3BBCC79C7155A76F8F4B4C6FAC5D1CC2425AB8D86C2DDA0DF066D9C77C89F,116,140,24,0.13361440253771617,PASS
D7E1D63E772B0A8303A80179A2735CCA880FF139CC8C16E1543850E74A1C5399,137,119,18,0.2605890342736178,PASS
B7AF28E2760ED896996AD9B8C8FE8A1CEA9B25B5906AC6D19D87428A3A653EA0,128,128,0,1.0,PASS
19093095C65A1235B6F91CAC25E7CBA67B85D17DFF455B77FBB23527B887FB15,117,139,22,0.16913144470267139,PASS
CB74BC3339014F6F3A130E745F17EA5398F717CF4E906485F9041E90712B7829,129,127,2,0.9005235503397743,PASS
C8BF6F08E4C9B7E17909EA48F042AF16C01EF9E3E493414FC1964F6840DB2EC8,131,125,6,0.7076604666545525,PASS
457AC79930C1F4A29BABBEC28D7B7509918C5F0933A0F877121E910B30FE413A,132,124,8,0.6170750774519738,PASS
171B2199C9549955E2AC0134CCD1577BAA338959166A5FEC626A6B59FA0E6FCF,126,130,4,0.8025873486341526,PASS
AC9D5EF4A6633C44DF1A47DFBC65D9121F29114773923EACE9D4BCC8A2F3B280,124,132,8,0.6170750774519738,PASS
B30BAF77365B1F0DEE07F105F83C8378DB297DBA89C759D028C9E6549E5A094B,123,133,10,0.5319710580974012,PASS
B686592D4A51F0EF94490023A2E916B50FEC49534FAE8D9B2C8169F8B364657A,132,124,8,0.6170750774519738,PASS
65C2C7C32ABB6FE4E14D36D824DCA4EB0C2FE3471845653A845A9D813B62B9C0,132,124,8,0.6170750774519738,PASS
27356122C5E8DD39B6C551B5EDAF862B1E83FD6FA23FA1CFBC767F348DA3770E,114,142,28,0.08011831372763423,PASS
25506D2A9CEDF7F99E42DC3A36D696CAB50FB655C2FDF36F59BBA1AB43CDA012,117,139,22,0.16913144470267139,PASS
FE9A63477C47D2BAEE9D6D69DA02B8DC2796D34A4FD4445CFF72311E4AE38CB8,119,137,18,0.2605890342736178,PASS
E29A558EBCE2141C29DF6BD342690455C81DAF8426F367513127866F754AE864,132,124,8,0.6170750774519738,PASS
1D4B5DF4D7929A6DE8ECA58EE8BB75977910EAB8C623661E16F3B38B83FD19AC,118,138,20,0.2112995473337106,PASS
C0DFFF9C8A6CFA6969C8F2252779066041128DAC8FBCB8E4A1C866247DA096AC,132,124,8,0.6170750774519738,PASS
64DCA76FEB75B57BCCFEC235D44367AAE1204511587E32D5814981AB8EAD8796,125,131,6,0.7076604666545525,PASS
5E3999C0CA7851603EBF6247C3637BA1884F27DB514E23A6EC25D167DB250105,132,124,8,0.6170750774519738,PASS
CBDF4548C404B1E68581805124DA471E063BD2960CD012436B152D4F3F3BE9D2,140,116,24,0.13361440253771617,PASS
80E136E2C71ABF37C73382508918A07EA27ACC0F0C587A6F04943A4482F292D4,141,115,26,0.10416255883043901,PASS
D7BB7DC45CC00123F79449E251A2FEA5DAE8E2B4A25477E948BAC534AF3DB098,126,130,4,0.8025873486341526,PASS
AED3F0DF132624B9833D14221B251257919D957F20FFD51619C086E4863AFE13,131,125,6,0.7076604666545525,PASS
66E07B6E228C7CD109F1D1053EC124C033E0E6466DCE55A28187B46EE5181BB3,136,120,16,0.31731050786291404,PASS
4166AD735D9626C3514B9AAE9881E8F764F64F0D1E79C1ABAE270A8ED1F17BF,124,132,8,0.6170750774519738,PASS
9F6491198B56254B2020BF2F2E18918B6845C36C13CCDDF9098D045861BBF334,138,118,20,0.2112995473337106,PASS
A7CE3ABBC0049BE133DB808AA12D271771550174CE6E94094C9CB86FE8A659DD,132,124,8,0.6170750774519738,PASS
283F83A6FB99ACBAC58044F7550A786FBF3631E0901D6454A1B595921F67EE4B,127,129,2,0.9005235503397743,PASS
57A1E6C48E8F0491FF490C7302A968B68B998AEA49D124012DF29961CCEA0458,141,115,26,0.10416255883043901,PASS
518F3AA4F10662DCA3E7A1F0A4BEF424D9841B9329C41C66034823710A1F3639,139,117,22,0.16913144470267139,PASS
6B093EA077AE084346D8AA8FBE21F3340A673EFB497C04DF9EE527FF01CA6310,127,129,2,0.9005235503397743,PASS
2FEA35414FD5D1B54771A2BC04DD78A5668E78C9DA4834F70D8D7E673B082A58,127,129,2,0.9005235503397743,PASS
85627661F89BEFBC0C135FD4FDDEAADE278DF088835684E7A6839797674C52F6,119,137,18,0.2605890342736178,PASS
D5EF309E4F6E9CCDEFA9EE93AF36998F903421B37FCB652758401ADAAE31390,122,134,12,0.4532547047537365,PASS
E5C49FDEDE01A664A16D83C1D2C2FDD5D50CFB940FD6FA40304BDFD101ABB407,126,130,4,0.8025873486341526,PASS
C599CDB9CF0845734171DE1F4B7A20BA1DF34A69CBAF4C273BDC16AF8489B86B,123,133,10,0.5319710580974012,PASS
10CBB3400817115620D182DAE9E8AB689986503200261023E8BF4201A3E7DDBD,149,107,42,0.008664896726025117,FAIL
BA855360EEA8AC1277FD043623BADD45FC6B99E201123639F00358264B433074,137,119,18,0.2605890342736178,PASS
3301FA0651BECF9CABF830615E11C8F48034746170911562F157B45F106A181D,140,116,24,0.13361440253771617,PASS
EFA12F07EF2118A22E84120EDE89E094BCF7172275EBF844EDFFCCC53FD675D6,119,137,18,0.2605890342736178,PASS
706395B04C57F5EB4E0B385AB29504C3EB77B928A3CE1915F19AD1C059805A70,134,122,12,0.4532547047537365,PASS
2C9A227459E1F215D0D325C18F18591EB095A008AB098BFDDBD68EBE2BC3BADC,131,125,6,0.7076604666545525,PASS
CF24361E65BF4B31FBF071EC132B1F7B6CAB081104C5969700BD1EC0DE9C9AD8,128,128,0,1.0,PASS
C108798B76661D73458F9981A6462044216CA8459C2FBD65692DD2EF0BE645E7,134,122,12,0.4532547047537365,PASS
D065D316A4AA0DE24DE13E6CAAD1368978AB5F7C44D69730AA52BA46BC06F98B,129,127,2,0.9005235503397743,PASS
E42381EA13C6E7B98325002041012BDE2D9DD6F44E995BC0B40DB291072B6F0F,139,117,22,0.16913144470267139,PASS
B0E4AD46E2620E3FA457C0C9AC25E8B8100518AA45F21C5B0DC9B1C2B51B442B,142,114,28,0.08011831372763423,PASS
7936DFAFC83B0B473C21239CA38AA4A9E13A520545BBD96B6AF59EBA58C9146C,127,129,2,0.9005235503397743,PASS
58CA13E867197BE209EEECD2D5769005F93C3719721DEBD3AE988942E56B768D,124,132,8,0.6170750774519738,PASS
E1509FAA63DF60A8290D7CBE2851F78DF83D5B9499D2236130D37B2D18B8CD3B,126,130,4,0.8025873486341526,PASS
4DD65A8CAE251FC815E815E9E1A5C83976598CDEA5712BB77323404F2BAB3485,129,127,2,0.9005235503397743,PASS
86D6AD2DAF8DA3C685C2FCDC4F2BA33E20AF2BAE2834FF60D1DF6F801FE2F927,118,138,20,0.2112995473337106,PASS
3C3A2C01498A4998D574DCABDD74445A1F303204B945AC39C9ECFA87836FF6A5,132,124,8,0.6170750774519738,PASS
BAC8793BA82020450C875E6AAFF48A8B13C005FD7604DC696A8B2A2E85B3BD8E,135,121,14,0.38157390570502125,PASS
D9549A5729775DEA5B721E31E8E46332C2FC3D53EE2276BFED7296AF9EEDFE09,111,145,34,0.03358661289689768,PASS
9365253335521AD12F5D94613A6D79BD6651E183216256FD9C9561E7DDFAA55F,122,134,12,0.4532547047537365,PASS
3028A82E299A7CFAFFC4969D781F0276E692891745A9421305DBD63F04514C10,138,118,20,0.2112995473337106,PASS
A6105FDB0CF0EBD0609232C031A21B0BAB71CB7C4F4966C69977E1ACFF07D41B,129,127,2,0.9005235503397743,PASS
2F7E04D9F25F09F2332E1C1730BD78C28E33DB5690347D34E67B980190DB8ADC,128,128,0,1.0,PASS
D8A1526E7F5CB9F30B15E94AFDC543463B6535D77BD5F83BD23543207153D213,121,135,14,0.38157390570502125,PASS
A7947D9F25C0C131C04B931B01F169D0DA8B2D4B7B1D2E32DAE5DB33E512339,131,125,6,0.7076604666545525,PASS
62CC64E693E011F498219DBC78ED91CAC7DACF5C5058C6B7C5BEE2DA933ED535,123,133,10,0.5319710580974012,PASS
53CD88CAD044B8143B42D4E1D3DAC348C6DF2806A7B02430B443F66D912D9A,143,113,30,0.060792723530522785,PASS
45706D840CF30165F2C9119CF123CEDE08B58DB311E28F7FBF406160C2881980,141,115,26,0.10416255883043901,PASS
B0E4C5170630F9A1C5284C79D8F6EB3ACEF813D360008581CE44D54256F76737,134,122,12,0.4532547047537365,PASS
6EFCFA433E997ED6826F1625D9AAEC4916F854808419181377214F698B7A3D0,132,124,8,0.6170750774519738,PASS
22718247BEBDFB957A05D14D31924F49CF531F7190340BD212B635AB9150D160,134,122,12,0.4532547047537365,PASS
A95B9B5AF003533974C72721886C6999E795803D72EDB26C39C69703F320FC9D,128,128,0,1.0,PASS
C2CF1D00DBA8C7A07F17EF72803052CB691E7974795F74589C3744443F44C93C,130,126,4,0.8025873486341526,PASS
5C0226FB582470C99311AFA9CC6CD477E90CF06C9674CE9654FFC88C115CC934,133,123,10,0.5319710580974012,PASS
3896E43DE87455A800F018B4F9318E4BABE1699C0E244E97307F007B8A82E70E,138,118,20,0.2112995473337106,PASS
1942F0C17C885FA5B5BE6E86A540A2EDC63C8C42797FFAF2D8499E623B62E0C8,129,127,2,0.9005235503397743,PASS
64774482414CE7ADEF7C85E0DFA7B4FD6DA5860B557BE8D9D603EAE5172CBDC3,118,138,20,0.2112995473337106,PASS
9578EF6795FD2C98D90CFF40827356D0327A669D2C6ADE8A88C6F61C915BD97A,123,133,10,0.5319710580974012,PASS
9E63CF95101355430B6EEC31A7A5AA520D0173420860065AC1C6003A356B4672,147,109,38,0.01754895019147673,PASS
41FEABB5C59BD6E239BA1B722124353B4719556441747640CC15F1C9569CE48B,131,125,6,0.7076604666545525,PASS
718976CC6ECA82BC199B61B470C2F014D92CECE788215E8FAA554310FD4F1FD1,131,125,6,0.7076604666545525,PASS
C1541F99961A59C6184C910987FD1948B5BF62F3EBA4D447710D7F04558F7290,132,124,8,0.6170750774519738,PASS
6410C7F7F751FEE386428C271225CA64836B8C7A22A3797512FB69748AF8A751,129,127,2,0.9005235503397743,PASS
22E2FE8F548213FF5C2937D067895D1FC0B1F639FD820675AE0C321D102AD118,133,123,10,0.5319710580974012,PASS
389DD21224B9DA72F577951DCCC23D8AEB6EDE04350E5AF0FAC68D0BCBE0E6E9,123,133,10,0.5319710580974012,PASS
472C063B3074982B8EF38494C29EAF072AB9704A7C5D9217A8771F8728890703,138,118,20,0.2112995473337106,PASS
F786496387ECF441B97E25CDFD5FB1BD7B62A4129633DD117CA41CCA2025B6B8,123,133,10,0.5319710580974012,PASS
FB17BA85E9203AAE43016FA8613B6DB3D47FE967CDBBA6F25C9DFAC16F0FBCC8,114,142,28,0.08011831372763423,PASS
C43A6DF3AC5113BCD61864A90950F88CBD91D539320005A94EB27EA7F2FA2CC0,135,121,14,0.38157390570502125,PASS
A8534A86F73D43BE40B59B0739A89D33EA640FF423B2FF2D1CEE1597F692E313,122,134,12,0.4532547047537365,PASS
25C25B414598F78174182443A14BEABCBE42491431C7FC31ECBA3ABA26BB249,138,118,20,0.2112995473337106,PASS
E7D157042E9D9E44094B919AD276397EE48EC625778220E5C123E08699CD8A89,136,120,16,0.31731050786291404,PASS
A87623C503CC8C2F4598019F0ED2A98162C6185D5B7DA304984E086B8A8EAF6,143,113,30,0.060792723530522785,PASS
8C97FED57C0ABCB3D06A64B67BC61F03690EBDAEE284A8316E8938F4B2769822,127,129,2,0.9005235503397743,PASS
4C4E32253C3E21547029219D4EA6715B31E66ADA9FEEE7BCB1DB4E8F1C30799E,125,131,6,0.7076604666545525,PASS
C0FA3343FC95D0B8E4DADFDAAE3BEA41AD38749ED12306B052DB4353C6556935,125,131,6,0.7076604666545525,PASS
643BD84EAF9846FD7D5FA359F5B03C404E582ED3A10570D1F8E87AFBD712A68C,123,133,10,0.5319710580974012,PASS
6805C945F35CE5C916553CD4D4F721D88D4FCCB3D68C1FC52CEF695198116151,130,126,4,0.8025873486341526,PASS
D34A88068509113919EFAE65D36CEB78A1A5F1D6FDE390A15A231FFC6E79A427,126,130,4,0.8025873486341526,PASS
A6570BDFE6496E52461A85483095759F8AED94BBB03E57331EAC893D6362644B,128,128,0,1.0,PASS
3301E7EDC9D79D9D1D1D3360F2D7CEA454D8B54513995796683F9EB48B828468,126,130,4,0.8025873486341526,PASS
F3C944A60D4D6C2480328A92D06728A94B6774DA9E7E2D472CC2D4F55DA2C826,136,120,16,0.31731050786291404,PASS
DFEBD7CC0C43FF515F6ED9CB07324816CC0D981F12D690BC6C34F4B0176092A8,129,127,2,0.9005235503397743,PASS
B95A01EE4210B47CBFBE8C71BB0C1BD4CB0F1663D6653294BC744FC32CFBDD59,123,133,10,0.5319710580974012,PASS
30FB2881B7E9049C08217C8EFC07D3B27CDFB856C60FE392FC5DD2822E725919,129,127,2,0.9005235503397743,PASS
EED42157913567EAD029B1D6E43BDB8132098B85DFA4A2B52E354D4AECF878A8,128,128,0,1.0,PASS
8B693D1F22D2A8B66D68F7B7D63B3DCAA530421A0B1ADB5D0DD3F8F0D268FB29,122,134,12,0.4532547047537365,PASS
31F79F79A32882EBE83504DFBB658193B8F80D19D90A994D23C14F2D616BD792,127,129,2,0.9005235503397743,PASS
55CBA1F421F2353D6B5FE3B3C564DE40583B2BCF0FE755584AF1FE23FE52E9D9,115,141,26,0.10416255883043901,PASS
88A366FF685A57579B75093B45B27F18D245B03B5B0DFA93027182209D3EAA40,132,124,8,0.6170750774519738,PASS
FDD490423986F7398531802F94E4992B7AD79CF7B7F613A5FF436F3CC452BE4C,119,137,18,0.2605890342736178,PASS
2350D56AE7E4D69D9BE010D5A148309A7908CAA3428BDB3AF4B9F372BAEE32E4,129,127,2,0.9005235503397743,PASS
755D1BD2AB1B599A88AD46A0699918C4438EB7D80688703CF5F39F3F04A6BEF8,128,128,0,1.0,PASS
DDDC84F4BA234F36EEF67B14980AE32150071565A37BF1CC3393B7EDCE06DF90,122,134,12,0.4532547047537365,PASS
50DD060A34E31DAAB2140DCC59F340B93A4D61A0D7FA57C4C7D5B48F923E61E9,131,125,6,0.7076604666545525,PASS
EEE036AEE3267564F8E9E3C0248D1764E2AF8D0633D2DDF36013BE08D99BBBA7,123,133,10,0.5319710580974012,PASS
C834009422F9DF8F8769B2A5913A389B8962B17B30A365C96F4EE67FB45BBEF8,124,132,8,0.6170750774519738,PASS
C58DE8B92BC009A9790974D2B4EBCD1028173E8319333B49C3A35BBF61888DC6,134,122,12,0.4532547047537365,PASS
CE0CA78CC0A78B0371E6F603899AE5369F173C022BF80CBB344FEA7CFE5D7DD8,123,133,10,0.5319710580974012,PASS
AD65F16552AF3CAED45DD75DB987F79F4C2A480FD54850AEFEFCC29EDA474FB8,113,143,30,0.060792723530522785,PASS
F66115A233AB43AF94EAE345406B2DEB86C83F6532CBD745A7F5589BFFFF770C,115,141,26,0.10416255883043901,PASS
17E1A4163B40F0B8E74E726F1B9F02833EA69CCC55615A1854B885DBACF35D7B,127,129,2,0.9005235503397743,PASS
757E4D23DEC623B2ECF796775EE5FF2D1D53C357A74BD16EF55DA793CBAF11E8,105,151,46,0.0040402749798920095,FAIL
A54ADCFBC445C478DE3E43BEB356DD674E71E42209D07150EA313A5A2062473C,131,125,6,0.7076604666545525,PASS
32B0549CAFF8E9BC8FBC41B30E5DF5C3742A20C6839CDD8B39D7C16F21485B79,125,131,6,0.7076604666545525,PASS
564E2DD6C4C88576985978F8AEDF343864D09D502BA5A344872F67FD159B4FA3,126,130,4,0.8025873486341526,PASS
BADEB003BE1C597FED3345B960D2262A78B0714B17EAC30317B5F1A8536651DB,126,130,4,0.8025873486341526,PASS
17048972F6D85A9FF41463716D75368EF4B66ABE9EA14020014570F30D22C830,138,118,20,0.2112995473337106,PASS
5C42EDA74638D7EDC4DE24CD4BD704D10743AED2659F8719DBC8E9C5635E6A79,122,134,12,0.4532547047537365,PASS
1353D54AB0CF47FE1B30A94C78FD3FC35756A667A52FC0D93E74FC5840A90ACC,124,132,8,0.6170750774519738,PASS
,256,0,256,1.2777508801076536e-57,FAIL
,256,0,256,1.2777508801076536e-57,FAIL
,256,0,256,1.2777508801076536e-57,FAIL
F54D701C445FF7AEEB193AB960181C8D2AB38D4C0EF8D26AE669777ECCDE3105,124,132,8,0.6170750774519738,PASS
E1C747A5F35A392D4B215D142F4B384D098C8462EE9B84A66BA94E5AC614F4FE,130,126,4,0.8025873486341526,PASS
25243D5AC099C67A876E0C776EEFDE255435D7A6235A6FD9023359DB68A1AED6,123,133,10,0.5319710580974012,PASS
F47362FBD0649FC9A0213DC166BF2F7727B48BDB9F6AD3729C898BC331856600,124,132,8,0.6170750774519738,PASS
ECD7A9B5829F82BE10FA40780E1C7163ED50D6490446377059A44CC854F789A4,137,119,18,0.2605890342736178,PASS
5013A1082BB539536DB247210EB295CB2EB28F70FBB82203E34F0D64C0F8C6D,138,118,20,0.2112995473337106,PASS
1D42DDCF939BE5962A4E70019F109E1C508F3D3E37E2251EF46106485C7803C8,136,120,16,0.31731050786291404,PASS
A62CE9B4FE93922A286EA04C031D9A17C7AD8662FCDDB53F8E462C59C476011C,132,124,8,0.6170750774519738,PASS
4DC4117DBC07D8519F98E5361D7FDE261D0FC163A4D0D842A8F8D68799ABEC18,128,128,0,1.0,PASS
E0D032A0188CE397D19BCF78C122E083641B46B912EBF2415A617FD668CE8E37,134,122,12,0.4532547047537365,PASS
DBABE375C0F24D4164930BFAD5E4A21E68D44D5D2A80EF9805927C5369FBF4F,126,130,4,0.8025873486341526,PASS
A8918D609F9C677ADD1490CD66C699AB7C9040D3B3464A313CB9D37DF7A87F40,127,129,2,0.9005235503397743,PASS
A6BE954BC65CC583A56E7896246ED3BA6F452470F763E5CB6688E484E1608852,131,125,6,0.7076604666545525,PASS
21AB0F311E4E7E587014E51A01D4E90834B3DB09C3991A593E61176FB98DF649,134,122,12,0.4532547047537365,PASS
EDC9C6769A7933FEA4D2C452E933B105560EF460B7E1E71D975D576C4D1B2A8,124,132,8,0.6170750774519738,PASS
AB39BE1EE1C0E654ADE33DD9BDF2C9A73BB10893E09A1A26A62B96E7D5C56CE2,121,135,14,0.38157390570502125,PASS
168236D1CC5AA7F5A290F76726D5A3B79531DE144BE429105EB5E386E2738865,129,127,2,0.9005235503397743,PASS
B5019431C556A7B51B57E69CCA129C7D19413E29DD1B07E14295AEDED7CE4F3D,124,132,8,0.6170750774519738,PASS
CA81B6159D1646551626BE36D27AEB185B44A3230B9684FB398E5F4152C639C5,133,123,10,0.5319710580974012,PASS
86BD7DDA78B1B8EF3FB5182ED2E5D049E167DB01119C96DB2D9C3B0E05BCE9D8,121,135,14,0.38157390570502125,PASS
5B90149707105C1C379E8E6173837A3FAC7918BE3EEE49D76B08237FDBAD6236,124,132,8,0.6170750774519738,PASS
205044AA3E4E05A4AC6B33BB4DD3F210F7F73C4CC9BE71F9B82712C6BDDA97BB,122,134,12,0.4532547047537365,PASS
A5CD09AE72ACA32E17212E911C800D67EE22DD7FD15DEA1BDC47AF7F0E52CC2F,123,133,10,0.5319710580974012,PASS
90820897612607DCACE55F85AE2C64D00F954CE59F3F74841001D8D53DF84764,138,118,20,0.2112995473337106,PASS
463AFC6E1ECA4913DEB742DBBA0BAC1F3DCB28C22B699465C90173E68B108E16,130,126,4,0.8025873486341526,PASS
F46C05F10A42B1E1E40EB2DE802F4DB49F67FFEBB471E61721A27DE2B38D20A9,126,130,4,0.8025873486341526,PASS
ECE4D7762582C185FBFCBE021B8D26950C3AA963971322368C45AE48754A4845,136,120,16,0.31731050786291404,PASS
24FBD1BC40B33BBBBA267D289BA647B291BDA132E36AB6CC901F7495DF2F9C9E,119,137,18,0.2605890342736178,PASS
357599E132583BDD22E84908709E7BF51752833A5DB3454E1D55102E2CD93CBB,130,126,4,0.8025873486341526,PASS
BC8AF25710C697449C86D85397259153B53F325CD71C00BFD7324C2D18E5BC2C,131,125,6,0.7076604666545525,PASS
5977BE3DE1C5588E39D898F1E12DA89A80658493BEC5454B910388A027E1B018,139,117,22,0.16913144470267139,PASS
662A728517E2AD3BFB314A37E04F7729B773CCA4E2877FAAC855FE556197C7A9,117,139,22,0.16913144470267139,PASS
890869125DF3140124CF953487BFA123EBF62303234E6CF87F969A1FF6AC992E,129,127,2,0.9005235503397743,PASS
BCD970A4BD27989A485CE68225D288CC0734E5CD0EA47A4D7177C8067359BCB9,132,124,8,0.6170750774519738,PASS
77D8441C330772137F1B31C672316E40FBAF789209E3E5E2F81A895B3E5B0419,130,126,4,0.8025873486341526,PASS
CF762D4DFF121CF5F1BD5CC3CF4726407312D1CD096EFFEB97814FC50B06DC3C,118,138,20,0.2112995473337106,PASS
B36448209D42B96557E677560CDAAE8A08EDC687F2500777BC84D03F9C3A6195,132,124,8,0.6170750774519738,PASS
3631BBC47C885A0B19E1C228D322F2059BDEC9914C497519D8FCC5A23B0E11F6,135,121,14,0.38157390570502125,PASS
F8A53BB8BC9BAB22DA08562EDD0283BAA886BC703B217D6ACD75AA5685D04D6A,129,127,2,0.9005235503397743,PASS
88463F52CDDE38EACEF5147791C6F09481849428EC122B58B8C3A648A3ABEADD,133,123,10,0.5319710580974012,PASS
B1D62388F045B40CF062F522A1C2A8F21346530C459996CFEEBFE2CEA2C3D23B,133,123,10,0.5319710580974012,PASS
B0282DBB24981F6C067EFF385EA881871E82D31AFE3060148A4C1D7587113D08,140,116,24,0.13361440253771617,PASS
6895B88CA574D07E2B2DC591F85FD1A5EE3941272306FCD68E17620C3553F66B,127,129,2,0.9005235503397743,PASS
C8F2FD771C4F3E1251BAD84C234B82DD40CC4CE2ACBC86BCA41D768A5A2E1F9,131,125,6,0.7076604666545525,PASS
71D49017B9B8FBD5E0BB66C349F3B76087432108434A7C53037322BC3A897826,134,122,12,0.4532547047537365,PASS
520AE886F5196CC571D26B16EF987425BC4E8EC4B37F94B62522B1FE3B7C6D8D,123,133,10,0.5319710580974012,PASS
1A74624FDA544435772E0666990F8F17C0F09C68E05DC9BBF01527CD32CD1BBC,130,126,4,0.8025873486341526,PASS
A61287B639CB99246C2FD179FF1E15CC84F25E3EB6FB071D6DBF4FE995210C6A,119,137,18,0.2605890342736178,PASS
E27D0975BB7662154564460E45A1F7E23426767E9BF2D554194B66DF7431B51A,125,131,6,0.7076604666545525,PASS
CBB94BC8822D24C76AA4A49FF17119F9193D565F4BAEDA495CFBFAAEA1A930BC,121,135,14,0.38157390570502125,PASS
19632282DB187E52E1F3ADFBF73396770529EE4062C2AC142A49DEBC0E760FCE,127,129,2,0.9005235503397743,PASS
507D71D951D38D1961E1B446CF7DCAE3495195780529E2395BC943D94E5229EB,129,127,2,0.9005235503397743,PASS
AB4CA46DB35197494A074C7B571E176A9F479BDD4FC1A3B1BBF0F3B79C2BAACB,116,140,24,0.13361440253771617,PASS
4A60CF510CDD01A76CD21B61E58806BDF11AD04AC12E02BB18394027A9E180FD,143,113,30,0.060792723530522785,PASS
16F51A763D66046E00E6D657A388438DD0CB8BC2819A5CC0D728E4077CA2A59,140,116,24,0.13361440253771617,PASS
2416A550BA6CE772A0108D632E7ECE786612EE79BE44D5324176A25C18C7899F,133,123,10,0.5319710580974012,PASS
4EAD58ED0D286D9C46221DA4F0C2ED8B3DD76D0769CAA7F63326C4D0E0683727,129,127,2,0.9005235503397743,PASS
172C1178896CAFAE12770E645DBCFF6C92A32B93BFDB2783E93F3C0CA4E1156D,122,134,12,0.4532547047537365,PASS
6B9FA46818864428ACDE472F7E40C50BB7E6FED528AD5FBD89D14808117723CC,130,126,4,0.8025873486341526,PASS
8F1A55B6373763D0619A980531F2112AA97E5DDD3A9077255A90B11BFFF09F3D,124,132,8,0.6170750774519738,PASS
5DECFF7FD17E9AD6E32A31699BBEE849A7060D0D51CCB512F9D84377CA604437,120,136,16,0.31731050786291404,PASS
D0E07C1D304C99C96FAB6CF125A3BBDBBEB96C358BB1EECE83DBCF0A60B08DAF,119,137,18,0.2605890342736178,PASS
57BEDE0CCF300EA7426EE15355E0CEF60BA8353F1B47BB8028C44A577275E90E,127,129,2,0.9005235503397743,PASS
AD147937DA661F366DF749D5E339260B2D2B694328F7E0318C92B8BBD84B950A,126,130,4,0.8025873486341526,PASS
22417CB38903091B86C2A97D62F359BEF2ABF9449AADFBCF7A5DEB5E5D44F6DD,116,140,24,0.13361440253771617,PASS
6984A693DCFD8A62104FD489C7C9756047665890AD237E68A47C3526F845E476,133,123,10,0.5319710580974012,PASS
A8ADE8F9B36DA2693E162641DE50CE7A7FB8CB26C8649BB70254B35ED8283657,125,131,6,0.7076604666545525,PASS
989210040EDF0C9936FB776C46996A9F871A5DFEAAA911C287D6A42D768DE702,130,126,4,0.8025873486341526,PASS
4C33885AC0A55F00ADC2E22D6BC3751486002DD48DF8ACFDA18DD7C5FF8DC06,135,121,14,0.38157390570502125,PASS
F42159E1EFBC03D7A8088B9F05B71A895E66908BBF0634A4ED8F02F26338FE32,129,127,2,0.9005235503397743,PASS
E6594D13925BEA4CBA9ACA402F41AEB9B58B4657F4C3C9D42EFDA2BE39F74358,122,134,12,0.4532547047537365,PASS
5AF7AAFFF93ED57864EBCBA3998C64DF0EB9518CB4C384EE2F0F80F835CE6CBB,114,142,28,0.08011831372763423,PASS
77A20D0F7C8FFB5C6BA838A6D85CA9A20DF0FDFDA62839EE719917DF4289FD47,117,139,22,0.16913144470267139,PASS
C73AE411546E4E2FD98E946F084894511B1D341448FDEE131B2C2C5F4DEB973,133,123,10,0.5319710580974012,PASS
6F344CB5822031E9CA31F1D887B52993D1D856CCEEABEE53DB252C99456F65EF,123,133,10,0.5319710580974012,PASS
2D9C011646FF8E19AC4AD5D7F9C1854B666FDE7E9730DA87402F36FFCE60611C,123,133,10,0.5319710580974012,PASS
C1E44EC6BBE4000C7DE5A7E902098FEE782B4A55EB7859A337FFD70AC1F9DB26,122,134,12,0.4532547047537365,PASS
DD3ECEE521D7C2F6CD8A3F2DC23DE07DC567379BBDF601B6726A511C199DED42,116,140,24,0.13361440253771617,PASS
5C1C1569473BC33C4587490BDB151B7258E57252CEA83F36FA616B3F30595130,131,125,6,0.7076604666545525,PASS
252EB3DD363392BC3379B3C8685E972148E3A42D5EAA0FB3F75AC1976166DD84,124,132,8,0.6170750774519738,PASS
6696C1C208CA797A3DBBFC6C0C1DEF89F52C3BB60BBA00795D287822393B1A31,130,126,4,0.8025873486341526,PASS
131D0181DF089650CE58A31BDE9C91D04FCAC2719334C8305AE034BE2FB1A36E,138,118,20,0.2112995473337106,PASS
835450569C547DDF9F9B6FAEA3273FB4A290E018B96EAF6EECAD883A8E1E136F,120,136,16,0.31731050786291404,PASS
682E1D1A4D2C174B55E4C019374FF4CF90E02FEC7787B97914D013D36DF192D1,128,128,0,1.0,PASS
F66D4E1D7D566EDAB24186F382DD5327AD11936D4EA85D2399C1CEF7182C4FB1,122,134,12,0.4532547047537365,PASS
F85FA42BC4405F8C555AA74952DE66D2FD3F1077B11CDD989953BFE51B10A5FA,121,135,14,0.38157390570502125,PASS
2D527D307EB13109FD67FB2FC55EC4E884CF4C17B1CCFA45872D00627E68F899,125,131,6,0.7076604666545525,PASS
A0FD4D947F6631C32249992C9D69919734DE33955B9B8C5DAB2326408B762C44,132,124,8,0.6170750774519738,PASS
C35B44A0C0A897C506C9AD9CE463F16357078354B839F60A5C565229385D1BC8,138,118,20,0.2112995473337106,PASS
E93FE2CAF0134C558E6D4A6E71804D4F0BAD5D49EEEA12A5B9CD6F64F4F6B328,122,134,12,0.4532547047537365,PASS
F2DA9FB1BD8054AC5D54F47D17AAD6E189BAA24BA95425DDDDD71CDAEE261D94,119,137,18,0.2605890342736178,PASS
72C96FCD66ADD22023DEE2F3F6355BD1A3ED8820951C5305C5C3A5F52B3A64A4,127,129,2,0.9005235503397743,PASS
7B5B3E6FB762125D485034B17B17F72DFFC8C6921084EA66DCB4CC792398FC34,123,133,10,0.5319710580974012,PASS
D0FDD04E2E8CE1186AD2F4EC82E37AD89C0A6A6AE3C2593656E5DAFC0F570E2E,126,130,4,0.8025873486341526,PASS
4F85AF32CF6ACFD962C04C5EF456E9299FCAD095124A8137CC470A26D0752FAB,128,128,0,1.0,PASS
89E0DACCC74D1278FAB33D35DF59E97631688206096FB32DDEC734E3A1BBFED,120,136,16,0.31731050786291404,PASS
D17AEC27AD6A0F9C12844474EAA7A365B7DE08B6E93CDA330A65D07DEDF32C50,125,131,6,0.7076604666545525,PASS
36B4DC3D9B481AE791093A955C0C32D971F8546906D2326FF7C12573031869AE,133,123,10,0.5319710580974012,PASS
C6BB048F72B4851597944509CC8C9830EFF8A9157BC4CB7CFA8612CFB3CF9D43,127,129,2,0.9005235503397743,PASS
BF06804A7019972B0FF48701B06F68E027E8A0AD804903794316FDFD3776E868,136,120,16,0.31731050786291404,PASS
E6ABB88DB8BF87573BADB78C2585B4E6C2FBB3CECA46149A3C7FA048C3D7E7CB,115,141,26,0.10416255883043901,PASS
B101CB4B6640E3F31EA156297B4B6ACC84AB59F6BC91403A11246C79D0004BBE,138,118,20,0.2112995473337106,PASS
83BFA041E4D5CC9090E551ACDEBF12737FA9B16BF45A22A6D72DA811A2BCFA39,125,131,6,0.7076604666545525,PASS
61AAC094D1C45EB88E58D86F2D4EBDE8B5BB3DE51AD47EC654EA685FABD2E576,119,137,18,0.2605890342736178,PASS
F7A54C4A4721BDAAA8442D5A73D69B8EBD05188A8813A7E7EE85F86249E91C51,131,125,6,0.7076604666545525,PASS
9BABDBD1B261570B1DA6A403C4429748AC0DB3E4F031CC1E692F3C5016186A54,138,118,20,0.2112995473337106,PASS
A34AF9140C0C85E9E4B3BB795123E9DDE1D0D3B6A2B104EF64E55866C73D3950,129,127,2,0.9005235503397743,PASS
E3F1FA7DEBEEF82A66E383401F308296CB24BD329CB0248E5A6D1D137AA9A495,127,129,2,0.9005235503397743,PASS
1D58D461D0F44F45E900EC6181264266D51F752A05D66B4ADF26EB38BBE4972F,130,126,4,0.8025873486341526,PASS
7374AD9A87B5AE197FA40F018162C87D992B7F1B262D326E9AC5CCDF494EDB98,123,133,10,0.5319710580974012,PASS
BF4CA55643C2D8E971AC8DDFE36D9F65451C374E8002A0E176655158B763BF66,125,131,6,0.7076604666545525,PASS
B4BF7352414732EFC33D3D1398E9288121C26C11AA8A4874BB9928FA9C31CD9B,133,123,10,0.5319710580974012,PASS
AFBD26AFE4F78DBB53CA58B6706DB68D4436C1181C8FF940B588526E2A8617DE,124,132,8,0.6170750774519738,PASS
C6A65310954476AE97C363B1B572BEF16745704211FB3986B60543622BBA8DDF,128,128,0,1.0,PASS
EF746D67D605A49317D57B2CE1A31327B8D920F67ACDF6929D20073A4B1FF1EF,119,137,18,0.2605890342736178,PASS
F0FAD5501851259301B48841727F5F0B34F1C6AE7A3A7BC16D9A8ED6C82E7E11,130,126,4,0.8025873486341526,PASS
8D0C3B73BCB545F82AE1376A2FD7D934B4A0E83477A04D71D2F82B28A1CAEF97,124,132,8,0.6170750774519738,PASS
BB543800D7F7E8E3B04C5B510E2A62CFEB69BBA09F309C2CA3D03B1D99023BB8,130,126,4,0.8025873486341526,PASS
7B96A27E7954C4789997B293A53111675622AF2E7B0E5AC195325AC36A4FD4D5,126,130,4,0.8025873486341526,PASS
D863C45A763FD3A2EE07B821CE9892A80E56CEA70F838C5EB28BD7D393F6AC5B,123,133,10,0.5319710580974012,PASS
D83086B4854BBB796A26F0143BFEF19D28412BD905324927F2989FEB3068218B,134,122,12,0.4532547047537365,PASS
F1AB2CE2BC57DFD2DF62C894AFBDCC161161489EB558F25B6C3F4759F828BEF2,117,139,22,0.16913144470267139,PASS
5C76C60585E2CB37E66F9166CED02FE887BD6BD1A23FCC240A58CB39090A41A4,132,124,8,0.6170750774519738,PASS
A8F0B96B0105834164C1E4F0961570259AF565F22DB1CFE95BDC065FD3FA1A5F,128,128,0,1.0,PASS
5F9791A75E2714015E10F1E08B06A3B3E8AF0A0776F92F508FABBD4523232CE1,131,125,6,0.7076604666545525,PASS
83F8BE98A5D40BFE62120B8C689DF97F60917C4F4ACE8DCA24D6AD63CF28563A,126,130,4,0.8025873486341526,PASS
108EAC12A034D882B44CDDC4875B2B3C928ACBCC1DCE4E4078BDC643A0A4C1AD,142,114,28,0.08011831372763423,PASS
FDC989CFE1396CFD32A6ABDF9CCE232858A4AB1596EB2EB1F0260D0F7544D16D,122,134,12,0.4532547047537365,PASS
D29E3D3E823F01ED5A50CAFFB2A5D332A6BC59ADBFABBCBBB12F4FE4A3396F1,114,142,28,0.08011831372763423,PASS
D2716F47E68C5C0BF50E894DD30056E0F978BD9D50828B81B2E99E9DAB7108B8,131,125,6,0.7076604666545525,PASS
68C5161DE533F379CAC27564A2D9D63B9630A0D69A8A1D56BD9954DF500036F7,128,128,0,1.0,PASS
A3E8AC735A44F7774EF159F2C03CBB97010A2795D01CEC5A40BADF14A029EDBE,127,129,2,0.9005235503397743,PASS
C12D7BC70B050EC55B1B197C81CF9EC68CDB6CFDBD6A3F7FA283E3CED57B6369,114,142,28,0.08011831372763423,PASS
5E2B922E4E027636A30534CCE2BFD0EC61EFF8C34A79F2F3BDE81470F93C4C3C,124,132,8,0.6170750774519738,PASS
BAFEF1D2A7A3CF8540B44C3DB11DB70FD4B15D7FA01939FC535ABD54FDB594C4,116,140,24,0.13361440253771617,PASS
5D45637A2ECF4BE3ABDD39D3562117ADA4E83371C715239E08E67D9E01B20491,128,128,0,1.0,PASS
9D9A4DCDE08237EAA1945E594E0F097A43C13A386F75583BF4CE0395179F6FB8,125,131,6,0.7076604666545525,PASS
8B22AD327A9E52D415D3375B52573DE055AEBC41F5A785552D7DFFCF942D5424,121,135,14,0.38157390570502125,PASS
E8B1666B47669B076ABB79791C328E224374369D503D0F31A5A70A9CCBC9E493,129,127,2,0.9005235503397743,PASS
C3A125C72A7D41890B55FEB85F79677C026F7C6E86F0199AD99B1FA68E678AFB,119,137,18,0.2605890342736178,PASS
41B54670195C8F788B36392688B5C18EA36D6390152EDFBF32C6C618FF46497A,130,126,4,0.8025873486341526,PASS
4F27067BE1148F7ABB043FE487B209E9480C3B49221849D253F7D3C0D42A0319,138,118,20,0.2112995473337106,PASS
9AFBA1B3FA47FF1630BAE77218AF353B5731A1BDD37E4DD2485BBCB1649649CE,115,141,26,0.10416255883043901,PASS
C19FA140D8DBDF4309D68137526EC42C70F19E60BA3E64F726D15421730AF6C2,132,124,8,0.6170750774519738,PASS
DCF312E44E54B94CD7820E4E78A256C33D6CE8A4E0FEC1230EC05A00AE6CD47B,134,122,12,0.4532547047537365,PASS
9F02C3E1C6E74A2A3628150122F9B9122506801B447586C84BD47C2217EACA62,146,110,36,0.024448945310089426,PASS
CBB0295AFB5DC0B90AF3C4EE434AC8BD5212215E013E11447F3E9E831F552C0C,134,122,12,0.4532547047537365,PASS
713C950096C4A3FB36035DFFD1373CAFC6FECFF699D1F83730AE3B1D4DCD9292,116,140,24,0.13361440253771617,PASS
F67F4FA06D7C00075F60D3CE618007019EE1394F6C9596D8A24C68EEE0E62576,132,124,8,0.6170750774519738,PASS
A2E6F2F8CDED068236388C73E8A7A052F1595096B9013C5FDED12FF83D44B827,128,128,0,1.0,PASS
1EC7E62CD66B417B1FB904FBCBD45ED58295A6670938456EDCA41D56992614AE,126,130,4,0.8025873486341526,PASS
6432C25EB8E751415B26B53031388CAE68EA3C48BE61F0236560D695AC9A6184,140,116,24,0.13361440253771617,PASS
4B13F77140970D4BD2385FD790324D395F1D9D87FFADF685C84DA9466B413433,124,132,8,0.6170750774519738,PASS
FDED731640BF5AB3CF73F68E5796BAAB0C808AB1A6FAF87131A9A3D306FB8117,118,138,20,0.2112995473337106,PASS
C3E55853B92762530DA4EDE766D4DF316A05DDB778DD79B9365DF7FBEDA88D85,111,145,34,0.03358661289689768,PASS
64E72B0C89F351B5128BFD460EDD6ECC9F075095F9FA1EE72151E92AEB0B6846,125,131,6,0.7076604666545525,PASS
633268FA379BE26C6CC8B14C4514CDA8C9CDEFD9390318EF5CF6D1DB423CC7CC,124,132,8,0.6170750774519738,PASS
3E1376BBEFCC9B08DFFEAD6DAA83F987B954164A38D42FD5EA45CD95AFE66319,113,143,30,0.060792723530522785,PASS
18D32E211C7A7ED2248F73A355E4CA30465B195BCCD9BCE80B4457C82989BD6E,131,125,6,0.7076604666545525,PASS
BE3A9C13AF322616A8D4145BAED27809ADE02263BFE6D54663B7C33171CE7602,129,127,2,0.9005235503397743,PASS
B0FD851AA3CC0C0D95FCA38132B734BED313672FF70903DA2B53B189DB29F5D8,125,131,6,0.7076604666545525,PASS
57A00DB94EEED63E312A50FCAE7AA15F3A692470C42145C389631B255CE723D3,131,125,6,0.7076604666545525,PASS
DCE841510D80E8C75DDE33EC6AB0205713B468A80CA7F0AD39F97049A5E3D73D,131,125,6,0.7076604666545525,PASS
6DCA909C8CFA438D6B76B020722591F6F3CA6453E07C09773938B31486448524,138,118,20,0.2112995473337106,PASS
D6CC375DEE150AE0A708CD852BF950C5280B75121605CEFBA788014D7237F2F3,132,124,8,0.6170750774519738,PASS
D025A0D522A9A3328DF4ED6166E1997A3D326D4B8FADA5537E5037908BDECBB8,126,130,4,0.8025873486341526,PASS
AFAD89168391F1CBFDC8B09E02CE0BF3023BB8FAF734701E468C3F118718648A,131,125,6,0.7076604666545525,PASS
1D1BB34FABEDCB29A090E99634B265F39EC6CA27E8272B5B6A3814D98B0365EF,124,132,8,0.6170750774519738,PASS
68C571BFB337DBE994F8A24BE1357DD66C5DE8D5250C174D8C8D8FE30E03973E,120,136,16,0.31731050786291404,PASS
F800D26D00ED95483ACEF8B18A43D034B818C5D21AD268D7B870E2F79D1CB271,136,120,16,0.31731050786291404,PASS
8DF348BC2365A0EE6EBC3508EA83D88D66F9A58F0473D054E86CD214C80002AC,140,116,24,0.13361440253771617,PASS
4C93EFE034B2B4E59CBFFD1D10128A8D38FB097BE7238AB7565FFCA36773ED7D,113,143,30,0.060792723530522785,PASS
D639392AD5D787328BC57A68E9A4ADB6E3E601AB70BCC3ECD025FD1812F029FB,124,132,8,0.6170750774519738,PASS
74FC183BEBF8D5B0C1A8339C0E60D71A411AFC95FDB824187EE3FF5D34635266,124,132,8,0.6170750774519738,PASS
91E04B06D368B7033285B9E9190A8D79E31CF6CA3AA1CF0FE9E85A711FA246EE,129,127,2,0.9005235503397743,PASS
AE418FCD8DD9AC3327462304CAD7F112D12C42554032B2EAD481B0C2919B107E,141,115,26,0.10416255883043901,PASS
F5115C0ABD6547C0D07036C79DCC03811D34964DB0F8230ECD49EE9690FC6CB0,136,120,16,0.31731050786291404,PASS
3D819A0ECF25A7064E66F94A592326FAA895D0F219749555145AA227048D12D2,139,117,22,0.16913144470267139,PASS
56990E07B8AC0AE073CD737B1683151D33B2D969E2595B6A39B1BA62F7271928,129,127,2,0.9005235503397743,PASS
5C06CF8656038EE16744249DBC62C985F7ABB80BE797C0DDAD95E7B0EA2B734A,125,131,6,0.7076604666545525,PASS
39DD3FC7B97AA17D47A665EF5E2808812B8615CBEC988A20EC7D816DC67AF0CC,125,131,6,0.7076604666545525,PASS
D24E1A0AC451D6FA8F8C3F54FA5B9D387B9AB4EF083EDB89F819883D9B1DB189,123,133,10,0.5319710580974012,PASS
A355F74D529327D98B8D07A630ED35718569FEA68290DE6EF655ABE4CD22D2B9,122,134,12,0.4532547047537365,PASS
3B4D01DF7032CEE4D36283A9629B83F03E865C4FC444D81E8ACB87A5FC053DCA,131,125,6,0.7076604666545525,PASS
B529F8C8236AF51F69155C39E0B55DE74FA6C377E4D811C8A81C7D7E60C25C75,124,132,8,0.6170750774519738,PASS
1F1E37E460EEA95225DE43FAB2F70FA4D1D7281ED256DBA9FD355A8C4F33226,122,134,12,0.4532547047537365,PASS
11AEA6354A10273C1EC7D98AE93B90905AB6144C16392B82548A6AA6FD18F6BA,137,119,18,0.2605890342736178,PASS
5FEDD345E4A71E7A1154486AE34467388D87E86AF1D26F6930935A36FA43EED9,123,133,10,0.5319710580974012,PASS
BBA40724A034FE106125279A8A7730FA2D3AAE5FE39FB1B30B62FBD07C18D866,128,128,0,1.0,PASS
AF893CC7F192C44D365C79C6A93694F33C00138BB34EE43051030EF1530428B4,139,117,22,0.16913144470267139,PASS
58D78011B5D12F890EBEE5273235C3ED261161ED7381822B929AB46181ED6DFE,131,125,6,0.7076604666545525,PASS
EA8E18D43F163E76E00AA2ECAF819BECDA5D9FC9808D2669739A888AE48FCCBE,126,130,4,0.8025873486341526,PASS
9E11E4EC9E731CE93EDAAFE179E18934BA6FB348CEE0B9B90DF3B8336866AB15,119,137,18,0.2605890342736178,PASS
8725488212A576302012C9FAEF0A9D47A7B5828222745BB607F3B283E378B8EB,136,120,16,0.31731050786291404,PASS
F0A1C5DD64861A530F5AACF404CCFC94D06CA4DAE7C62AABC259FB293A676455,129,127,2,0.9005235503397743,PASS
96D885C517112CEE3699CF3FF58EA1E8182A832C739D79B34ACDC200FC41A051,134,122,12,0.4532547047537365,PASS
674801530C87EE8A5562A462B1B70EFBD91E1A5863A11405C912C4D377AB8353,138,118,20,0.2112995473337106,PASS
2AF723482FA5253659A913874E3BA1B0595D0CD8C46E7EB30F8DB9F0AC2E46D8,129,127,2,0.9005235503397743,PASS
D4697554FF37D5B7ACEA699D30ADF93E0CA5B7F115C64CBBEEF0CA36F4C57C73,110,146,36,0.024448945310089426,PASS
FE2EBDA5426311889AC7EB63A175E7F30C5B00B4E53719C6D88CE5D53D52A8C2,127,129,2,0.9005235503397743,PASS
6484326D794C97D094600D9DDDF906ABCEAA56D0D434B0FDFC148690E409E446,136,120,16,0.31731050786291404,PASS
77E0412A6BAA12EC01BB06FAD4803E81C3B07CC5081D2E05CF164F0A3F4EDBBA,135,121,14,0.38157390570502125,PASS
D730E994E1C0B71A359116FA61BCCF4EC33C430684CB06FA3F141329525BA166,134,122,12,0.4532547047537365,PASS
4A05F572B67C27D5768E1CBCFF015F04FF4B04DDBB8167AD20CCCDF987919859,122,134,12,0.4532547047537365,PASS
66AF7916F9453919019E6C7565D4073BAF3BF543EF31675BE1768C035F5C7ADA,117,139,22,0.16913144470267139,PASS
BE77E8D2ACE9A873803ED770EA61D472DA4E741FA18B51C53A3BEE7988D63C8F,120,136,16,0.31731050786291404,PASS
8992B5D906AA27D96CEA7AC98A5F8786D4FD615C8708C2840B07326D5B8ABB60,133,123,10,0.5319710580974012,PASS
69070A596DFCCF97F43821FBC294E603E84FBD69C235DF6E26A628E71F846CCD,122,134,12,0.4532547047537365,PASS
25E7D7459E5E0B1003D3A2B375937BBE32CD9F273920FA386D49B1876A7A444,128,128,0,1.0,PASS
A9EC2EFBD259A69CD37C908DA495353B83976D3B20B93E5FD408305849A7C279,127,129,2,0.9005235503397743,PASS
26D674C3D23C303B0EB4CEAA9C6DAB33552E1F8B618287AC7B94E7F1AC998AE5,125,131,6,0.7076604666545525,PASS
C9F66910853CDA54EBF4AD0635D1000C8774D19103175A2157868DBB9FF1C6E1,134,122,12,0.4532547047537365,PASS
F518792C12631498DAC0E4E9983F61E42C8269365B946D5E20250BBB39B97AAF,133,123,10,0.5319710580974012,PASS
CF2FA6BE9C650DA17929A8924362D816880F0D88E8CB4DB129EF9122E973ECBD,130,126,4,0.8025873486341526,PASS
5AB038E3016299E8BDC02340D8DEA3E6B2875B8627174EBD9505D802C5A232C2,140,116,24,0.13361440253771617,PASS
77E2D2BE51AAFA06DA23599E1EA802C152523D2B375B65AC45CBB7C021C5EF90,129,127,2,0.9005235503397743,PASS
226E1AD3293A582C87007453F768B930A20FD060EBFB0694AD9A44D4B21DB12B,138,118,20,0.2112995473337106,PASS
DAE82596F9CEC27079D4B7EA698D05BB87C0090ECE8EB01A22C5731D5F4CDE1F,126,130,4,0.8025873486341526,PASS
C95B8FE2B4776D926E958C0C577D839BB59BF6ACCFA8E93309FBF4406AF17E17,115,141,26,0.10416255883043901,PASS
D81E5DD188AFDE847A2B1F5952C4239D482EA6226347C0D12F7D7D9D1560FB79,126,130,4,0.8025873486341526,PASS
4A33C98DDBD7B34C76F0D4269CD3E49F45961E4272A619E27E5A56AEBFF14478,121,135,14,0.38157390570502125,PASS
A4CD7CB75AD218128152783EAB1E752BAFB2BA1F553B4FF570FA7CC0EFF042F5,118,138,20,0.2112995473337106,PASS
1D932C36CBC9EAF53B4280456CCEDF03A133797A47C806C741645957DFA19869,130,126,4,0.8025873486341526,PASS
B2BDF62B99FF8E6677B12110519DC5332FE75805A462541BF97DB8D762FFD891,118,138,20,0.2112995473337106,PASS
5A748602BEB211FE4BB0BFF18406BBE9178183C02A9C6A10421C2C8D37E9346A,139,117,22,0.16913144470267139,PASS
65A77208A23AE6D86BB7D0AB2DB32F2483CC59D5E98BB1319CD48011D4E7609D,131,125,6,0.7076604666545525,PASS
AF6434FDFD34A95FA69C6EDD2665E5D93CADE1212A32E6CA1339C6BA52EB5485,120,136,16,0.31731050786291404,PASS
468982DC504AD32CD58A38F72F570F6D5AB09A77A00C3A9B390AE2A4257F0EC8,134,122,12,0.4532547047537365,PASS
CF722A81544D6CEE126DD95C50C139F6C0262AA8D04BD02D9C9110350FF7D29A,137,119,18,0.2605890342736178,PASS
55935F0B4281CE1F7BD21B8DC5095B64440CC747A70EAD55E2E1AB11013ED8F8,133,123,10,0.5319710580974012,PASS
FCDF368F0C2AF82014D9E0FAB540C520200914F165B75046B562A2859701BC5E,141,115,26,0.10416255883043901,PASS
2AF0C7E20FD96BEB1F0D0C71349FE0E8E7FFC7EFEB0EF340647904D858F414AA,121,135,14,0.38157390570502125,PASS
29EDAD81BC9CA1C712D1DFD803F753CD7BDF1C5A6F656DCD838042A714DFA4E8,121,135,14,0.38157390570502125,PASS
708545B5B5BC0ED9D8334680E34AFFE637DC005CE1D5414988F5D829715AE358,132,124,8,0.6170750774519738,PASS
5B2B5DB87719C0A390E6B1AAF6E0E90770BF3B2B5D7FCD7C9A4250A5D136E834,123,133,10,0.5319710580974012,PASS
41D0EA0C08B42A2524CF40BC43E3FC03829CA57F040FA1E0C0C7EE43981DBCA7,142,114,28,0.08011831372763423,PASS
B4FBD07FD9BAD99A65842C4BAC0F9486B4B10511F478ABCD25FB220CA07A4D4D,129,127,2,0.9005235503397743,PASS
B6D8D675D7D8731BB77E2451EE407911B6842C11405687B600FAF72DF1618FC,129,127,2,0.9005235503397743,PASS
A01899E3627476667AE476F6DBA5E79DD42FC4831A7A18B9D6786BD4F2732801,125,131,6,0.7076604666545525,PASS
96355420CDEB7FC4F80BC401D0C349EA4981447CE0D488A828CC3933C86FFC42,141,115,26,0.10416255883043901,PASS
873757AB5171C989EBC7E87BAD5CECAD4D27F7CDDFD99652F38D0E282BFC4720,114,142,28,0.08011831372763423,PASS
5E5BF9DE1E1FCD45F749647849717E706D7CD7073BB0B095115A58104DF4CD22,124,132,8,0.6170750774519738,PASS
CF27C86BEB0A68534F3F80C348A93E59BBABAA0800FA2952DA4B577E9E4A3ED3,126,130,4,0.8025873486341526,PASS
E3F71F43B8E517D8ABA784FF2ED6CE3EAB75FF2546AF84DF241EF51EF4526D4B,108,148,40,0.0124193306515523,PASS
35F6299965A5981166B8E3CC06282AD2D4DACC13AB9082232997B037A532FBBC,135,121,14,0.38157390570502125,PASS
AE2757EFBF2AD907D94FD9DF473AE030109F9DFB7C97BBC44B1BE73F7FC68DE4,105,151,46,0.0040402749798920095,FAIL
AAE69A6BD598FCFEB00170F437B033A462C92E8EBB727D043DAC01FB85BD1E1E,124,132,8,0.6170750774519738,PASS
166442E4DE394D20689DB3AFE7423E2CEB734D26FF90166182A907669807CF77,129,127,2,0.9005235503397743,PASS
B7ED0DC631A5E2BDFDE5E9F5AAD6E18F80409B36C3C2B7D57B6257B0656CEC69,116,140,24,0.13361440253771617,PASS
1A6F7D1B2F06338D6AC1CC2BFBD8B23B9931D8BD8F4E94D04B258FACCF764668,122,134,12,0.4532547047537365,PASS
47E5FF63A7AB5045721A965C223867BA8A06900C6D80A8EF9EAF64B9886FE04D,131,125,6,0.7076604666545525,PASS
966B3B208B958087EE4C931AB0C75FF0A7C21DFE9A3C8CCD76BC80396740CEE9,128,128,0,1.0,PASS
4FAD1B886CA7DB86AE0AD56B5ABA913D8FCF30991586E53542A03DD362301075,131,125,6,0.7076604666545525,PASS
554F638B51C6B2379855165613A2FDF3FEC1125037A28A4D29B8E3D5FD94DD64,125,131,6,0.7076604666545525,PASS
598ACEF7C451048DF0DD6179D6F48762E0F872A6156236AEC751EFC6B01E3A65,126,130,4,0.8025873486341526,PASS
258BF80244ED08E9687D6537AFCAD4A162668CE97EF2F57C4F1E07B16429AD72,126,130,4,0.8025873486341526,PASS
F1F00A4C6815E6893665A9FD774A1F90AFE36F3191AD9FFC92152E654A5011DF,125,131,6,0.7076604666545525,PASS
A33455C551D7789552D99CB51F6FA6F4943134E751578AE9004396E5FE8E2FFB,121,135,14,0.38157390570502125,PASS
AB2BC62D28E7B3C6D6BC3FC2DCF49CD4B54157C66AF83B9F252D576A70893085,122,134,12,0.4532547047537365,PASS
F3C10A6108FCA29CAAC1AB4C14CE402C35416BAF1E7B4E99CC643192BFCDAE2A,134,122,12,0.4532547047537365,PASS
FEC82FDD0A7239077A58E612283F35C58F9A89EA9A56282AAD815FAF9B897DE8,124,132,8,0.6170750774519738,PASS
6BEBEB7004F6FFBE66F0CFA9A6B640DAC118AF5FD0F7533DD74498E186E1A790,117,139,22,0.16913144470267139,PASS
B2E74F939AF0F241F84CFB1393DACF8581841D541990ACCA2E3B656BC97F42EC,126,130,4,0.8025873486341526,PASS
771A5B94051A2DA1A28504EB89B2D23D2071FF58E853CFE776BA77ADCFC72874,124,132,8,0.6170750774519738,PASS
5F08C4495CF4206BB44C4A6C384CC1BBEF94002158F35C87E9B172B376DD9F31,132,124,8,0.6170750774519738,PASS
3CE70F8CFF870459EA6E6CEA6D897B03191EE40E3F24D0E5C6DB64F7D5120503,126,130,4,0.8025873486341526,PASS
716339E926793FE27924C03E4FFDCDA0C6F4FA483276DAF22D1EFA5D361ADB12,119,137,18,0.2605890342736178,PASS
3F87D9BD495378C00DF8DF408DF447FB664373A216FACB9B3EB89318DD468F6A,119,137,18,0.2605890342736178,PASS
601B2D0C2EE977C91F3EF403AA3697EAC8ECF725BD684166C55A7A480B8224B9,130,126,4,0.8025873486341526,PASS
9D3F6421AB151E102E977737993B89EC4C1BD70E3391A08EEED7DEDB306EDE3C,120,136,16,0.31731050786291404,PASS
C89BB50B4C77894C0EEAD82B0B80BECC390D5756B11D7FA4F17A091CB3FF745C,125,131,6,0.7076604666545525,PASS
19432E728248CF0F8B6F342C0A6B6A8A28C3E5952368F281DB96D1BDB5133989,135,121,14,0.38157390570502125,PASS
80AAA5F7CEA131943743E3F0DDF3AB74A7DB3F57FE45FAFCF3D5D2FE272163B8,108,148,40,0.0124193306515523,PASS
66BD9E99C4CA25ACC36DE99F762D6DFAB03E16470B900E79367C2CAA37E8DEDC,119,137,18,0.2605890342736178,PASS
60BBC32C13DDB0EBC8E5153B5E404C450A612719CD2D6B7F7A9ACFA9A2BA45DC,127,129,2,0.9005235503397743,PASS
7DE21F2D976710532A0BFC40D23F1895F3018E72876CB70AEB55C8E783B388C5,129,127,2,0.9005235503397743,PASS
8E325AB68E4B65579398C728FE93A5614F10F1B030ACEA8F2DF395F4FBB1F28A,123,133,10,0.5319710580974012,PASS
D6460403B73303F0FF1791DF67CDC37094E5EF8D2868D5AC4FD77F614AF032B1,122,134,12,0.4532547047537365,PASS
E9E829544C3599EC5DCF0434D12B9580995FC15755E28F955F36BE4547FA6C47,125,131,6,0.7076604666545525,PASS
5E74317680B9AECCEF6945B24BA177A4D73ADDC40700A07100C0C40F23D40B8B,139,117,22,0.16913144470267139,PASS
6A1B78AFD8BCC13D05687FCEF857D486447D45896D0FA8C789225CBD005DD31A,128,128,0,1.0,PASS
42E980859B6EE6773750721E454A117A0F8B754BF8F5A6A6FAA99602C400DAA5,133,123,10,0.5319710580974012,PASS
B68B8DC2AEE4D9B5BD3785DA0B0F5FCB5EB3A30DD22B8101DF4BFF7B28A6D594,117,139,22,0.16913144470267139,PASS
6E2D97FE0C16F8CD4C814E0D3F5B404FC66F51CD57B8502AD7CA87986CC876CB,125,131,6,0.7076604666545525,PASS
6C2323FF30F976531486E6E44405387CE6355995661E31FD2543583701FE849F,130,126,4,0.8025873486341526,PASS
E5ADB6AC6365D81670223DB24D675B8A8EFE4FBA0DA6D686EE11EE8094F5616C,124,132,8,0.6170750774519738,PASS
B8E704ADDB8C2F2860AB7A845103523CBA18FF80F46158D1A5A8E5AC87957EB2,133,123,10,0.5319710580974012,PASS
EF967083D56399DF72E0CF76311C8C718F977469CDC83CC563B44300F7BD2797,121,135,14,0.38157390570502125,PASS
1C39DFBB8E32BFE973AC9E38FE02EF7F4059F8CE10928AF816CFF1EA2F90FF85,114,142,28,0.08011831372763423,PASS
9CDE661E3CE588CBA3C82D173596D342D2B8E508919E6404C4B3B53A5B89ADAA,132,124,8,0.6170750774519738,PASS
51856E3B9D767A4A1397D2457A097CD767EF8159B609F53E54DD3A2C8BB8D7DC,118,138,20,0.2112995473337106,PASS
B5BB6F1D3B11AE7463D2EE1797D54D2FFD1BEE439C68F491EABB5BC4948C3869,115,141,26,0.10416255883043901,PASS
382651A4474900C3C769680A07D3CFD1C094D4E3C6AEAF5D846282F8D76B3750,137,119,18,0.2605890342736178,PASS
E38297C6B8DFC9FE9ACCAEF47E69F53E699819859182CF13242AEAC9AECF52AB,119,137,18,0.2605890342736178,PASS
31F02EE176FC6D45723318BE444FC38D833DD7BBB27127E10AF0587B0728C35F,125,131,6,0.7076604666545525,PASS
1BC3F581B2796CFD33095FF59FB37B7457AD09DAB7F7BC3E41B0FAADAF77E63B,103,153,50,0.0017780505982168669,FAIL
B7434C70BB73069F08AF55D4C07A7C7AC025506B1BA820CC2D2F8AA0273DAFB,134,122,12,0.4532547047537365,PASS
88C9F358051513FE9CA95EBBF485483E04F34A28AD496E818EE6FAACB46424F9,131,125,6,0.7076604666545525,PASS
FC5CEA388A4241C4DEC2EE22F7BE8F2ACFEF3347945081811D5EC2ED083F8F2A,127,129,2,0.9005235503397743,PASS
BAC0E8963178B5AE33E61E6A8C21F0A84148E290EFD653A91F274C2D29B9D120,136,120,16,0.31731050786291404,PASS
FF9FEA03CAD0A90036EBA30FE1EA4417F71EE12C8975A96EE08ABF7FC3084241,127,129,2,0.9005235503397743,PASS
19F2C19436D550778000E9CFD0CD2E907F60CA8E569C1A45E78EB9BD9F03DD70,130,126,4,0.8025873486341526,PASS
B867B7196431A49D0BC4F7D5A6389524AF3DF8542858433D8375CE8018DC8289,135,121,14,0.38157390570502125,PASS
8FA3A1FE846B0346EC086F49928F54C0B37CF285B444D2661032C5338D949E84,139,117,22,0.16913144470267139,PASS
8AA5C3221E1E30B49958D6236080E1DFD217BA183A4B6C870D3221FAFF07B920,138,118,20,0.2112995473337106,PASS
4711FA578F2AA2E55F11BD73EC76165C5BD2C8C158A9CD8E33282A6BB4E65E91,125,131,6,0.7076604666545525,PASS
9A26C75C921F36A583AE2CB0F9930C9AF16AC60A31BCFB72F4EDB291711E6891,128,128,0,1.0,PASS
E1F88F3826161026CC6ACC61D32802177F0FB855754FA8BA48BA858C50695E74,137,119,18,0.2605890342736178,PASS
663825558C8C7E2ACD1AB286F4549D6217DC8DE1C018F2EAA84D6C98359F2EAB,132,124,8,0.6170750774519738,PASS
AFB687E24BA38403090DCCDBBF898A5D004CFF9A061B0C558FF3D8B92F3931EA,128,128,0,1.0,PASS
76BB826818984944354B26C319FFEA58A6EF8CF162C4083070D102E3B8341F4E,139,117,22,0.16913144470267139,PASS
E02081B18BC75D5A8796EDE5B2B7ADFEC6E9F449DADF0C1B8617D64ADEBB65DC,116,140,24,0.13361440253771617,PASS
960717D3A3182C48D5F62EDD2EFC6A4A20A58A3EF59CB0B5B6680C90DDE85295,131,125,6,0.7076604666545525,PASS
ADFD3963F26E9B47FB527637B952199948DE5C32A6D4B12FCAF512E2EE8091EC,119,137,18,0.2605890342736178,PASS
AE07C463C0CF934C14C0B2CE4E49402E786AC90E47EFECD30F1BFD85D0616E4C,133,123,10,0.5319710580974012,PASS
77453B908B9AB506FA14EC877F2DC88E72F54DEAA3C4699826DD74BFDF987889,120,136,16,0.31731050786291404,PASS
F0D8F6B041D33F19F8AD312136814C73DF4BF3D3292AF32A671530A07EA84E60,130,126,4,0.8025873486341526,PASS
E638DFF22F79DF58B5106658B702FBFB6E4C9748AABE53EA2B6F349E97AB8EE8,112,144,32,0.04550026389635853,PASS
E38CC85EBE49ED171EC1D49739A94FCE395F94B238D9840F9EA978712F9BFBD1,118,138,20,0.2112995473337106,PASS
7EEA86645995FD9FACD7719EEBC4830B28A8D109A4F0973E282D23881626B3E8,130,126,4,0.8025873486341526,PASS
3057A172D71891AD12B02F85B3D9858F6D650ABE27F3A694B17B7C39BE63E99D,122,134,12,0.4532547047537365,PASS
A1AE5CDCE3DF03929BCCFC4531F5D3DC3C4B7509A5E519D4CB416CE96AB463B2,122,134,12,0.4532547047537365,PASS
BA10805193822A26FBE9FA1C502F71518200A80897956A79FAF43526A11CE290,145,111,34,0.03358661289689768,PASS
8D18FFB034B5A8BD8E0F15FBD8209390DC59436FB759A6D6E2B363082A660252,131,125,6,0.7076604666545525,PASS
66E8B8243E8D68030127D4043E434A0539F6325E3C8F113534BA106C344DE725,143,113,30,0.060792723530522785,PASS
CEC2D423C3AD82097F69E0EB2868A769776854A51167A62BE0E6E6B6665010D7,132,124,8,0.6170750774519738,PASS
F88BD25071938DD859E7405C1BACBF7E1BFAFC05ECA5E12E23DC9166E8537A1C,123,133,10,0.5319710580974012,PASS
21E43208399EFC2CB0FA40712995FD8E04FF8A70E8ACA0D51C5F42DBF924812,138,118,20,0.2112995473337106,PASS
7B72364FEB632791986C26AD71850985E03D4ED21CB82ED94B5970D68A36C159,131,125,6,0.7076604666545525,PASS
1C6828452EDEC27AFD50FEEED4A8BE09ABEFC88B3667BFB04F56354E92533FBC,117,139,22,0.16913144470267139,PASS
886A009EA13B03588AC56250642E302659EC7FD1B247B0B3E6A55E7444C14798,142,114,28,0.08011831372763423,PASS
B57B2385AD3CACF6C49548BC6543E2FCA7C6800E1189D8CCDB96E245D35A0DF6,128,128,0,1.0,PASS
F24B2F9C1A64A7F82D7739DB2B6F26B71FDD7E5E6FAB23BCEE5B804F64ACB90D,110,146,36,0.024448945310089426,PASS
A508CB7261516C1320E3D103B21E5CFAB6CA2A8ED34D199E4547A343A4BA558C,137,119,18,0.2605890342736178,PASS
EB738798346D26FACC998BE6D402176A2DF1572C6226C7E1D44E03EECE5FFECB,120,136,16,0.31731050786291404,PASS
F762EA18023D3C1C36877F7377E023EE53641903FA362CC57FA0F34B65D05BA7,123,133,10,0.5319710580974012,PASS
4411E9B0B04473F8DF56552F2AC25C396399792FBA7DC46697681D95B020849E,132,124,8,0.6170750774519738,PASS
8208BDF68AA3C056C1B8F85641E2A55D6DE87A03C072B771FB494BF2017BE4F1,130,126,4,0.8025873486341526,PASS
9B57DB3A6736E442CE6382CC6D114A06A0D3B4E148DF903BD35195C813435099,136,120,16,0.31731050786291404,PASS
B351BF5AC94E82CD0997E0D9809CEAB56859C298CE1D5A8EC35B36394B8666F8,129,127,2,0.9005235503397743,PASS
2070F71B6091D2BA0576BCE7AB3E64D0C2E853B483F4A370CA807C538D2CE3DA,132,124,8,0.6170750774519738,PASS
70B91C59C88978AEE07B1877A2D74F93BE6CB49C34FCC4955D8FCF504EFCD1A4,122,134,12,0.4532547047537365,PASS
9643F80C69D0290CEF627F52B3C6C9400EB9A9A3765B3F8545C25D0FB720E4A,133,123,10,0.5319710580974012,PASS
818FB282570154386382956EC33B7836F563E3FD1D310656F950A5C59B665C3F,129,127,2,0.9005235503397743,PASS
38453182251CC57E21189AA2E9DCAC7082EABDCB54D60E21D2DD24207F662465,140,116,24,0.13361440253771617,PASS
787C1AE6AA226CF537AD7DF6D7EBD0FEF3E8D34C4491C30ACB2E3ED4B2D33D98,115,141,26,0.10416255883043901,PASS
77E449EB5B6FBFCBD6811CF266ECEE0B0D4CC7B99136D86C73710561DCB640B3,120,136,16,0.31731050786291404,PASS
97E22DDB910354458F7EEDBE1C2F16CA2DD0D8E0056AE17D0D8F40EC2FD99E8C,126,130,4,0.8025873486341526,PASS
9AB6836D352897C469393544BFC53535F50CB56AE095345B5B944D59965ADE14,128,128,0,1.0,PASS
,256,0,256,1.2777508801076536e-57,FAIL
50C5EA931BC7964BE149AE828BD1AF2244770DE5F565FAF8A4737C272DACC2E9,124,132,8,0.6170750774519738,PASS
CE6238A08819CD154F7F315A45A84571622CF6988C78D7AC5D915D7EE378E33F,127,129,2,0.9005235503397743,PASS
687EFBDDDAE5F91C55CA8D39B118E9964A0A778916933C2F68E9121954B41A00,131,125,6,0.7076604666545525,PASS
3083385074442C3975E9808BA2A60AC805CE87B4D82B80841EFFD11509D60DA,149,107,42,0.008664896726025117,FAIL
124D2796D6ACCE6AD83811927440D0351C421555517674ECF790AF7FADED366D,129,127,2,0.9005235503397743,PASS
CEF59CF79093183A0486345224BAA2AC9FFF0F54BA77F9AC39798C1FCEB72A90,123,133,10,0.5319710580974012,PASS
A950527DD60A1ABA68BD4CC64B1D8DFD3EA2D583C7EE833248BC334D4875BDB6,125,131,6,0.7076604666545525,PASS
D8A2877FD1784FB8231231D9EF67AE777586D45ADCEC4075CF68BEA6C8EF8503,119,137,18,0.2605890342736178,PASS
8706100417795B1AE1D6954AA66014942C0EE06637EAB661316CFAF7857500AB,140,116,24,0.13361440253771617,PASS
E95D7952DE62DF6D5D0430DD712328C3D08C3B5523DE29B70FD95F02BCA062C2,128,128,0,1.0,PASS
E4DA9152DF9111CB4A80E1FEBA1BD1A6CBA3CDA8A32562D02D227CD2C330D22D,133,123,10,0.5319710580974012,PASS
6EB7D890B0B949092C25DE57475A4B441C91A72BE7FC737355F4A0BD34890277,128,128,0,1.0,PASS
EF2E5744A467EEF9E6A653C3A2B3806A9D61AEBFF3F6BDC30692783886808F07,122,134,12,0.4532547047537365,PASS
2BB9D9A6DB7DD7D41D5B1A38A6276B30A38D3C2E8C51CF7E31E88EC9EF531DAC,118,138,20,0.2112995473337106,PASS
60E4FDCD32AE87AE9A2A2E9C22CAFB2B34DEEE255B77734B700CB2B3DCD6C82C,121,135,14,0.38157390570502125,PASS
648A5EC153AFCCF582D7A6CDF82597F2EEA08A4EB9505431B29C200400948297,139,117,22,0.16913144470267139,PASS
E4CE440C979FAC7DAF8DBC657AD57FEF9366E3C83E4632D4EAC4C091521D7AD9,118,138,20,0.2112995473337106,PASS
EF8AAEF61C4DC232C17C2FEED38DC62E8A006FA0A15B06BB1CAC51269BCB2CAD,128,128,0,1.0,PASS
479F8EC3418CEF60A884AA96BB56731CE7C0574659F3ED66E790389311358AF6,127,129,2,0.9005235503397743,PASS
A1844E39FABA0E7290E9582A1D6B007DA16B326E3108FDE7B47D3335D32E9AF9,127,129,2,0.9005235503397743,PASS
E16A1D3865103BE46B44EF8D03DEAC367ED9BFF94D4236CABAC81637E3677C25,121,135,14,0.38157390570502125,PASS
B7B7C5DD63C43819A566E006FA18452F663799FF3C26DA564E808F42B7E46C73,124,132,8,0.6170750774519738,PASS
88C2291BB05DD9472FF243F8DCC57769FC3E3AEAA7709991D7259954F47A26DE,120,136,16,0.31731050786291404,PASS
D3CCDFA0672AF70D1D2AD518ABD65AD04C8F6418368CC50CD842B5A6A371921,136,120,16,0.31731050786291404,PASS
A0725C626BB0CCCB563F2ACA8E93D14EE847E6C1F8E00FB33836BF55B133278F,125,131,6,0.7076604666545525,PASS
659CDD43366A9D651904415895DDA3BA51225A22CA8546BB485DA7B90ADA70F,136,120,16,0.31731050786291404,PASS
BD31732A863806641A97D76901B1E3762DF4DB5FCB3A6C2FE6FD973CA972F0A1,120,136,16,0.31731050786291404,PASS
27AB64C5F4D4C62836BD2703ACE7D28380B27A6BE2055AE1040EB6A5A6C0ECFE,132,124,8,0.6170750774519738,PASS
EED70AD8C6995B068C401E8CBE70DCA43CF3F22D528C055F461000F4B300CF09,140,116,24,0.13361440253771617,PASS
74235D8F86B0A22FA6FC6586157CE809368029E3AF6EF44858F4F2277BA78B82,129,127,2,0.9005235503397743,PASS
A3DFDAA45A4E1EB14BF4E7A8900E13DD57D7681AED2E319D467D1324465ACF41,125,131,6,0.7076604666545525,PASS
5ACB4535C45D5B427A89749EFE4F3A81394E759D84D904306AF2431DB651FE4A,128,128,0,1.0,PASS
3645EAB6F7CBED10E1656CF52DB7036606F7EFB9FFD164269E619E39B6533843,115,141,26,0.10416255883043901,PASS
7C9105669DF6C7623258FE73FA7015E6CCCBBD3EF6B4431C4EE4AB632B633CD2,119,137,18,0.2605890342736178,PASS
5D51D60238452C0A5DF639895C177E8BFE59BD47EEB6925557F69421BE4799E0,123,133,10,0.5319710580974012,PASS
E4CA559823CBE473484C19EE89F6641B5C0184F2D10321CFD0F7BF88361F3ECA,131,125,6,0.7076604666545525,PASS
E2EB0FAD5BD99A3CE24317C377E00ECA09D5333D03B929932B25B5C4E79F3D80,125,131,6,0.7076604666545525,PASS
CD07FC883DC1B1F7D9C47F3B8CD03E68A5A6FA13F9DCB0EC3E3304D3817CB802,124,132,8,0.6170750774519738,PASS
F20F10DA527D482139AC83B6FA16AA303554A796548409EE22F5F75374AD98BD,131,125,6,0.7076604666545525,PASS
451F06D98016D993BC38E1DE58DABE966D2DB4E619386DD12FBCBD9419E1A6CF,123,133,10,0.5319710580974012,PASS
EA18B077B34EADB62A0ED3CE0C9DA13B3628C31497879838AC840ED933748408,138,118,20,0.2112995473337106,PASS
67144452DD6714704BC118510F64F5B4BC20B0DF92568C6CE8EEEE0411BB8D3F,134,122,12,0.4532547047537365,PASS
7F26CEB1F88C0E5F888FCC0425F3AC6EEED067AD9832669C515C4D13B5DB2863,126,130,4,0.8025873486341526,PASS
D63C5F505220E89E6A1C17D1C36AAE5C9AF030309FA1AE25CC58041326E5B1F,138,118,20,0.2112995473337106,PASS
5F3311832D5220ED0CFFBE128CEC8E704F5CE723DE39F0928E781D1CD6A48A31,130,126,4,0.8025873486341526,PASS
6CA86C6A049A341B403D6A4259E54850FC8DA191EB165CCC1A1F8BD8C3FBEF6,135,121,14,0.38157390570502125,PASS
DE27CE307A7716D6B220F96EE4373694F2035F438F8F1C0F3BAC6A3E0C5EEE91,121,135,14,0.38157390570502125,PASS
4791EF667555553FA4407690CA8735F8E01E8AD7748D8F6A2D1869ACBBDB0A5A,126,130,4,0.8025873486341526,PASS
C716CA8276177CF29E2B80FE2B93437C3ED76C66D85644E59E2E1A1A5755B99C,123,133,10,0.5319710580974012,PASS
8DDA739A4FF3556952DF8B3DC9FF9F734F50E98F564C8F6B98DBDC2C42D083F6,112,144,32,0.04550026389635853,PASS
2860143B98E86DA837D10DA9E514DB30AE0F9FF6F922438AEC21344CF5D16978,133,123,10,0.5319710580974012,PASS
A3A1B30252D2C5C5FFD83A59C35C34E18EFEDAA4D2DD701122C4A46A1952EFCC,130,126,4,0.8025873486341526,PASS
84DB3FCD8DE5FBCB0C279E56EB37B09BE19A14F868FE4F38E6892CBDAE9577EE,111,145,34,0.03358661289689768,PASS
F229DC8465D2AF6A0895356572F7412DAC1A884655B7DA7B03733949880B3DEC,131,125,6,0.7076604666545525,PASS
63DC2196490A1BBD3B47AC70876727878A539CDA4C452128F718A754FDE5249F,130,126,4,0.8025873486341526,PASS
4ABA0788F54694496298FD36A94179E707CBCE790DA0C1712DC5C253156E2AAE,133,123,10,0.5319710580974012,PASS
65500ADB5344A61A1439A5B785B3386A61C1F02AF15DC83C5302574064A57AE4,141,115,26,0.10416255883043901,PASS
F184C79A04FAA39B9F53636CB1FF63951611F203D603C595BFD485376E439848,127,129,2,0.9005235503397743,PASS
D6F1E7C29DE817C7EE5D6914F99F46DD2E611C6D3B14852B9B8CE15D2CCBFC1,120,136,16,0.31731050786291404,PASS
A81195E33FB74135E3D0F0652620E0F9FEA8CBCD32BB97A2C6E08F3795A77BDE,120,136,16,0.31731050786291404,PASS
8974F201F01D2706EA843420D82968FFD434C167246B2F6C3C9790E71ACDBF44,135,121,14,0.38157390570502125,PASS
1546EC0414F8D24B3B4954974296A5FDE8D874A307FB4D9AF4C87C3EFC446988,130,126,4,0.8025873486341526,PASS
940FCD7776825F9E1E7BF4F5A0528B0DA83CCC72BA12FD9EBAC6A88640DCCD20,126,130,4,0.8025873486341526,PASS
9AF842F01F1EA4663707CD525B3C9859B332619E0C04D9F4A64D689F316394A0,135,121,14,0.38157390570502125,PASS
A5514DC5226D2FE0B228692642DF34021A74BEF32A5B06AADE7F4F8A346CD7E9,128,128,0,1.0,PASS
44523112AA87B9BBE57A7415AA7FE9C1FDB5B7B60AEE3ED563092C1793C6A912,123,133,10,0.5319710580974012,PASS
2B5693B40A2848D29C9713810DBFA8007F50C0AC0E873D264FB003EBCF904EA1,142,114,28,0.08011831372763423,PASS
8C1EDDBB4BEB0C7EF1D0766F4C4A68A4CAEF6B1CECF912D51B0740C85CD2E3F,123,133,10,0.5319710580974012,PASS
1B4D8E5F31F1354A48B16EB0390B4BF6E9EFF755E7E0E4161CAD4C3CA2537226,124,132,8,0.6170750774519738,PASS
316D47C00727630933D0A18011F609BCC7B6E410B64368D3A6F9C2E27640D04A,143,113,30,0.060792723530522785,PASS
CBFBCD5981CE406D0E874020613373BD3A7AF5F1CDD160869F7C495CF2456551,128,128,0,1.0,PASS
C579A7ABFF31186305E512CBA395C7B5D4F73C804F5984BA44AFC509A0A5F1F4,126,130,4,0.8025873486341526,PASS
1157E1530FC94D809F5C04D6D14EABC401A8F34B55844F05CDE9E3888A2D1CC8,139,117,22,0.16913144470267139,PASS
B53EF1443846351BB70B1F0176A602B63592836603C3422CCD3C43631646A1FF,137,119,18,0.2605890342736178,PASS
DEBAF2A2240E045CB6E1868B4C6A285FC946A41C59DAA8DAE78CCF8AC25B065B,133,123,10,0.5319710580974012,PASS
1F9658D3F434EED985D8EDB09612CF7A5D9E055D6933D29863529E3FBFF04D32,119,137,18,0.2605890342736178,PASS
F35E09EF3FC00D506E25C9E6C04D963CC11C92CF8935DB1C35C3E332CC66736B,127,129,2,0.9005235503397743,PASS
A9C40E13B79ECF1DDA9CB2A361D4AB3D36C70FE2AD099C99A3901A66FA50C3D9,126,130,4,0.8025873486341526,PASS
5AD0094DBE9CF8827397045FCF40F0CD64A8063F99C1662A2382A2EC7651D6D5,134,122,12,0.4532547047537365,PASS
B8A1DDBB05A7A48E91FD97809C965E73026FCACFB33C99A540656D334D884281,131,125,6,0.7076604666545525,PASS
CD0C193788F71F808F97B162F10300816E2F1F1DFC5145E243A9CF98C8CCFA63,132,124,8,0.6170750774519738,PASS
B7D0F20DDE8A3257EF8DDFA41105F6E2493DF44B242D9588E9293B5AC901F8C2,128,128,0,1.0,PASS
38E5A992C5C7760A74E2CE19F250E5CC47B4459F9EEF03416C50CEFF3CD0DBA9,124,132,8,0.6170750774519738,PASS
8D77BC9550509BB6D0390E57CBF190E36544B92657CE7FC0D321379A7118E12F,127,129,2,0.9005235503397743,PASS
FD03977DB4E7325C0FA7E81ACD5554EEC8843413F001EDFB5F6E3BC79A023E9A,121,135,14,0.38157390570502125,PASS
CAE8BA4DA9717BFC948F2AD70DB6812487D5D6FFE8E7F6E8756D0C59D6AD93E0,115,141,26,0.10416255883043901,PASS
5D89C34D2B0019A9A696D93D8C9B47667101A70B9CF60D032BFA8BA7752E7F37,127,129,2,0.9005235503397743,PASS
740DB6F74151DDB78EEB6CC0FF5033C1095503498B541BE0B943E370218BC1E4,133,123,10,0.5319710580974012,PASS
8A81C1FC5B710A2C5D67582D6DB38958C522B55E11EAD895BAA2890242963D62,138,118,20,0.2112995473337106,PASS
7AC6955DAF84BF5C8621625AC9AE34C3F44AC20A247C40026F31EC25A6ED6D47,133,123,10,0.5319710580974012,PASS
AB65FF1C0A20EC9184AAC907CD159C681564AD4EB0A1C782802EC59EA9A5E428,141,115,26,0.10416255883043901,PASS
8F0ACCED990CBF960749BB235107BCD41AB30DF51CAADBB4C5694C10C14AD0C4,134,122,12,0.4532547047537365,PASS
E69F52EFBFFEC5221112A96CE32EB39F7AD790B4B2B4ED234406B3FDFE844583,118,138,20,0.2112995473337106,PASS
5A3DC4A2A45ACDD230986461778AC1E8B3BAA2F3AFF2C80EDE987728AABCF0ED,126,130,4,0.8025873486341526,PASS
D04824E4C482FF8F85C9E209420EB261079B2260156D77EF1FEEB7987A8251D1,135,121,14,0.38157390570502125,PASS
567C052F00B2621F5ABE4D9DE0C320BA948A20D405195240C9D18A1B783FED54,142,114,28,0.08011831372763423,PASS
6D1F16F23ACD038920D244353874FCE17822E346E7770B6F7F309B171C307F,131,125,6,0.7076604666545525,PASS
CC90A4F1D257A3F4531E89964ED14FB4D48C344F4F3C1F87EBCC252AD8086CAA,130,126,4,0.8025873486341526,PASS
FDF4F2A946806C776AC3D0F400C2AFBA6033BDAF4DD65ECF5A8C964A05D5D4BC,123,133,10,0.5319710580974012,PASS
6564BB6C16FE5C94BFE796836A5EC81C35F22B807F1781CBD0FCF694C7233327,121,135,14,0.38157390570502125,PASS
540180526A21A091C2F96C0C9FDC08BD7040F982956A91F7FC15684971169B0A,145,111,34,0.03358661289689768,PASS
26183100C0624D4E62DEB35640A92AEBFD795FD3608239A54BF3A4EB11AAF169,134,122,12,0.4532547047537365,PASS
75C225A55592D4A013651B2DDEBFD48AF9E723030CDD53775827FB138F87019A,127,129,2,0.9005235503397743,PASS
A20F13BA896568D96EEAAF51AAD0F4A223A3D4614B0206D06BAE254FB6CB0511,136,120,16,0.31731050786291404,PASS
4D27AFB94E5F7AD839CB80E5BB87A597CEF616B22B01094BE5A5268E92E733FC,120,136,16,0.31731050786291404,PASS
8E902D306C1FA4326DFBA3A1327EBC2FD5222DE43C5D67CFBD10F4DEEF8978AE,119,137,18,0.2605890342736178,PASS
737F74CD82E9F8FC74B3CFA2A737255D0E0C0DCA6AFBF2DE7D026D84FD4DCC3A,114,142,28,0.08011831372763423,PASS
89DC430F9F90BDB71AC0BF7DAEC22682B2AB0E8B3D079631A6F705C3C5F758E0,125,131,6,0.7076604666545525,PASS
53AEF29AA07B5D4DC8F6CD406C4298E1A60583DF624FEDFB59D43548860CC7CC,128,128,0,1.0,PASS
DDF737CDCE53E823573E2F6F9272EAF30AB4012B8DE9BD8267B322174B4083CB,121,135,14,0.38157390570502125,PASS
332AF0EC460924D2162CDAAB75757C58E1AD74675539129419BEE878CDA2EF39,128,128,0,1.0,PASS
C6612962E089BF064981197547F62FF4C9422A85C989DCDD793E5EC7A058B239,132,124,8,0.6170750774519738,PASS
A0F4B8C0890007B6254BDDE3CC792AEEF2F443C1EA1E07ACC240A6493F20F3AD,135,121,14,0.38157390570502125,PASS
A5BA9596DF43430AE772A1A9129FCFB5E2F144A4593CE111A9EA793649D937F6,123,133,10,0.5319710580974012,PASS
D0AB514A4631517F7108FA857638D0798A9A5332EB4ABCC1A73821D6B6BEE48A,132,124,8,0.6170750774519738,PASS
8895F872740A897FC2D27B56DC6668FDEA8BC5173848B8D674402DA01941D829,135,121,14,0.38157390570502125,PASS
19521035023DC035D53B494EF8499E2987DAC711A2E9C7E2E859EE8166329C54,137,119,18,0.2605890342736178,PASS
D696F4FE1E3E5C86EC331911F5BAA62380E0F37DB002945AD16345F9BCABD33A,124,132,8,0.6170750774519738,PASS
165841E4A15A699E94B63DFC869612F1E6D300CB6B78326B3A37D68D2AB65223,131,125,6,0.7076604666545525,PASS
381551FB617B5EE2DFBD4522FC24A9A81E65445E187CC4E2C9739394FEB9C90B,125,131,6,0.7076604666545525,PASS
96182CF7EC6F55C2C7FB4B00E5A28BF247357ECEC9E71E9ADCA0E8EAC831061B,124,132,8,0.6170750774519738,PASS
CF676F1CF421FC2E24C38E5010E2D343D93873096406C66746E1A13659B56CB,135,121,14,0.38157390570502125,PASS
986A9D9510350111D11D3A48E9EE9C37882E1A0D99134B4D23133D84C1CA5B0C,144,112,32,0.04550026389635853,PASS
E1E8B7CE5F136AED2FE774FC1A68802B67E29B287716C1ADCC9A5BBB6C5D14B0,120,136,16,0.31731050786291404,PASS
C25B47E1C6EBEBEEAFD040B02355F7A161BD7573E648CA3C3EE28D5CB6FA89CE,118,138,20,0.2112995473337106,PASS
7573DF5BF8C1B182C66E8B9784CC999DBDDDF77ACA471DB09DC08A5104DF6114,122,134,12,0.4532547047537365,PASS
EC572107B5CD8160D0529480D6A9699072B9A5A9178C4A11DF0ECF965F77E784,133,123,10,0.5319710580974012,PASS
F6DEB65440008C6735D3D51746F415EE387321586477B37512C5ADF3D0A82AC0,132,124,8,0.6170750774519738,PASS
EAE500FBC25C9BEF9F0D80DBAD0BA399CD92D16B893C9FE76576B6059BC99DDC,117,139,22,0.16913144470267139,PASS
57DEC92C9AC166A4D5E6C8034EB40F9BD6D622C38218CCB79E61F9BD5FE2C0A5,126,130,4,0.8025873486341526,PASS
B7B2B714C140AD5CA1DFD5FCBEA2622BFBAFD8C1449CC94211FA2C45EBB1FD5C,121,135,14,0.38157390570502125,PASS
4DB5E538D4D08D376C4BCBDF63D67AB65000CE9576FA05AF7662BBDB8F5FBEF0,113,143,30,0.060792723530522785,PASS
667FAA0023AFF9B92727AF087F9CA0DF49591F95C40122E0092E025F41B0801A,139,117,22,0.16913144470267139,PASS
C8E543B164F62B21264DE09580BD8B82B5B725B7EAD046896178208F48CDEE3C,135,121,14,0.38157390570502125,PASS
F4EB920459EFCEDF33AF4FC67101999EED54BF52E1943D309A31AE80BA3F61C2,122,134,12,0.4532547047537365,PASS
C68EA79779A57CF3B15F9B18BA07A4F09A2DE935D5E1C34249EEF525CD61AADE,118,138,20,0.2112995473337106,PASS
F164154987675122BED3BDEF5E0BC4AAEDB464BB139A582D2C3A9CE9D6654D3,125,131,6,0.7076604666545525,PASS
1E6F7474CEF05909F38FF966725B74FD6C64C9EA01C33D5616B50C97C38A7F63,119,137,18,0.2605890342736178,PASS
20B3C95FEA83E3B2F86665C1ABA62ABDC535C04CCD8203DBC78DA9D5BEB57991,124,132,8,0.6170750774519738,PASS
7A6DD443C0CC0BF273DD88F7ECF675F068396E8666C3A3FD95989B8097020C87,126,130,4,0.8025873486341526,PASS
74B663F3904EFDE1E125CBEFBCBA8715BC695EF134074B630F4E8148A5BA71BB,120,136,16,0.31731050786291404,PASS
2F05BD0A55E2BB657CE2694EBD382698E885BF5861E17EF7240D7A9CB4552779,123,133,10,0.5319710580974012,PASS
80107D7CB7595774D89B55A4E477062A49A8F295C85D507DC8A9095BED55B9FE,126,130,4,0.8025873486341526,PASS
21AAE9071062EED7B4E6B8C0C555298D1E3B6527EAC07BE2665E0F7833DE091A,130,126,4,0.8025873486341526,PASS
C5BB87F62C5BF57BAEC67BFDE3380EED53524AB4ADC640F2AB28BC8D94B63420,120,136,16,0.31731050786291404,PASS
8F3CAA77A001BA45BCE10888AF17492E789DE582AA2FA155A8BDAD944B85279F,131,125,6,0.7076604666545525,PASS
2477F1DDE1D8942105830165BAECE59B7F7CC98CBF0751F5E2379FA28F04140,130,126,4,0.8025873486341526,PASS
82D5879DEABC31DFCBAE80DCA135874D4C1E8B45FF6B26793607CA985A092171,128,128,0,1.0,PASS
458929F34FA34280CA459CAF59C09CEE857653EEE6F65E8E2E402F1F9835E74D,126,130,4,0.8025873486341526,PASS
F0FA0DCC1E6F00850F7C91A1658714A4A19659E8E69130B882FD0765B5BDBC68,134,122,12,0.4532547047537365,PASS
D1995DE3607DE199D7D8FB96F0E3E1406E1DD9AB25C9F25C7031B7C10F199E16,122,134,12,0.4532547047537365,PASS
DB103469ABDD39F06084B311D1905FD408C5EFE31BA5E2BEDC7FE954F28B76C1,124,132,8,0.6170750774519738,PASS
7713BFB517DE4327F9D6297ED37E992D3C715A68CAD2E6B0DB97CA4004E8F2FF,114,142,28,0.08011831372763423,PASS
EF98118B3DD76660B7DF44F36C9D2F5E9C5882702561FA07412C9F93CF40E86B,125,131,6,0.7076604666545525,PASS
1D9ED317940F3EB46D80F687B3982ECB834C77E11E0AD98948421F7716A2FCF9,126,130,4,0.8025873486341526,PASS
DE13C55B4D9B726A620C5A242129C5F978EC565458D9C4BD101813C63816F6CC,136,120,16,0.31731050786291404,PASS
90E1E0A693157AD18E9390DB39FACBCC898C6B3325011BF72A66867B224D0B05,135,121,14,0.38157390570502125,PASS
DED0D6E3936599C3744C8FFB1BBE7882354D9BA8D31299190980768D12AE36D9,128,128,0,1.0,PASS
7FE296A7B73461F04F470E208A26115779E2DAB7365A8B665F19BB6704701CE5,126,130,4,0.8025873486341526,PASS
2BA90ACD05B7E9B724C5E8E4A26E328C110EB940374F7A47CEFDE2A2221A24FF,130,126,4,0.8025873486341526,PASS
7EEF154A7B9E9029304708620F829767A8642739B3AD34F28447A5B38FC55445,133,123,10,0.5319710580974012,PASS
58181DD7B2BDE49CEDF8427CE3C91AF14578E7E21E426FD6A8FADC4ACD693B16,120,136,16,0.31731050786291404,PASS
D136B246A7ABA139DD853B32119C97C59EA0CEEFF94BF3AAD469D00D38F05E41,125,131,6,0.7076604666545525,PASS
948FAA09B775EA53C291975D411991398DBB7ABD066E7F3530D35484A417D116,129,127,2,0.9005235503397743,PASS
4B24A586522EB29012056C7FAB5371B04ED0D09EBF4F29E164F3AA19CA1F4898,135,121,14,0.38157390570502125,PASS
C5CCF000EF61F35FD69B9E774EE58B30E4B1DCFFCF39F34DB0DD388364948F1B,115,141,26,0.10416255883043901,PASS
5733B491CE46897D16855C3AA6A9AC9DA78A7DE336EEA5268ACF602F320B2436,128,128,0,1.0,PASS
263FC3CED2E95491B4F2965A53A2D2B8D696FC7360EC5815D4A886D733FEA273,123,133,10,0.5319710580974012,PASS
B95ECA1A54B5586CCF90E9E6B7503C50C0FDE4CD86CE6D4335E79815D68C1211,130,126,4,0.8025873486341526,PASS
445221DB98A9BF5E78D234136E8B0A0D77A452B6F13E8F8BDE728A2961FC34B1,128,128,0,1.0,PASS
721F2786CAA5E92EB661377B0CD793DB428C8187CCE787B0DCBD56143A7D0FCB,122,134,12,0.4532547047537365,PASS
B5C3592758F349D9A0FE03938EFE6F5004F533F534A008CDA0956D03EC45459A,132,124,8,0.6170750774519738,PASS
A8A48876B3213B25B73481E48695C9B06CA6BEDD36E1189F10D8C5150FA436E7,134,122,12,0.4532547047537365,PASS
34A06C30F5FE15EF0613C8C86458FF3F498B4F59A3D7722E3381F6FAF3C16F16,121,135,14,0.38157390570502125,PASS
5F2BD35D5E1ED419709EF0171B1984E9BE6645F6B41AB741AA8F94DD7BC5A603,122,134,12,0.4532547047537365,PASS
6E328FFE76FD350A148F5617ED624DED4FD65E54D44E69F3965D7CFDBFD15E46,108,148,40,0.0124193306515523,PASS
BB0E1268B67628E36EDA8AF1C3602F5014DE833041C844EC4C93D9A3D00AF061,141,115,26,0.10416255883043901,PASS
423275013671A416B0E88B520E5CB10C5D7232A25D2ADB942ECC3A99DABD386C,138,118,20,0.2112995473337106,PASS
46377BDB9495BD6C89A59F2AC27498772AB4DA631354D2A3579792BA2CC38B11,126,130,4,0.8025873486341526,PASS
AC17873EF403997263A936A88CC7C7D9CEA20752584BE2B663BDC67187868F1F,126,130,4,0.8025873486341526,PASS
1948CF4420019456F1C62EE1721FA95A6066DA5110D13671AA89435C100B068B,149,107,42,0.008664896726025117,FAIL
A15AF6059FFBEEC5C1F77E2BC762D2D14F921FF746E0FF0DBB533831561C93EF,111,145,34,0.03358661289689768,PASS
1C508A5F9DA0E7616BBDF9A62EC691700F70DA5922120B5164D3C0284483EB3,140,116,24,0.13361440253771617,PASS
55A9A11D6BAB3DDEAB9598ABA837740B2819853D444F6B3691812FB737B2A5B7,124,132,8,0.6170750774519738,PASS
BF4120E090E86C71EC71347FFF9406D844C388BCAB0E0557973D768FBF1106CE,129,127,2,0.9005235503397743,PASS
92C1D6E4AB2B80667718A41555DDD403B2ABDE9ABF66B0B44D18C3D6255E854B,130,126,4,0.8025873486341526,PASS
C6F22A271FABB96E2E683B3D7D2A7B3BDAF97A16445C5DFF4030FC68ED4C2999,117,139,22,0.16913144470267139,PASS
F23C8EC28DA5AFBB72033C8A1E3EF199024C5FD1D1FC9DFB5E28946D9C4B58D9,122,134,12,0.4532547047537365,PASS
EF1A03FD4B9DA2C53425E8EAC5D8E17B6AABBB6D56FAAACC75BA4766BA640F2C,117,139,22,0.16913144470267139,PASS
C80D42CA62B6E731C77273A124873D5F1E6E38E123A02859E5A90642F8F2632B,135,121,14,0.38157390570502125,PASS
27DB2654F557385814AE2B3E7B7B767F044BDCC621BDBE9132A71116E16BE5DA,120,136,16,0.31731050786291404,PASS
415CDB3F4766BB9A5954F6EABD8786E674085C0783F605F5977F6782E6F859C3,118,138,20,0.2112995473337106,PASS
BF12DF04E4B60EE99CDC6727E8E20E6971F1D414CAEF468BB350EA8E72DE77E7,118,138,20,0.2112995473337106,PASS
3C31E1B01E79DF6103C1F4DBE57F2F46E2C9CDF4EE2A49525F75E8FF9C1B16A0,118,138,20,0.2112995473337106,PASS
97DE9BDECC843C4B0238B8259B0B117CE59183B87858199DF0D49CB08135A66F,133,123,10,0.5319710580974012,PASS
F8EFCA2823906656C89EDB3E2B6FA0273EF26B700D482F154AFF8B74ABDC16D9,122,134,12,0.4532547047537365,PASS
25C1F8CDDDACED0FBB5C7FDEE1BFD8C1DCB443245B44F4F10508FC13AD6BA7C7,116,140,24,0.13361440253771617,PASS
C18B0E4A947550AA8345DE13EC69584CD5A352C680FFE767AF6D4A157A27AD25,129,127,2,0.9005235503397743,PASS
D456FB8DAEE24780AE82845FAC606BD37BCD1126A16F769DA1FA8B8DF5D9F5A0,121,135,14,0.38157390570502125,PASS
EBDF33BFA94F6F4712FF62652532DE4EC341DD897E23915408A9315F0B181E18,125,131,6,0.7076604666545525,PASS
5C440D68DFDAA5C82F11B116589679774CA0A99253FFE93BC25EB8ABFE888FB1,124,132,8,0.6170750774519738,PASS
CEED24C0E101B18CB75302585613D143CC9BC40F3116EF50221C4A4D175BB2D1,141,115,26,0.10416255883043901,PASS
40DAD6DC1EFB19767DB5A1B875E564AEBB1834283FF294D02C59C44765213E2B,126,130,4,0.8025873486341526,PASS
F3090EEC27CC93F98DBA60312F142391C569E274DF28C932E70457CD9570468,135,121,14,0.38157390570502125,PASS
CB988C051C6AB766A110ECEF58D6261215336701F30201E8D1358933CF482CAF,140,116,24,0.13361440253771617,PASS
9E4963FE2E23416830DDC1F03732B1A4D801EEB9F6517A50CEB4CEC3781D0F5,131,125,6,0.7076604666545525,PASS
2C74DF36368BFCDB5D909A41AE1745EEE67AA082FB83933A061446E5E5F67F89,122,134,12,0.4532547047537365,PASS
73081459C5B2F96CCFC1D4BEFC9F47C0E07C9D8D47E5345A30C6F878D43A6AB2,125,131,6,0.7076604666545525,PASS
EA2612904D66A96B5235EECC9604D3725F45BC630EFECF22CBF86CD74FB1DA74,122,134,12,0.4532547047537365,PASS
AA363DE5B615D3E5DD820235F4375B5DDA3B76C1CA152E65DFE7DB5209B79839,117,139,22,0.16913144470267139,PASS
175723D430D84830CF8FA5D9FBCAC1472A3DD0A10B95A54AADC742DFD864D0FA,129,127,2,0.9005235503397743,PASS
5D6C4D7C412EF1E68A50BB1E3B389C25EE4CE9FD02926EFCBA3B3512EA14DFCA,122,134,12,0.4532547047537365,PASS
16D05C2B39C8FEEB4EE3793A5D4022E2338639EFE1686B779247F382AA99D2C4,126,130,4,0.8025873486341526,PASS
6602CE42EAE99F6B0659543B8ED4804CB6CCED48A05859CA8331DABEB0587CF6,133,123,10,0.5319710580974012,PASS
F13DBDB2E3F166820CDC4741058C1830A69DF2EB1447DCD1032A1C2D6EE99409,136,120,16,0.31731050786291404,PASS
CA85AE507D9B2E8C8636BD6D75E2DC5C05A6FE72609C3CFB44135B874317D7D0,124,132,8,0.6170750774519738,PASS
6B6A65A03B16DC1A3322FC80E09052137BE01AA3238906082BE44D704C3F23B,146,110,36,0.024448945310089426,PASS
1E0C58E39030BD71588E2A25B71E5638ED8A5342D96A7894AE7928C550AB2657,136,120,16,0.31731050786291404,PASS
106ABB6C4F76A1A07646A891B5A3A19FF10A6CC5AD96241DB2D51629B9A0A135,135,121,14,0.38157390570502125,PASS
76A6073A28DC50EEDE9C7C4B87E04B19FD78F72D1A8F52786AC47D6568112F29,125,131,6,0.7076604666545525,PASS
1A01D378BD787501FE443AAF7596B045E36E369F4FEF68A2238BEA464B0512ED,126,130,4,0.8025873486341526,PASS
DF66E5E587F4EF5385831EFF99EF5CCF89E753F169239ECE799BEE7AE8A0EAFE,102,154,52,0.0011540500847815347,FAIL
1E40E7BDCC2F72FC77450651C35656765F42428843F57B0A174D70EFFBFA8880,126,130,4,0.8025873486341526,PASS
9FAB2DFF1E38FBAAE2AB61FD49D5D681224EC07B4AE3AAE857877A329CFB5D3F,112,144,32,0.04550026389635853,PASS
C9B391900B43B3456E5F6F46D7632BC45AF9EB312CEAC09F3F87C2F0892E3132,126,130,4,0.8025873486341526,PASS
FFE3144C28BD6DB545EE368FCEE3ACDB9AA1E21C5DD1B431833383F96A2E9AE4,120,136,16,0.31731050786291404,PASS
B979EE77B757D25897415B64F74634C1D11A62354E570EABAF1FCBCADEFF467A,112,144,32,0.04550026389635853,PASS
9A6649A2F47EEB5851767FAEA32C4ADD8C1F2777585B0BEB39F1F618EBCA733E,114,142,28,0.08011831372763423,PASS
D6639DAEAAE36AFAE5EE5959CB5CD894BC1A4337A3216F26AF722B77F41C96C6,116,140,24,0.13361440253771617,PASS
9A0577B70DF901042834435A6BA184FEEA55EA0EA5EEC040746B3C0D4538AD8B,137,119,18,0.2605890342736178,PASS
489D5AD4A76A2CB5C130B6720A0E802A8A485C9BDD446D2AA0217A0F226AC9B1,144,112,32,0.04550026389635853,PASS
9CEA981DD8D972489463C6871995E7586EB55A8EDB2264A185F5FE712CDB870C,127,129,2,0.9005235503397743,PASS
E898B65F4F8DE646FC8AF8B9C6B10AFA4F9644F3856EFD6B2AB2347A627D5082,121,135,14,0.38157390570502125,PASS
7383C0C5600B4788A2565DECE7AD8155BFD24A1F7A5E7436F3F1B1E57439A3B8,124,132,8,0.6170750774519738,PASS
6B96F534E7FD8B2BEF8210DA2D845D56D307A3D217FA34F65C25F1410785A666,124,132,8,0.6170750774519738,PASS
DEBFA97F891C49CB381664831FE999C4946601E7758287A1A92A7E6C4F9E48D4,128,128,0,1.0,PASS
B85E241AFFD5DD92BEAEE6A95B6B6D6F3DC9F66721C5AEC240AFD3873868F451,115,141,26,0.10416255883043901,PASS
140ECAD6DA7BD222ECF445ED0472572F0CADCB71CBFC2046E95A7F03A7268AE7,125,131,6,0.7076604666545525,PASS
FE50017B2780B79BC9D5CAD72C255556A810C53C234B008CE01C5B77FB21A01D,137,119,18,0.2605890342736178,PASS
7F4EF0113DE4C7AE565B96E69E321A07A346A3B0165289534E2987CFE87F725,127,129,2,0.9005235503397743,PASS
535E162391F3146568ED7DDBA41729A387F8C665F5E7F394B4BA0B43CCDF951C,120,136,16,0.31731050786291404,PASS
62F78044467092B11C61AC766325C21B7C085A52E6A7579F235A267B3B3C3AB5,133,123,10,0.5319710580974012,PASS
DA6EA47C756AA9913001B0E44CE5AC50EDC5ADAA4601EC3A07E6F70A4D689040,139,117,22,0.16913144470267139,PASS
F2F56E7AC3D512AB3656C1962AC95C9FC712C9E73785D968A1BB67EDFB5D7FD4,111,145,34,0.03358661289689768,PASS
3A8324FD56EEF56A6A83970FB5C3B00BA33A26E230BB7161579670903E3F6B56,125,131,6,0.7076604666545525,PASS
C1763123284DEF83FD987A7333394BCB190C2EE40712D9164B3F9625D243562,134,122,12,0.4532547047537365,PASS
FADD46B0424608D5BAE877AA8E49B7671F98AFF512C7A094CBE411FFF10ED88E,123,133,10,0.5319710580974012,PASS
9ED22EC2513C3A636017A27B002AE3663007EC951D6A69884D15AFEB49D91948,138,118,20,0.2112995473337106,PASS
3B336811DED8442E790807D24854D4581DA3021C039CAC542EDB849AD6D8DFE5,139,117,22,0.16913144470267139,PASS
175C3FCEF2A40502F4C4D77A280DCC507D34FD4B4ADB43C2DEB6ED4DA7605D6E,123,133,10,0.5319710580974012,PASS
80EE99E2BC808545C171BCD5E9E73301383FF2B8E5C7C2B8F0037ABD451D31D5,129,127,2,0.9005235503397743,PASS
27D8F39FA688F773DA489D8E29BBFB9C2BE59593A6B46B4BFC90A5ECC1C2D49E,116,140,24,0.13361440253771617,PASS
D49130D4895FAEF4D70732045233FC296587E75E0D69A9EF24253816F69BC72F,126,130,4,0.8025873486341526,PASS
90AABFBDF3C3C09E0FA19215C800203684820D6E8A19EF2AA9AB2379DBF55689,135,121,14,0.38157390570502125,PASS
595344176C212FF2B831E0D49FF770BF98446DDA861F202D4687D8D730BA6873,129,127,2,0.9005235503397743,PASS
F0235B8346CB901E912B4013F76E5680385D7D5214C042100F3D268E2982694E,146,110,36,0.024448945310089426,PASS
76465BE8D0E229BF6CE27E69E4B4090E5DA973C36A84F8B32866D0E60C90A706,132,124,8,0.6170750774519738,PASS
87133BADE7833D96AA97C17942AB924867D63E350F35A0DFA23818AAD66DAFA0,126,130,4,0.8025873486341526,PASS
9B5A1A2A7AF4212FAB7C74E22A7C190AFA3ACB0A9C425C61E31188660EB9F3F2,131,125,6,0.7076604666545525,PASS
2086BDBBAE77CBDBC1DE08BD23FEAE1601CB0CCAD3A733A2C924A3AD659577C3,122,134,12,0.4532547047537365,PASS
76896FBC403B8DC5F62562903DF15CF4B9D815DCCBB5B2E28C960F2C061C17A6,128,128,0,1.0,PASS
1FF59DDE9376BE63A1ED37637C20ADFC0BEB990D35E806120189298B80384DB1,129,127,2,0.9005235503397743,PASS
B06CFD8C83049CD08EE541290FFD74A87AF076F29D3B1DE3C211BAAB2F56AAB6,125,131,6,0.7076604666545525,PASS
CA7009FA2E0BE2048250991AA32BF084BD0CB3ABAC9926641BFB4D62AB05EE99,137,119,18,0.2605890342736178,PASS
43F116FCA37A7E4B3BD3B58E41FEF45A92061F0707205EAAEBA251446217EFBF,122,134,12,0.4532547047537365,PASS
807516C9783318DB2BC4D0E3E421344F8A544E8BCB743245C08DA6A6C18190C3,144,112,32,0.04550026389635853,PASS
931F88C3B2BA78FAEA6693E07632A7D68FDC30D638807AB9883DE9581A734AD5,126,130,4,0.8025873486341526,PASS
AFCEC965F2CD4424F5CCEBA9A7DCB566DB2C3DC0F492460A8742B5BAD46A2681,126,130,4,0.8025873486341526,PASS
97FD09AEEAC6CB0163B5884EE3024EE476CAECF7AF01709DE54F173262DC5A91,125,131,6,0.7076604666545525,PASS
19A7286B6BE105E2BA03E7E1C76CE429CA4609E487A368367CF12462FF9ACABC,129,127,2,0.9005235503397743,PASS
2D300C19309150995CBB63E01A570EE19009DB1CAF875192AC667852BE1F09CD,140,116,24,0.13361440253771617,PASS
19802596E62BBB564F047522F5CF7A7E95A960D66A1D43EE202DF1BD43E324C7,127,129,2,0.9005235503397743,PASS
4B47A2BC739A1D098EB8E703828BB00BD836B36987AAEBD532D821CB62A95686,133,123,10,0.5319710580974012,PASS
98A4DF6F109014E4E1BB2E19E4656874E98CE62061D9723D53E443D71CE9FFA3,128,128,0,1.0,PASS
A292AA432A660721124E324AB854644AAB38B59842615F7496FB73668D8D0A3B,140,116,24,0.13361440253771617,PASS
4272A81065F14B49775F74DC4A4FAE842CEBA08440D00D96932CD80A2A764A5E,141,115,26,0.10416255883043901,PASS
A9DD61516092D9F23D76450E997FC89EF9ABD2704DC38F4C407DC293F02E02B4,129,127,2,0.9005235503397743,PASS
19C7FF62785B41B74B99886736D810DBF7AE82498CDADC13292D7FF29F8D34E5,120,136,16,0.31731050786291404,PASS
4DCF3F3726A6EF54056305E858207861F1BD55EA9F5E726DE181FBF395854CD7,120,136,16,0.31731050786291404,PASS
C9F7222CDD039F80196C665DD1BB2F4E3F0E092BFC1EFB4525CA1F7BC67C9512,122,134,12,0.4532547047537365,PASS
52773A67F5FBB912BE69342C0E4D3C4F4AA8BECF86352C531334A5517F18BC8D,123,133,10,0.5319710580974012,PASS
FB1691AD8BCDBC1BBB01CAC454F20002E3AB2D36FC00E886345771F59DCC86A5,132,124,8,0.6170750774519738,PASS
7BD20EC2BA9FD027C0220D74EE420FA6A445D28116F20408F088A12FFFDA6469,139,117,22,0.16913144470267139,PASS
1144E21F113402B80A2C231E489A951F9006E6CA9E1D2FE839CE3E6C8226860D,146,110,36,0.024448945310089426,PASS
CC9D2DEF558C8767D66D6E4BEB68B9ECD4101903A7C1A56753D661BE25E6FB90,120,136,16,0.31731050786291404,PASS
AE83BFB308307EA97C2F5700AE571466AC9E1A8CBF8845D7304FDDE419BE9E5C,124,132,8,0.6170750774519738,PASS
A5616B5CEB6016CB3EA37C4F65BCA3E48AE673C888D95A726F9E16E4591FB980,124,132,8,0.6170750774519738,PASS
90630CEDD2338CF10DE123C7CB203B4F9DACD3525FA73808A866B296D42089CB,135,121,14,0.38157390570502125,PASS
C7B5CD792AB55369D5FAD24A2C61E8144957904B6A804B7295A9996FACD68473,129,127,2,0.9005235503397743,PASS
BB58780282289384DF790821293DBC6D6320AE769C08407455850483404E1913,152,104,48,0.0026997960632601987,FAIL
D23BF9A14EA77C02DE87DAE28464EF13D7B7B3293613F9D9D3188929E655658D,121,135,14,0.38157390570502125,PASS
5335227CD48F7FC40A4B13ED05DC8A531F2DCE3BA7CD34FECE33AF9888619973,122,134,12,0.4532547047537365,PASS
C9D89F1653CBCCF2898B566D2BB4BB4577478F13D72A6AE604E0935C432A6641,128,128,0,1.0,PASS
C0C3D1B7A10FA9C3E9C90417653B328BD505137D1582D32F7CC28493AA29F1D5,133,123,10,0.5319710580974012,PASS
D8DBE8F93D76AEC42B0F01370134199888429C7D89076E49C9F32368CD37EA17,131,125,6,0.7076604666545525,PASS
F1DEF8638BBFD47ADBDA251A9135BD702E3BA635149ADFA2F00F7EB267BA0670,117,139,22,0.16913144470267139,PASS
B35A75FFD22AFAE51186D6EF782C0D96FD88C3560FE91E05F57FB7F51DB3FB73,107,149,42,0.008664896726025117,FAIL
5A4370A357286C9D86EE0DF667359AA91832916C079150A2ABBC5783FEA6FDAD,127,129,2,0.9005235503397743,PASS
CEFD57E34EFD117F8842B46DB0EED6F7EB077EA912CF7C0D778459F507A53D7,112,144,32,0.04550026389635853,PASS
7539F18D61F49068EA4DA9DF023AD538307642591D4B92C7BFADE22966C30775,128,128,0,1.0,PASS
66B32CD1C4269FBD5A3DB9B74FD90BFE525DD5FB1ABF1DD3CC81E44F5608B024,118,138,20,0.2112995473337106,PASS
C8A36EC678702F9745CA5471F286BFE87068B2D689839C6DA7E59BA1131D9CB5,126,130,4,0.8025873486341526,PASS
4C891B0327321701D55E2624DA36E95ECDAC5F6F6742903314731DAD87D7E035,131,125,6,0.7076604666545525,PASS
5E69918DFCD156A0D2ADB6BCD93B87AA46F99EF76F48B007799FDCBDCC3F734D,111,145,34,0.03358661289689768,PASS
3196624DE1CA88CB81E8F7AF71DF16095A074D073A4427B1F9466E8F8EA262B5,130,126,4,0.8025873486341526,PASS
6EED075AC116DE7FA3B0FFE73356041042376411D884B2B39235D29B76806049,134,122,12,0.4532547047537365,PASS
421F240C0B9FE07A56529C51061140F46804BA5EB47FC70740BF2E5F5D3D5366,135,121,14,0.38157390570502125,PASS
C9D3F2C7C0D7E301222F42C444ED458A22996927A08B900C74AF40BC7D00241F,144,112,32,0.04550026389635853,PASS
8C29D1972349A7418C570620145A33C8E3583D1905F4C2BE61E05FEAA83F17F9,136,120,16,0.31731050786291404,PASS
FEC7E13DD215EE85FDC342865CEA71F2BBC405AD020DBB7DBDF5F8F373147185,116,140,24,0.13361440253771617,PASS
8E48298E9E4A711F4D21C20C188A68164FC63A648B3CDC7566609834695AF8A,143,113,30,0.060792723530522785,PASS
9ECD1B08E6A74A0F48666DBA7F12F0372F915D9F45841B9220AA5F7046239205,134,122,12,0.4532547047537365,PASS
26D73AB39AADDF5DA18664D895042008C7DC7084CF7E3E2C3FC4CAB507F27486,129,127,2,0.9005235503397743,PASS
8A0289BD5FDAF48321A2C490DC281F2805686DAE5660CF89D5B117DAB5572045,138,118,20,0.2112995473337106,PASS
2BD99FE55641EA1B6E0223AA9E65D50E54E5AAF0C12C26D3A6552C6F75792001,132,124,8,0.6170750774519738,PASS
51D50B2EC7B5AB2F084BF6501BBBEFB41274D50E8DC9D4472A8BA589CCEA6114,129,127,2,0.9005235503397743,PASS
B0465C674DE0563E5BFBD5817DEE3EA033A7011BA3EC2A7B2DBB2EA8B20D3538,124,132,8,0.6170750774519738,PASS
2EF8B9390B9A310BC5DDBE1EA013A5744EC0B9C418503EFEAB5BCB67460323D,131,125,6,0.7076604666545525,PASS
9B994EDD9EC452EAA311BE1C5590874585EDFE4A711743366AF8F25EA8481F11,128,128,0,1.0,PASS
4BC11DBDFB5DECE3F85CE4C62288B86FCF40220EF863C86C9C8C0926FF7598EF,123,133,10,0.5319710580974012,PASS
F620D7B562CB5FE0963335BE53FC1333A9FCDAACAE15FE4F9D23D7D3B4C49CCB,112,144,32,0.04550026389635853,PASS
60BE8AFFB5C81EAAB296781E4F74B05AE1511699DF502A11FC91C0D7A7A48AE9,128,128,0,1.0,PASS
40DA162F2CDA6486F6F5C8FBD4E4C4CB637A8A9242DCBC0834D2BD523CF06451,132,124,8,0.6170750774519738,PASS
E8E953BA8B52E60ECC21735FF26568D8D2E10D1F26DAF5CEA796D612B5E5C513,122,134,12,0.4532547047537365,PASS
C6404A3A8F249BA4CC62A505F1307CFC5D3B9150586A28E392FF31A510867C09,140,116,24,0.13361440253771617,PASS
F04F3ED67F36776B6E4CD8A1C9A06FE2D5254619C7C52BA02C358658B3A9DF6B,121,135,14,0.38157390570502125,PASS
7A8EBD287A8023FD5738D63DA6C360B8ECADC48AA10858E3F489A7E640A8AD3A,132,124,8,0.6170750774519738,PASS
44CF208F09A1787D56DDEA54E0CF989259505AAC675C5E96C56D90B925D1C790,132,124,8,0.6170750774519738,PASS
2789F21C535AB8246970882C4CA79B86BF65ED4A22695CE9B7179F4CAEEFB474,125,131,6,0.7076604666545525,PASS
63424A1A5594AAA5D6E18F28AD02DA8559400FF798772E607D711EE09F34D2FD,131,125,6,0.7076604666545525,PASS
7B70994FAE7BF2FCCB6AEEBBAA227C614DDFF112EF901049FA449F3DA9C0190A,120,136,16,0.31731050786291404,PASS
A0EAE8A1B2421C4EE7173D297E38F8BA14FD09F5890C4A066EAF4B1227C8376C,132,124,8,0.6170750774519738,PASS
EDEF67A0D110A4619B9018D8F23C752EDF11EF5F803D7EB973EB990C1B10AD56,124,132,8,0.6170750774519738,PASS
569EB996E4C3C2F86D412DE947999AA547723C6C345D089995FCCF030E29098B,131,125,6,0.7076604666545525,PASS
125CA0DDCF85AFCDC888F8592C8AB0301A1839B8CBC4079B72FF57778BA7E5DF,124,132,8,0.6170750774519738,PASS
3133B64FCD82140B01890ABE759BE79C5E4BB9E881305026D1167B59C2E1BC1,138,118,20,0.2112995473337106,PASS
C88CE3B9120A099E8C63811094A9AD276E27035617EB9B1841C117B560B50D43,144,112,32,0.04550026389635853,PASS
A032AAC6CF92C067D2E2F7989B89A4BC7F770F815612AEE8D1191BDA1ED0ECAB,126,130,4,0.8025873486341526,PASS
61BA4B9E0408A4EB26E9A21B36155127BFE9479B2507635C0F26A47BCDC0CFE,132,124,8,0.6170750774519738,PASS
3D491832A23A171391B64149CC352E08C3D5F10EAA326648533004B6ED52029F,145,111,34,0.03358661289689768,PASS
11E7FEDE48843F4A05FFDC099E2DA102E92F928ED820C842872C2F1F8B8AA873,133,123,10,0.5319710580974012,PASS
4E74DD50D39B9A065FFAC31B8181A1D46E1AA9F6D61D02EC0601FB82DDABB531,129,127,2,0.9005235503397743,PASS
F4922A521E6DCFBA5262650AB7D58F895265DD90DBE1E9A1C2617138ECD85F29,127,129,2,0.9005235503397743,PASS
91DEF53D15143C81594EB0F065587400C7FB141E91A3A079CB8B0256DAE54490,139,117,22,0.16913144470267139,PASS
50B2BD1A199521210943DC3A47A0AEF7FBA21E37568895FF2311A9399D53548E,132,124,8,0.6170750774519738,PASS
3C3D52FFB1498EB5B04E42314B1181E8C5F4A39406829EC9D30D4B601B09D824,141,115,26,0.10416255883043901,PASS
BBDBF179E842538031FA505431668C2B8BC66AC4FB5D77DDDA07FC42E8EC8C41,126,130,4,0.8025873486341526,PASS
,256,0,256,1.2777508801076536e-57,FAIL
972038651E07E6C5C7A196E48823A9446BD4CF4EB3D310B0FC717792A5A1D232,134,122,12,0.4532547047537365,PASS
C77D70FAF5E9863B5987B7930B2285EFBDC3F8B94B296B043418575C4AC60CCE,123,133,10,0.5319710580974012,PASS
EDCB835409DFCA4EC69A8F90288DA43543CF3E6A2ED8DBADCAA7DDFC7F1E413F,117,139,22,0.16913144470267139,PASS
D159F7D5611832C87E1B51C57190FE114EA5DBE1A6F3FF5FA684A09CAA5537EA,121,135,14,0.38157390570502125,PASS
25175968AB06E79E70656BDC4C7A6178ADE86559FC6057DE2167EBF5D6DA3E0C,120,136,16,0.31731050786291404,PASS
100AAD4280F1025150900A7E84504470BB2482A800F3A73CDCB9B12294263FDD,153,103,50,0.0017780505982168669,FAIL
D9F99444E68D994EB67E9DC0942DDAC406A389B225B209CACA35E2937706C271,133,123,10,0.5319710580974012,PASS
1C4C6D9DBA603A4F9C5D8FA9CD47B36DFA518E897945F1A4E6CB917400445AF8,127,129,2,0.9005235503397743,PASS
4CBEE4FC52908D5F209846BDD9378B4BDB1AAAC8197F57FD404F58077A978E0A,125,131,6,0.7076604666545525,PASS
A91555833998EDD3BE304F0A671813F3C122054045ADC8F9A85B96DA07932484,140,116,24,0.13361440253771617,PASS
5CE666893845104B59CDA8E8B5B8100927A23DBD22A07EF15C7F485F3661D34A,134,122,12,0.4532547047537365,PASS
8136BB7C648CFB5FFD010DDAAF8626B1F736EEB7FEA4D9F7DCD6585AEE8749FF,105,151,46,0.0040402749798920095,FAIL
34A976BC52182CEAAD07521ABA7FBD78154A4F617D3C08005D6973708238F905,135,121,14,0.38157390570502125,PASS
3660B4F8F9794CEA60A11BA272A15C7AF3EDEF86D90A4374DE2ACF01F1D97C73,122,134,12,0.4532547047537365,PASS
CA2D33F8A0776D28897AC3B74267F6688B1B524325002323D5A569CCC74C675,135,121,14,0.38157390570502125,PASS
7B6B5E53C789344EA25CECC25A36C2C3B2057DBC96B86AF5C45B92307F71043E,126,130,4,0.8025873486341526,PASS
897A37BBC75BBFD4E126E40E5344C60C01DFCB657BB34BA9ACCACB923BC6DEC0,121,135,14,0.38157390570502125,PASS
B4A586A67805D926959A14E5AC58937A428EE448CB24AD43794EC7CE4EFC289D,133,123,10,0.5319710580974012,PASS
FE6E2F801A9BA00CB7C26687ACD8868C11E49068118133825DD4782ABB572F8,141,115,26,0.10416255883043901,PASS
1645C6A9F844F60B0F37EAB1ED8F13F1E1DD898AF130F3E5E8D253EA683CD700,125,131,6,0.7076604666545525,PASS
B817EC1EE7F10D33F627FE9779DC8AEBD94FC9ADDD7D71C48A82AE8DB94EB7BC,108,148,40,0.0124193306515523,PASS
18B56591190BDF05CB10886E969FBB3234207029A7541F54DD2BC1F53DF72928,133,123,10,0.5319710580974012,PASS
276B676983C4CA4ECB77EB22ED7A9E41FFBFEA2DA3A09FE6C1BA4999E3C398F4,114,142,28,0.08011831372763423,PASS
C3FCC6499CCD9C0AFD6B37983D26A046590BF535E0B3CF3260DEFFDEB97AA604,120,136,16,0.31731050786291404,PASS
8F42885A996543F959256F724EFB618A98906BAECC2E6AD34BFC24D058F9191,132,124,8,0.6170750774519738,PASS
B2B18F66CC3F6F0E507ADACC883694316B564107F1329B181681D69EAD9D4DA8,131,125,6,0.7076604666545525,PASS
955A0C6FB73BDA2DEAC99ECF78C258D5FC20A76F27CC57B4A14D25AB3D174EDA,117,139,22,0.16913144470267139,PASS
F839C14D8B5A73A471FA294C755BCFB0EE1AD223E083582D32ADEFFECE056489,125,131,6,0.7076604666545525,PASS
4ACD3F7F85D56B7615467A27D477C3962606FDE6C8962C5C65C9FDC03B1E19BA,119,137,18,0.2605890342736178,PASS
9D8FE85A03D862DCB3E3BBF1EB4366AE869904D428CBF80861458884FE176F5,131,125,6,0.7076604666545525,PASS
D723C5BE3F52411AF4B68647EDB0F72599225AB00460E5FF51A4E7CCC8A24388,131,125,6,0.7076604666545525,PASS
C1E6864E3B6C57447FA8083B583247A9F8B65662BFCC25F54C082DB01EE70B85,131,125,6,0.7076604666545525,PASS
9424A2DEE23A93C5AEAB85C0866693A67EA67333A0726CF0C69A611EBF2B8125,132,124,8,0.6170750774519738,PASS
86370E1CEDC9ABDB6B664FB066B9EFA6E399B1BB4C6CA9DE6506F5CDC39FB29,115,141,26,0.10416255883043901,PASS
FA4B1E181EAA87A729D2FB3E32C6E8A7AA229ED59E9CD95EDB2958CE422C54DB,122,134,12,0.4532547047537365,PASS
51C916DD53526DF00E00D2BB5340E89C2A5227AE74F00F9124DD417661E39162,139,117,22,0.16913144470267139,PASS
A5FF3CC87D947EE939AAC14D77B63DB2C8785435AF32782719F9234D3C30E49C,121,135,14,0.38157390570502125,PASS
E5C56932C72C003DD7A21125162C49EE54BF01CD6C9E05F1F01FF487FBA635E0,130,126,4,0.8025873486341526,PASS
55331D82F163F4FAFA751D9F0A73FADB9E3E32145EF23FCCC86F4BE4840C4D9D,117,139,22,0.16913144470267139,PASS
DDE0AF7C113926CD14F7DDC2F365304406CF66FF87967B81010603A2BE0881E5,132,124,8,0.6170750774519738,PASS
111F024297AA8EB012775955F61787963BA66105A390AC31EC04D64A5D91BE3C,137,119,18,0.2605890342736178,PASS
232C6FB33031C9113374EACB97726883D8E29D7EC6B923C2FDDD36EB1A006C3B,126,130,4,0.8025873486341526,PASS
491D30F7475C15FD19B6761C9B589A7B05F9B9933592B43EBC7E7966B20E2B78,120,136,16,0.31731050786291404,PASS
E9247DC290DE2AAF80F3160B76E0F3ACE7ABDFC9586C92103A56E0803D092D2F,131,125,6,0.7076604666545525,PASS
BEED5E8A38CE281EBFB695B30D28E0C122A16DA1A2F44785BEA06C155DB1B70B,129,127,2,0.9005235503397743,PASS
2F879A4D75D586495BEBD4E7BFF8353A1149A8543EA867D41F8B8283234ABDED,122,134,12,0.4532547047537365,PASS
ED7769308B1034970BD2DC626EAE1EE12C5B9AFD0375CC6F95BA6ECCD89992B9,122,134,12,0.4532547047537365,PASS
2ADE5C32BB29036A395A0EA075C4F40C877009CA278707517585474734F62319,139,117,22,0.16913144470267139,PASS
6EEE71F4491F786F3BF271A8E929609BA3DF30060EB579E0370B2ED972402E99,125,131,6,0.7076604666545525,PASS
,256,0,256,1.2777508801076536e-57,FAIL
BB9BECC79F18321074B483452914B82FE8DD5787D0367ED0821B20E75E0D2A15,133,123,10,0.5319710580974012,PASS
403DFD81AD00B916E82055FF6DC1DE211431262F43D0883FBC3206B92EA059E,140,116,24,0.13361440253771617,PASS
B479B3F81C3552BD9343100740FC4B643B9C98320B2384A09139F42506FF99A3,138,118,20,0.2112995473337106,PASS
296D8FE49952BD8BF1750E619EDEDAB92C2C8CE9E599100F71966E634DB38C98,125,131,6,0.7076604666545525,PASS
4F2900FA827DC39E68C9C1AEFBB67B30022824F0CAE1939C943A59F02BBDA8C0,135,121,14,0.38157390570502125,PASS
7E1F332626F454C5A4B3D2104926044F9677BB7956ECF9E6C61F0AE7FD178A54,123,133,10,0.5319710580974012,PASS
8B8D67E678E908D1E263A625291F96ADEEBBD30FC2931843F185E43FADC493,129,127,2,0.9005235503397743,PASS
852CD9754192A6366E50688D6C44E27C7D54B80029342C7074B95ED2B74BE635,136,120,16,0.31731050786291404,PASS
E183A43CDEF82B2FB64B8BBA30C29F93C8FA09CAAD0078B87D6488F7AE4AC87B,126,130,4,0.8025873486341526,PASS
98633D82A7155435AB6B5C581BF552BA772A462AA97664928FD946F4D4F02B91,129,127,2,0.9005235503397743,PASS
E624DE0EB48007A9F89B5BB222AB51584BD6BA026F024CC2B87FCEB1F28BD633,130,126,4,0.8025873486341526,PASS
AF0B9C082F4D6A3D8A16551A57639F0172EA473EC36C16373343395AB4E12C24,133,123,10,0.5319710580974012,PASS
DD5D35F58B97400BA8B47E282F588B40958D1B7CB3330086741D644C245FB3AC,134,122,12,0.4532547047537365,PASS
F8BFE4114E9E483873B0F8CF7935F2ACD5A0B40AC839B8061CC8B8ED5FDDC237,125,131,6,0.7076604666545525,PASS
C8574A64EF02364D90B39A416BB534C744B7CD3961D5B16E3D3E8456CF51410E,131,125,6,0.7076604666545525,PASS
F36ADBF9D5FE68C53D69044808EB0993E9C515E71DAEF9347466B77D558A7B2F,116,140,24,0.13361440253771617,PASS
25786E17D32E99B80A38EB7043E135754A5AE2C4800699151F3C763F6594C95C,134,122,12,0.4532547047537365,PASS
480E09CD41D24D79CBE38ACE71E2E91EB1917E615CA80F56D6BAC118ADF541F,131,125,6,0.7076604666545525,PASS
95E29DBE7F194CBBE5DA547C4CE09C2F8AEAFE9A721FEC0C6E8DF57F97CD58F5,109,147,38,0.01754895019147673,PASS
43687E4BBAC1DCC4F82C18642285C4512BA685656CB2503EF103AF50B06CB021,143,113,30,0.060792723530522785,PASS
84A327F57DAA896D71D0CB487E27A244F5CAD6882AAA36FAB129B326A8E323D3,128,128,0,1.0,PASS
19C7B1221D7BCCE39629C3AA735E11DBA67DA57B35E1A563DD3160E24E77B63E,119,137,18,0.2605890342736178,PASS
F09074B26342813B45322C84AE5C2A6EC503B5EA66FD826D568AFD063373EEED,130,126,4,0.8025873486341526,PASS
73CD04516CCF08724BF8CE2227D853787D08A95C8DDEAAC0F54DFE29012B4975,131,125,6,0.7076604666545525,PASS
A3EA63B686B8BF1AD539E194531D06AD5B7D8535117B6D02B06848AFBCCAE6BA,125,131,6,0.7076604666545525,PASS
6A8DE47EE4F5CAEE56CFF316F266CC68C2F85273CB4AC8D36990647C58FBF372,117,139,22,0.16913144470267139,PASS
22848068B856EE6F0C2147D3748E944E10AC12AF97ABCC9F19B2F25B0FEC781E,133,123,10,0.5319710580974012,PASS
63A535B91B4F722AFC10195D08BE790B4D2993584D9AE5B5151B3963C1BF4D6F,126,130,4,0.8025873486341526,PASS
D97ADE9D5E276766AA1510FDF4BD239060FF9C8973387A31AE68E957AE5D7DB7,113,143,30,0.060792723530522785,PASS
ABD6238E54265FEC7732A214591F6467B99E89FA8C29AF519527BCD3E0325F84,125,131,6,0.7076604666545525,PASS
528254F6F1831601899C72A29A188E24EE85FD346C1715A6EDB2E6CF30469F55,134,122,12,0.4532547047537365,PASS
D20D35FD59C85BD9C593A5F4D20BE434EB09B3933746B6A61C19D60084069B8D,132,124,8,0.6170750774519738,PASS
90C22BC7D345A71E3BBD96C1432D635FCA71B04673CE22A1AC655F91B5FFE309,124,132,8,0.6170750774519738,PASS
B61EE6EAAE74BA969FDE9345C7B911FDE88E944F8A9864D10AD19A1F11DE7328,122,134,12,0.4532547047537365,PASS
AD1F06F679C77C779FA90244A9B53EBC6CF651B07DAA73F433AA75A48D582C1,122,134,12,0.4532547047537365,PASS
CDF48CB84B13274A5F698EA6DCC946E45759DCC1A4C27AC3F24A3A7D01EFEFD8,122,134,12,0.4532547047537365,PASS
C74A3F17014BE6B5F314CC5205F2FEC208811CABFFB5EDA59A31EE3AC3E336BC,122,134,12,0.4532547047537365,PASS
2F246B81D4EFD74A9D37A64413EF0261B3CF876CCB183529FDDD15AE7C693005,125,131,6,0.7076604666545525,PASS
6388294C5F762D3F8605ACD29BF3A0FAF8D5BFE997D1AAC769C610D53B1E46F,121,135,14,0.38157390570502125,PASS
FC8506FB22F9C62DA74191C30B1888DB927D699C2A5AD5A9638B3FB414999DAB,128,128,0,1.0,PASS
49C9E22B2746A293B3047B85C7E5A7B2E5C25FB6F5B23ED7146C6ABB8534BEAD,120,136,16,0.31731050786291404,PASS
47D173177ED7001370BE3F07C3701A966AC79EC5759321E5770AC3905BB4D84B,127,129,2,0.9005235503397743,PASS
F5AF5EA70D2FB7D793B405FAE16114637CEF60123D9D570C1E60F1BE05FD2332,120,136,16,0.31731050786291404,PASS
26CA73DD709C5324C5C4468DF87DFE69C234F8FF8141C30C678EFA22AA189573,128,128,0,1.0,PASS
A3E9F622B1413A1E12DB4F8B0646EBE7D5A71A807BAE1F900CDCA5D4828742FA,130,126,4,0.8025873486341526,PASS
ABA4CFD43197773589D342C1CF6C6738C489F2E1CC04DBE4C934D5A13A69CEB8,127,129,2,0.9005235503397743,PASS
57F9459001F1AD8E173BC09C0F28378D1F602C428E1B357E2B6FBA1327CE39F4,129,127,2,0.9005235503397743,PASS
4AFDE41C2135BBABC8872DDBB9D1F72ED595E7BFFB1F1F4B318148D299D65E44,115,141,26,0.10416255883043901,PASS
61157E3AE169B62DEA54E1E420483F58DEA89F1F136956C29E3D344AC545A3D7,128,128,0,1.0,PASS
A906247E48CF44DDAAAF5B8735BA1FDDF0C61793C22CC9AF810651A7BEB3201D,127,129,2,0.9005235503397743,PASS
C12EDEA7F0EB33CD725CB568CA78BB7805A125A2DD6BE8ADA9157F073456B498,123,133,10,0.5319710580974012,PASS
36200A0767BDD6D55C08A9C52DCE9770BB147DFC87F86B463E01EF049E164E14,130,126,4,0.8025873486341526,PASS
B12B1F3187821EFDB7638B84DE38DAB7225EA01BBDBB5D9DC300B6AD41347237,124,132,8,0.6170750774519738,PASS
DB211BE43F7BCD2ED6F83ED18609066E63453470163E9ECD6C0E6F250751F608,128,128,0,1.0,PASS
3FB3A3C3ED34927725456981FF7E8B5430036C6B583CE907ACD06913E5DF70ED,123,133,10,0.5319710580974012,PASS
7CAA2EE4A6D0962299C630C4F8C7DB1BC527BF36B10A90862DCFA582D3BDDF7D,123,133,10,0.5319710580974012,PASS
4CB0BC1E6E0C7391FA07B607837BE8135EAFF514DD895868BDB0763E9ABCD1D7,121,135,14,0.38157390570502125,PASS
813CD0758B07EEDBAA942E8A4764CB47793BC57A9B139060FDB4BDB0C4C36210,131,125,6,0.7076604666545525,PASS
C771518F1880CF08AF79F746A460CF4D39FBD271A4097124876DC1C7B9AEFF10,127,129,2,0.9005235503397743,PASS
E4B699B99526D3842C8BF20EE0608183FB5C14E7AE4B382AED2839E7EDD0CC42,132,124,8,0.6170750774519738,PASS
BB960832F1BFD6990867C6783C994CACAA97668A73D12EF276845D3C1C2A21D7,128,128,0,1.0,PASS
A636B2F4587C5DAF5F9686158B924BCD51A464C2C737906B098A5CFB551E1C44,130,126,4,0.8025873486341526,PASS
,256,0,256,1.2777508801076536e-57,FAIL
6B698E152C243B855836AB973F584BB9359842B48E6AF6FE9D4875FC85044058,132,124,8,0.6170750774519738,PASS
8E9B73D25B08B78665AFF5325C50E590F95A9278131E9AD9E3D57A44AAFA35C1,124,132,8,0.6170750774519738,PASS
9F95A5563FE3F41115DAA8623873E14D539A2A57F8F0355C20110302727437EC,133,123,10,0.5319710580974012,PASS
C94E10316F170CE0D4AF7E00DA892DABF3B08ACD49E98EAFFEFD18472ABBDBB3,121,135,14,0.38157390570502125,PASS
3FAEE7ACEFB46B5300341747F29BD250370B23C3583CDF863CA836D2A19AEBD4,124,132,8,0.6170750774519738,PASS
65C55F16A41893D01DA6A5763AF9A509C727F934A07EA42E1D6F4CFAC8362849,130,126,4,0.8025873486341526,PASS
EC908B89A84FD744EBEC003640F6155FFE8BC1AA5C84256CA64AFDADEF8EEC3C,125,131,6,0.7076604666545525,PASS
13928728D6DB911A1193230693FCA173BAAEE345CD3A141D573909AE924981B8,137,119,18,0.2605890342736178,PASS
EBA23E580B068103441073E31D4FA1D6CD7E003E13990B99691BC9ADE7D550BA,135,121,14,0.38157390570502125,PASS
F3D050B15066E6321A85D4604D03683C6EE50C45C81ECD44F20AE68529775F4D,139,117,22,0.16913144470267139,PASS
9E0C71904F77AA27D3FFF93CE0B826B5BE8661B74024C95724FD46327B26BF9A,121,135,14,0.38157390570502125,PASS
AF930D707772BFD19F22DFC0DC696EDAB3EEDDD9A4DFA19822D6CDADE8CDCCF7,108,148,40,0.0124193306515523,PASS
8E3FD6806BCCE10B406C4B9F1C74E9F46971F1C27159986BD555373B873FC4C7,123,133,10,0.5319710580974012,PASS
EAE23AD41E5026863C325FDF73C026A42A48696F5E407682A67401B6DBC522F9,134,122,12,0.4532547047537365,PASS
67E63A2B79B646A2688A94AE4C6CA52B72664C0FF5BA150A61782ECD326D920E,132,124,8,0.6170750774519738,PASS
7A81ACDC41A59E80566C4C677139480D01B6A7A4FDD1ABD00ABB7066453AFFC7,131,125,6,0.7076604666545525,PASS
9F25DB1BC55F50DA1A55090623DB081E57A72395ED152D1DA11495E77B2ED8F7,125,131,6,0.7076604666545525,PASS
E5793D3CB97E3A0430BCA6F463DC4F30A28E3786AC182A50A0DF4D2DA400E95C,134,122,12,0.4532547047537365,PASS
45867E1AA84C270964E6AF4F49FE941DC6AD6094316BD276E2F96C0DE51F1B8E,127,129,2,0.9005235503397743,PASS
8E55CB3EAFA1DF9C8873D1CF40F3A2D2E61A934D13A4C441B228635FA9035C33,130,126,4,0.8025873486341526,PASS
6E5ED9E0A9DA1EAF691888A2727EB5FE6A9C22B36E06508258096DE8431A82C5,134,122,12,0.4532547047537365,PASS
3E436F0042366C04527F14B5DCE04E65749B094EB67EF661CE975A9A9E69ABF7,124,132,8,0.6170750774519738,PASS
4152BFC1045D1EC3A9619913B9377FAFD8240CC4CFD69A1875C8D427573CE18B,129,127,2,0.9005235503397743,PASS
5AEFFE32647C11A483EC7A4B773D62EFF11AA914D40FCE9ECFD43592039E5A1E,120,136,16,0.31731050786291404,PASS
E8A91B552591221FCC5CBA745CBDD5D304FCCAA57866B324826CA7530BB48828,134,122,12,0.4532547047537365,PASS
53B22471EB8E54516D95B92A8C7F5CAF8F05FD71546EC1179A3A250008D673C4,131,125,6,0.7076604666545525,PASS
9F896EABB282E934EDDDD949AC7DA9DFD6DB39EFA8C27CB0559C322D25EDD909,115,141,26,0.10416255883043901,PASS
77FD4FE464F410EA626AB147FB1AE94DA40D3D80D60D4BBF6467642CF078CD83,125,131,6,0.7076604666545525,PASS
3EDDE4737AE3D6F821111550A567F6A272022ABBABD81CB2D36E2A6BBC0C982,130,126,4,0.8025873486341526,PASS
EC55069C045F407F20E2CFA3B82F5667A72631C64A9A6A4B4477DE883981FB83,131,125,6,0.7076604666545525,PASS
9944593796B6347CF8CC67A75BEB1FAB17208D5C9CF91A4D4935FC01E64F6545,123,133,10,0.5319710580974012,PASS
B9581BD40EB332307DE3EEE951175BA6AF7337F855439B7B71051F44A083FD9A,121,135,14,0.38157390570502125,PASS
446A68B307ACCD1EFD6724A850ABF7D604DE455DE254A718E1C686C40E6F7275,129,127,2,0.9005235503397743,PASS
8290AD142835D9B52BE08075C8C2C25CEDF7061F4F7E25E1946DD4E2FBD0618E,132,124,8,0.6170750774519738,PASS
4B73690A8377B5E83F788D43454773B06C8075AE35E7124D5AA52D341DE72F92,127,129,2,0.9005235503397743,PASS
E325C18C7A4E53BBAFFA5D3C6AC6FB447FF815890A088BCE9270CA98650D509C,129,127,2,0.9005235503397743,PASS
5FB6D6F8AA39F391C22064C601D4A8088FF75F1F9B5979A4A50E69626150B537,129,127,2,0.9005235503397743,PASS
6633665A2E6EAF070387A23B8D716419D7055275F75FB49898D4EF59EDAD5A6F,119,137,18,0.2605890342736178,PASS
CCA3B2EF8DBC7048102E22B7AFF885C4F8A81082BE1354DA6B4C2D6AF1CEEE6E,128,128,0,1.0,PASS
4369727182E4149C2E2C5A386929E7FA703D90CDC217893901D074C59651BC69,139,117,22,0.16913144470267139,PASS
3F5D82F950CAA4E046EFD66C0CCA23926F88F6D3D3D38BF4DA5046B35C318DE6,125,131,6,0.7076604666545525,PASS
A601BC49C04E0E651B22C50C4E9D01B027D3B61A049831F6517828FC316C5279,145,111,34,0.03358661289689768,PASS
947433368960A47413FB107121AD41CC7B3F794D8BC652525562E193E11B3BED,132,124,8,0.6170750774519738,PASS
386BC1C91836794C07F79194FE302E62F23E59E6001C6F1BC529F63E19E1A8E5,130,126,4,0.8025873486341526,PASS
CD98133096ED3F8BBCEBC723EF837D0FD8309A893F8CBC028394882F63EE1E63,125,131,6,0.7076604666545525,PASS
9E8BDDA4FAA96D1D6ABA96F04EE65A19C5E39C9E80D7EC6BA1A476E743EB9142,120,136,16,0.31731050786291404,PASS
B4E936D520C03C5CBC42A47834AB2946CA339D394FC3C9807D622F1BE0F1B59,135,121,14,0.38157390570502125,PASS
77652EA77EE2ECD5A909D785D1940B90BCA7530D7606ECDB9F517060CC318EEF,123,133,10,0.5319710580974012,PASS
7B76A3EDFE9835BECEC45CF0B07AF96BA64E3110C684956F1A9C9DCADEF06A1D,118,138,20,0.2112995473337106,PASS
AC63A3709E45B2027D2DB29089EFA081FEC58BB98571088EB76DB7A485FDC16A,129,127,2,0.9005235503397743,PASS
72DC7F2046404E3D46F263954A3170C85DC1783FF0812FEE50D43B9F5B2C4F37,128,128,0,1.0,PASS
EFAE17B15363B0B59EA2D00E41977A411E8412351ECACA7F50A1FB1C1A96B25A,131,125,6,0.7076604666545525,PASS
DD8D3215CF00D12D069FB0713811DBB8F7CBDCCB725A70F42C2CA20932C8A376,132,124,8,0.6170750774519738,PASS
A0B9D81DF7CEB224C545A8CDACC16C9D182D9EDC551CE8F0E6D3F7852EBAD910,126,130,4,0.8025873486341526,PASS
3CC1893B490DADB1FE49CCF1805D2373E2439F3FD3BFCF75196C3F0EA8E60AE3,120,136,16,0.31731050786291404,PASS
32B130E82A1D283936F2D2182A3E0882441725491B51133668B9ED881231AD2B,148,108,40,0.0124193306515523,PASS
9E68B75B78C641709DAE0396B698F29C5711D68AC603DB6A29DB27DA7A81C100,132,124,8,0.6170750774519738,PASS
48571E2C60CF232B2F681CB3F81A378AA373715284613FBCCF0E006EB8BFD220,133,123,10,0.5319710580974012,PASS
3EE4F69979AAFE8BE48C103776CBD0314B506C9C81F5C1D33EC8FFC77CBE3BE1,117,139,22,0.16913144470267139,PASS
AA0CAF3E24E8C1E7E91980341055C8799E7E04070C97C17F8F1DB962693101CA,138,118,20,0.2112995473337106,PASS
E04A4892A620232E957BA96D42BC6BFB66AD8C90A70092EDDD2E9615550D3F6D,132,124,8,0.6170750774519738,PASS
85A79E2669AFD5E186B0A62D22EB7FBAD340DE1C878F70E5FCEAD0DA8087DF38,121,135,14,0.38157390570502125,PASS
E5A36A8F53E565F2D557CEC73F6C06D87CE9F494AAF544EFD802EC3BA788FECB,113,143,30,0.060792723530522785,PASS
5EC25C4A7ED3F78E404283BB680BBD24E134A33BD68E069786F3222186E5B8DC,131,125,6,0.7076604666545525,PASS
8A34E7B511F8BA3F21861DD697E2441300E5F6B88D1D7718ECF3C81ECF6D6BF5,122,134,12,0.4532547047537365,PASS
C89B072CA82F67AAD49153F04F455A19D4E83FC049DE25862C89EF7A50743F4A,131,125,6,0.7076604666545525,PASS
839425C2E3A03821C29090F91F5CEE4F8CF3C428CB9E395BF6EBCCC2F7D09CAB,128,128,0,1.0,PASS
EE2B50EEA74FE4B223849808948FFA939BD7AA9ACDA93ADF852C682316CCDC3,128,128,0,1.0,PASS
29F99B59BAD3E9884E5A7511A8BA24CCE89BC1416356212F57D6D3AC87FFEA62,124,132,8,0.6170750774519738,PASS
C31A8919B5570EFEE6035537BA14EF960165B83DCB5BED2FAC7552DDCCD46960,122,134,12,0.4532547047537365,PASS
B6F74219B421482D343655EE4A5E4F5F5A3D1669C0308159D65518BBEB7625C6,130,126,4,0.8025873486341526,PASS
28331282A7DCA162A97D3954A82A434B09F3FFC716C1BC49CB9F7BC4D96822A7,130,126,4,0.8025873486341526,PASS
89371544185EA4E9FA81459761DDC651784C5BBA1744C8E23309A1CFAE966076,135,121,14,0.38157390570502125,PASS
9B63D5811E5A2EBEB59B07DD32903C8EF1FD144A5B6D1E7C298AE3CE092E12B7,124,132,8,0.6170750774519738,PASS
B05AAEE718478A602DC3A94E9E0C4F644C0E916825D24AD0C1780A82E24D1BDC,143,113,30,0.060792723530522785,PASS
1C7C0E87463210161652C49666484F1270E14A5CAFE5C74FA0392544B4ED63E7,139,117,22,0.16913144470267139,PASS
3BDBB679265364B72B8E8C6C6FC7A431DA119F2FBF531CEA6663FC7C7CD8DE38,113,143,30,0.060792723530522785,PASS
2C43CF192E9807A891C6E51C68ACDE1C0C3214C45CDD5684EFD9E927DF35DBFD,126,130,4,0.8025873486341526,PASS
AAA52A825F6B98BBAEB4736A8C861C93F4A64987FFC1A03A58E2ED0C3518A5DA,129,127,2,0.9005235503397743,PASS
25B44B0432FCBACF5DD44DCE481E5A587A077ED30B4568163A2D7902F2BE3EF1,127,129,2,0.9005235503397743,PASS
6284EA398B0F712A16E3D1DCA3871DABBD3CEBC0BE6618AC4A4272F68B76ACD8,127,129,2,0.9005235503397743,PASS
5C7CED62D0CE0F18C4F498D9B2EDF914034EBF9C5CFEBE7D5E35C3FDF1812C8A,117,139,22,0.16913144470267139,PASS
6A4B71BC1C198AF3822AA2E698C0A36DC197D2E4532E497CC823ADC1E7672506,135,121,14,0.38157390570502125,PASS
8A581DF06A556963F5F285E3B4447F76495431D67E5A2A30ED66B39278EBBEAF,120,136,16,0.31731050786291404,PASS
5E8FCC5E10F27441AC86E989B8014E12A5E3E4E3546BB41CB9B7B89B06E9F568,130,126,4,0.8025873486341526,PASS
380056E4746F8716FF2C65FE8AD636488EFE749B5B6AFECA608A7BFC837565F9,117,139,22,0.16913144470267139,PASS
C1DB3759BF2666C41D04A3E2D737ADC1C03E4B41826E5215D40D0AD1CBB0048,140,116,24,0.13361440253771617,PASS
8EA58A3AEB4CB1F1923869D248B6232B130A25C8960693F1D7FAF4FCC25CB234,132,124,8,0.6170750774519738,PASS
A8761BD5E779BB3B61704F03812DB1B7212B9B912AF0A97B7036E759E4FD3B49,121,135,14,0.38157390570502125,PASS
7765D4203D9D3EC603EF204A6CA6B521FECF499CB4E4A26E243A6C67F61BC078,127,129,2,0.9005235503397743,PASS
DCD3324C2854910F7A8F4D784BFB1285A947A6791B06C078FB457429D9C9ABEF,127,129,2,0.9005235503397743,PASS
4500388513046188D22A7F88D4B13DCD889D9898309C601B48FA9DB19C4C95FC,145,111,34,0.03358661289689768,PASS
A59711518C8713310F12E2F226E2F706488244319557BC56058B4C071F0CA8E9,144,112,32,0.04550026389635853,PASS
5BDF5AEA85564B168638C2600A80290B8C21DBD922F0FFBF73C4D3D0392875A1,134,122,12,0.4532547047537365,PASS
D17D2BAE9795351A69F5FF8AA895D53C68B32F8480A56F863592474918840396,131,125,6,0.7076604666545525,PASS
C75C461790DA93AF6047C7B2B0311E99CF87A6742974363D382B06787A472C1A,132,124,8,0.6170750774519738,PASS
A2A9BBB1E0307E12DF93C84BAAC94ACDD18DCAFA86D0F32A165FCC156D5C05C8,129,127,2,0.9005235503397743,PASS
AD8299975CFCB971B3D22B06C6383D215EC2E0EF9D21916F614F2F9B391B5AD2,124,132,8,0.6170750774519738,PASS
95D174AF30C3918DA672AC786BA962249A90FE1DDC0757479D4112CC024CAFE5,133,123,10,0.5319710580974012,PASS
DF8E75B00012A921918793E9C36577545FE7237015EFD6F99ED52B353E901B10,127,129,2,0.9005235503397743,PASS
8CC2D1793F92160162BBE5EBB025B8E9CB6DB1C97D4BFD36483E73DC5A501C38,125,131,6,0.7076604666545525,PASS
93949B924636C64254A0DB52D73BE2376A00BE7D886D5FD3D3C8D4D17CD6B5F2,124,132,8,0.6170750774519738,PASS
C18718A39D102BD1080BB46E77C7FBA73E6676010A8BA8D597F89F8E41F825D,131,125,6,0.7076604666545525,PASS
E3FD9C9ED7E319AE7B7CEE2821522F160413776D8BE526E7AEE2F91A6DEA98C,118,138,20,0.2112995473337106,PASS
E3C6CE09203A2ED635BADFB8434E2F8F56A941C88BA163E608AD13F86863623E,131,125,6,0.7076604666545525,PASS
847403E4269D39C64FB7A7F5493B858709F5E044D28202E1CBB7A2E48DDCAE74,131,125,6,0.7076604666545525,PASS
88E36DFCCF03C5C63D1BDB06C372018C9F31A493E83A372400BB1D5B7EDAA5A9,128,128,0,1.0,PASS
3F952588631E2CB5202AB3780D095ABD2DE39B280BA4B90344B1D40C40214F84,146,110,36,0.024448945310089426,PASS
F3E557E425738B68AFFFF3D9CBE17AD6E99BE6D8DB591C09AB5AECF8B7C8AB1A,107,149,42,0.008664896726025117,FAIL
17A2C7B6A994716D8B295E366374915D51F5477BB3F46A7BA043A521A254BD41,127,129,2,0.9005235503397743,PASS
A77533A680D376A89E232B8CE89915B2786C9E2843C37C324132A5CE3203808C,141,115,26,0.10416255883043901,PASS
7AB6079EC89DB6063374FCD6ED874F72A0F42799E5516F8FC998A1611487259F,123,133,10,0.5319710580974012,PASS
3D5F0441CCB62296DD7366FD9C0AA7CE0A40F060D310676621429CB0D9A2F708,138,118,20,0.2112995473337106,PASS
E58CC4F36F907EC4C7D4F3DB157B03EA0FBE0844949AC6A98E6E93C7AE5799A6,121,135,14,0.38157390570502125,PASS
20D1DE2AA385BBFC47D4CBBC0FA94A578E9A32B372050413BADD7B5E01D9A933,127,129,2,0.9005235503397743,PASS
63D297FEB334CC01AC51D88453540E3C623D2F4FEB878054A5026368ADE0CD5D,134,122,12,0.4532547047537365,PASS
34E7099852E44C39404F6BC1561B4119D569C234347651CA546DE5D64C529424,142,114,28,0.08011831372763423,PASS
2A59580161EE8D35211AA8FC85062125F74B431C0EB869E2E6FE0945E94FAB6C,136,120,16,0.31731050786291404,PASS
60E16478F8A00E0F4BA3A1C8D9DC197DEC2FA0F3421F6582A4BC37D10B9269B0,135,121,14,0.38157390570502125,PASS
BF7CBD259A9B34491EDCB68552DC6E7EA0055F371F4EDD8D19BB1DB6D266A515,117,139,22,0.16913144470267139,PASS
E99A57FF40B958673EE8D03A27505925D9A8BCF65B53955ECE0CBB83B32556D4,122,134,12,0.4532547047537365,PASS
75D9529DE18D6BF67383D3F021277B95FB5AE4811D31AA1B6D77A59FF3616749,116,140,24,0.13361440253771617,PASS
FE19F4D4CF5D9BDC3130D1CA7C2E468EC42E41CC7294896E358FB172B123D6AB,125,131,6,0.7076604666545525,PASS
F247D3917969036ADA0F78435784FC43347B0BC1E747DD7B73C52F408CB27AEA,123,133,10,0.5319710580974012,PASS
6182CDFAE260E897DB434A81F2A66F5489ED03F7B439155C86C7F87A9A053405,131,125,6,0.7076604666545525,PASS
C5CFAEAF89F24D532A644987AF2BDCB86EF78DC6B9D646E3C6397339B467E6A0,116,140,24,0.13361440253771617,PASS
87F757BE516B1E46F2E13DA1B01740B8AEF3882B4541AD8029C368BD7DEBC964,127,129,2,0.9005235503397743,PASS
E598295F729C0D6395A9708BB5DA81FFA8190E629F44FB995741C3262F63BEA5,125,131,6,0.7076604666545525,PASS
C4A0480AB9EAD3FFD2569376AA79EB0445483DDC9926834E4728E8A41B743225,135,121,14,0.38157390570502125,PASS
4F3F20EC20463643CBC296260B44E54A47A17C62FE1496449D9368A1835DBF45,137,119,18,0.2605890342736178,PASS
E04FA3976B3477CA4ABC906B7A615D4354CEB9BC4DB5041D5EB70D23FD6F5D2B,119,137,18,0.2605890342736178,PASS
BABFABFD4E6611F3B537AFBC25BC8DD47776CA72AD6FC58486794FC3D11C3823,113,143,30,0.060792723530522785,PASS
588FA5DE9ED51AF531827F05A4B2BF5DD24F869EFED497A5AF859E6D53DFA188,114,142,28,0.08011831372763423,PASS
1CF79A2435479355B2C9CD36FC2E0C6FBF056252E72EF68ED98B72255A730B96,122,134,12,0.4532547047537365,PASS
912E55F124B71C27DD768674C15E0F2CB0AB99C0DEC2623545741C8FA240A7EB,132,124,8,0.6170750774519738,PASS
2EA081751A999CA3DAF05D6FF44A2DD8AED8376CF72BB3758ED92E1BE776F747,114,142,28,0.08011831372763423,PASS
2D5607E6D6707101A40557B96B47994C0FE3F8F02E4BA6EB0BF71BEA3BF3822A,125,131,6,0.7076604666545525,PASS
F4BFDD9D5D0810B52886DD2DF1296B13C7F14D6F0BE34C89E0EAD5CA7FE518AD,120,136,16,0.31731050786291404,PASS
23FA85A6987A0788490DB615C6BDE9A28ADB7F21F31EE25579E4D7FB42613952,125,131,6,0.7076604666545525,PASS
F0F1567ADE51FC879001B79255E5EA42F1EA26D0CCFBF358F663B2090CA258D5,126,130,4,0.8025873486341526,PASS
35C4942A7F48A15650F8B7D8114EA2A979D1D7837F81DE71D14948B21B8BEE93,129,127,2,0.9005235503397743,PASS
54A612025E68932C6AD1E13FEDC96241C3192BD5FDE12ADA01F70F6F3CB50D7B,127,129,2,0.9005235503397743,PASS
30FF08FB7F8563BA49BA4260FF30C9A53D4DDE109E70FAE9BE1128961A50B0CA,128,128,0,1.0,PASS
7F1DE52D828B8CEFDBB43392823D4B661B679A65EDCC9DF2412BF1A8C52CEC50,123,133,10,0.5319710580974012,PASS
97962DA000C47150CBA5DBE5ADAC549C134AF80FBD5B8BFA371AB3D64605EA4C,129,127,2,0.9005235503397743,PASS
A394C5696E6C7BC2A75E501C9E04A341809587F5F6780CFD0B4ADFBA03053AA5,132,124,8,0.6170750774519738,PASS
3678ECB343CC9FFCA38F2D1E3B92934E00E978FD1D7B9FE6570BD66763AC4FF2,113,143,30,0.060792723530522785,PASS
3E3C3B5292A2060A96CDE126707990E96BEC96B8990C1A99CC7C0BBB439655D3,133,123,10,0.5319710580974012,PASS
68403CE9F8BCAA60D2732AF6967281849C26273C47DB1DC807DB56A6DAA1EA2D,131,125,6,0.7076604666545525,PASS
32CC9E2654809EC4FDDA9003C122C6791F8744302D0F97480F5B32A10A8CB552,143,113,30,0.060792723530522785,PASS
51AFA4D241F063391DA0D9F63BC9B047ECFF5AED4EF47B0365CDB6AE0D4FA04A,121,135,14,0.38157390570502125,PASS
CD9657C2DEAFC6FDD01FE12E0C4E863C1EED4D4F07522C7A563D78567B38CDD5,118,138,20,0.2112995473337106,PASS
80EE880C6F560B3475C2726398DDC0FAC9A1C320C9C0BC06066B0A588FBD6C96,140,116,24,0.13361440253771617,PASS
DC58A4A3BDC0178C7BEECCB26E11D6D7A80980C464E942E8E161D05EED7D2E84,132,124,8,0.6170750774519738,PASS
DF7A41B2EA353BF8EFB139B0D377D4572C72DB4DF45528E9CD46917243EE996,118,138,20,0.2112995473337106,PASS
8142C0977A072BC4BD2CB43448F38E7F1002E7B874C7EFDD1512CB1B1A168083,137,119,18,0.2605890342736178,PASS
627F24034BBB38049A668B6CA02DE516E73BC89AB073D45CE843B9C1CFC6C9EF,128,128,0,1.0,PASS
14C798FE800060CA7EDC6B06C21FB43A5E85B8271EA73910B745C4591FDE3EFE,129,127,2,0.9005235503397743,PASS
3C3FA1AD67BDDB6EFE895CA009BC0D62D8843C22AEC926F2A3AA1BBB3138536C,126,130,4,0.8025873486341526,PASS
48CB44D13667FAE2554F295D25F3819A82E8965E2AA30A6BFB3AFF0628BA7D10,128,128,0,1.0,PASS
61F378C824F7DA8CE5EA1290678CB5867CE7724D3F133C27EFF2FDCE8D42B46E,118,138,20,0.2112995473337106,PASS
62B8E989461CDD327470DB9FD66FFCDA8E3A278A7029FA7B8E0111BA7E5ABF1D,119,137,18,0.2605890342736178,PASS
C4EF5C566E547F8CDC71C2FF9566EB666E8F16BF5A109E4F933D17296FBDE966,110,146,36,0.024448945310089426,PASS
86600BC047DFCA08BFBBCF05A9D540B369298CD8B8C47640CD857DC61D08689E,136,120,16,0.31731050786291404,PASS
676F21F03DD7708F3648223206F4F58FA6A1ABB104491074AB4248D5CFB6EB0F,131,125,6,0.7076604666545525,PASS
ADF4456F9E5626A18925FDD66354A5704C70DA20D3AA32110A26CFDAE213925A,134,122,12,0.4532547047537365,PASS
A67B46ABD3E53601D30DA943ED92B92EB30B4CFD0EF1E464ABA2E82E1E0F2256,127,129,2,0.9005235503397743,PASS
477920ADD821B6D5363AB154A9E4154E3B0203F42E69DED028B0B77E64978BC3,132,124,8,0.6170750774519738,PASS
14BE3604D15287BA53AAB446A3FF738CE550C49607F6775C6CA3199DFC1CE168,127,129,2,0.9005235503397743,PASS
2DE30E37260BE3C4C36B64A5D33E9B59603F8535E80F2156B23A8856D25A1EFB,128,128,0,1.0,PASS
E52255B74451A9CA662EF48339958489068F10B867852E0F994404D4032A6472,146,110,36,0.024448945310089426,PASS
BEE3358380BC5DBB718BC18255602B3CF4F86D7B8E7B8F4CE6217E88745D3BB3,121,135,14,0.38157390570502125,PASS
DA564BD19EA5F0426FC809E953046B071B880EE5F5DDF673856C5C0763B4DE72,126,130,4,0.8025873486341526,PASS
3C9E92B685E8E5E88D8354AF8FDF943FA5D4C8EEF487634FEB5AA1DCA2BB0612,120,136,16,0.31731050786291404,PASS
4058E85F68F6683CBC984D36212D0050A2DF687514405CC52890A6A86858A8D0,150,106,44,0.005959526470109114,FAIL
DEBA275D2934983D8FB49174C4F78DC9139BAF6FB972574821DE59CA73167843,121,135,14,0.38157390570502125,PASS
A4AECFD919116C3DC0E72719D2DB34E0428A3F5AFEB17D2FDB6B84F628AF02F2,122,134,12,0.4532547047537365,PASS
74056D5C9553C1325AFCFA7054D90DECA77B5F88DCDFFC4678B07B5CA301660D,123,133,10,0.5319710580974012,PASS
5C9C993D549E1650DEB20FA8F49AA003F1C3BB3DB0E3E3E1E3EAC5C18C159E4,130,126,4,0.8025873486341526,PASS
1BB8302CF2066A6C9D1E64B433C6D03CA646F10F5EEEF3C68575DB7D30A374CC,126,130,4,0.8025873486341526,PASS
19F6AFB3E8AD01128B6DBA4A1F65D881BF1916E0974C9027C84C8CE6AABD5310,133,123,10,0.5319710580974012,PASS
FF8F485BE3505DAEF132B955504A24B52E53D649245CC170BF421B5FD38E0FD8,126,130,4,0.8025873486341526,PASS
A5CCE91CC51CD77A01D955AB2EB55141FD50F5C9D7D86EA8501B6EC3E0CC3B0B,126,130,4,0.8025873486341526,PASS
91FD2FBBC0DFCD0B43DF79D3E869E7BFE3F0FAB7AC54E5490123E559A97F9CA5,109,147,38,0.01754895019147673,PASS
78CE6A0C0F23F1E7A6AB9523803C71A958C75C35F5BCE9DFB3CD9CD942332593,123,133,10,0.5319710580974012,PASS
EE1304B504BD0C371E1711C3643F6E6D18FA1CC90D3DC90EB191F7C2DFEDC34,129,127,2,0.9005235503397743,PASS
56EB23A14E0EFF1E46DBC59A8F66C0B7DA73BEF27AE4E2A8A1272D4F0F0BE8C0,121,135,14,0.38157390570502125,PASS
1C12DB02794598D3DA2F4DADA7A8824E053AFD92A8A9DFCEB92B84AC56EADDEB,124,132,8,0.6170750774519738,PASS
9B31211AECA9043E03A369EE2D07A58E8D914B14305CB021D4FB79875BEBDA0B,134,122,12,0.4532547047537365,PASS
5F644476AEFA123360054A9D28A1F8CE2AB34C33DD9002E0E3198CF318B43897,138,118,20,0.2112995473337106,PASS
1931EF95E0CCBD0811836A8CC2EF18E0C95D389B362E9B359F4D1E264E5B8441,134,122,12,0.4532547047537365,PASS
2DB3F470C3CCF5A301AE20157911DE6AFB3EE39BD95CDA2AEF4FFED90C2A131B,119,137,18,0.2605890342736178,PASS
A425EC61F6E21C3C03ECEBE2B78D94F7B440D2D83DAF7AB0BD907BF5250537E6,121,135,14,0.38157390570502125,PASS
B066D61DB883AC635377CA2A4E7279C3950A7CAACF6ABF9E132A2488E9ABE682,127,129,2,0.9005235503397743,PASS
DD17ADFA39A2804060B8FDE9375D022E58D73039535D7D5E2C48515342EC9E1,133,123,10,0.5319710580974012,PASS
8CD2B486F3909F47E591197A391A133AB7DA8048A34352F831AB7D48D571B293,132,124,8,0.6170750774519738,PASS
C4E4D7DFE0A56BA327B33372ADAB2E557369763DCBAF08B2884929B6CA20D898,125,131,6,0.7076604666545525,PASS
B88C3B96A8EBB173DFB2385F7F819C7826E8DAC7CAD1C1F767B22C4AB2FCA6BF,114,142,28,0.08011831372763423,PASS
5A0DF7BAE5BF1BF477C7DFA18926EB97C2188954E640A4B5B2D7309049591A47,125,131,6,0.7076604666545525,PASS
363FA1EC6A4848A7F041D4BD0B4C66EDF31952970C4158FA157983761D14EC0A,134,122,12,0.4532547047537365,PASS
6DE2786FA95D3213DC5E0F8E183A828499AE02E578E9F4C25D82FD747FF0FAA6,123,133,10,0.5319710580974012,PASS
C90E220B2712592CA910C24D445A1CF9386D31B8DF1B516B20AE4548C9C1DDA0,144,112,32,0.04550026389635853,PASS
289C0AE048B603D725EB993F27E1786D65C9E5CF24FE6E86F81C40D3EA0313A8,131,125,6,0.7076604666545525,PASS
9A91230254DEEDD8D81880135E1315C2048A22C119F367916C879EB37033E6C,144,112,32,0.04550026389635853,PASS
EA3E3A7C220A657B9B1BB4A1E4C4DE3FF151AC311055017C3399C7EE68DBDC97,124,132,8,0.6170750774519738,PASS
9D3D99E4B73A22389374B09268F8D5B8503B23285046B10D2FD7ED59CFE56BD3,126,130,4,0.8025873486341526,PASS
F523A3C8919E63AAC9588F9570D3FD3A237161274BCB7824BF49C3504B748DE5,127,129,2,0.9005235503397743,PASS
669BBC438FB554D9B7CD90AB70BE94FB678DD99D3AE95862E78419BE2B8CAABC,117,139,22,0.16913144470267139,PASS
97A6163EC2273953FD93673D0FB87456CBA2EEFE16E9126F76DB97816836BC4,119,137,18,0.2605890342736178,PASS
94A927121602E5062E550E2FEA8677A9D29B7E64334A85D71500BE41A8D9D762,136,120,16,0.31731050786291404,PASS
E9AD94F689BDD2D07E7049948F385928AC7FA4C1C8727CF7556FF0445E37FDCB,118,138,20,0.2112995473337106,PASS
990AE423B88D4847E140EDA17ED2C57DCF3617E0FE4821893FE7D67E385FF06A,124,132,8,0.6170750774519738,PASS
755FCD7F1CF82EFC607013AF2FA736A08C6AF6C27CDFE8F2E51B6EF86B546E37,111,145,34,0.03358661289689768,PASS
AC9FD53EA2BECB1ADAE60DD7B1C951D3620A8100C316D20E50E621FA46D8C285,135,121,14,0.38157390570502125,PASS
41DBFE6E39F17AA37ABFB86AA2925D878D91FBC045903D2C38589CA4A30E9CAD,125,131,6,0.7076604666545525,PASS
3337845E2B73F7FE18EFBB520BAA183A2F8B56E12350A662A14ACBFA073AB9FF,120,136,16,0.31731050786291404,PASS
E554605CA06F1CAC18F0F42C11648E576956C26FBC6D1DC97A4904A026C5E1FE,135,121,14,0.38157390570502125,PASS
A87C6103095B99E87F764B117311676179AED64488CD3E3EBFD02E2F1B7E375C,123,133,10,0.5319710580974012,PASS
79D932C3EDE5A3A7EA2A4DFDE7BED94A12B0BA5F295AFCC50061D933822E30FD,120,136,16,0.31731050786291404,PASS
6523BAF81D9EE61751DA435DE33C85F1343C2C7A9343C1CF9A6DFD7C93AB67BF,115,141,26,0.10416255883043901,PASS
85B390012428386134AA2E2116EB7C97F0AF41110766589F2C2770D3A6DB23B4,141,115,26,0.10416255883043901,PASS
E1CE2182530B8D35FEF51858CA2F85D21C3EDDDF790CB41956D53D4237DA291D,126,130,4,0.8025873486341526,PASS
101299B27E3ACFA97678005D54E33301F21014FA6DEEA41128022B529DE6969D,139,117,22,0.16913144470267139,PASS
DC6548F1AC0528D0D8730B3257C9163A0FD15258CB6CB0791F244B13FDA6E00F,135,121,14,0.38157390570502125,PASS
99BF2199B8F3CB480B0526CF07C903256E7951DD6C6CDB26EE1C7CF7F9AA07FA,120,136,16,0.31731050786291404,PASS
528F907A318116CB07D43E55FBAE96F312B3FC5AECF9BBC9E3353AB97E17AB43,116,140,24,0.13361440253771617,PASS
7EEBB1B3C4ECA3AB211469778C81436FC95D2F816BE9F6C391781CCCAC1CC12F,125,131,6,0.7076604666545525,PASS
F744BCF54573193890C2141EBE3F957B4D7F01FDCDF8F2F25A4924E911A88ADA,123,133,10,0.5319710580974012,PASS
C46031C238F5F3FF487692669C887A22FB734588A11072CBDA61DAE746E8B89F,129,127,2,0.9005235503397743,PASS
C277EBAAE6B51B8F42ECB9279D92AAA32D36159D8D2295378F473A2CEA9010AF,125,131,6,0.7076604666545525,PASS
30742D6E073B238322C39383342A0B8A56D37977B4AFE126FDBC141415934D56,134,122,12,0.4532547047537365,PASS
BDD72C8356D5E77C0DC172CD2096AA68727E4052CC28536DDF4A0E26D8AF7280,131,125,6,0.7076604666545525,PASS
ACCE09ED2B50A67F6823AA52E1A6A688003A7796A84FD4A0B766A634005D45A9,138,118,20,0.2112995473337106,PASS
9389C1E30F7B260248A144061900FBE778F698AD2301BCEF75782E015B608851,142,114,28,0.08011831372763423,PASS
D2604F188A25763EB8CFEC1A3FAD877289A8F4F1FA93FC17159A5C7F78EC1308,123,133,10,0.5319710580974012,PASS
379261AC2B0FA5F612D4B86DA05F7C1FC965EB1FA885D5E238BC977125CB49A8,125,131,6,0.7076604666545525,PASS
10D109A83D519816B05F289570F7E448D996C5B528189565FB82ECCD81814DC6,140,116,24,0.13361440253771617,PASS
5704CB1592AA33834DD2219B13BEE380C9A5D7FB8FADB7E566610B2B5350EA12,129,127,2,0.9005235503397743,PASS
619CF524A3C82366340B41411E7424A587835B24E06DC1EFEF551599A7D071D2,137,119,18,0.2605890342736178,PASS
28C618D04DB3E0BB173C88E2A63B5AB85831E95ECE6772D660743A8893703744,135,121,14,0.38157390570502125,PASS
488CF58BAB2F8C3DD906F2426B08AD955C345DDE1AEDADA50F6F8CD6A22C2E15,127,129,2,0.9005235503397743,PASS
C6DE2093009B6147E41F2F6586D7606C0A8291DABA7DB94205CA92B6F30E2CFE,133,123,10,0.5319710580974012,PASS
925243E854C34A504BB4B1D3012B01352EB9ACC2296A6679C1EEBA651484A035,144,112,32,0.04550026389635853,PASS
86278BD54A9AB0A75DB22EDEA304ADA4AD807F46B911562FF3A4EA55B071AFC2,127,129,2,0.9005235503397743,PASS
96CC71C8750AB3E4697B27EC04EAF0E9AECE6B4CB4D0C1DA047C06042DB8EB7,132,124,8,0.6170750774519738,PASS
3A588A3E585D27B3E03408216DEEA8D6BEAFEC8CE21C4E8D5A1DDC1853FD133C,128,128,0,1.0,PASS
65E4E48599E6EEBD790F732CE11F72F108EF71B4B631726A9415B785D58E0734,123,133,10,0.5319710580974012,PASS
4B6D5CA5FCBE9168FC411000A4B8CA38497D5E156D74782179D80DFB11E359C7,131,125,6,0.7076604666545525,PASS
595C10D48779AD5EFE05395B875BEE9AAAFAB9C4C324028A04F6BF49F782FF01,124,132,8,0.6170750774519738,PASS
176B77CDF108F28591F3CB007C8480FE6F99C1835A92E8CB209093F72094DB08,136,120,16,0.31731050786291404,PASS
3726CBF266A0E833652AF1B1B3F5FEF078F9B6670F91A732ECE70043F638CC4E,120,136,16,0.31731050786291404,PASS
4EFFDA72E901A80F7FA767E48BF72767D262073287B035B54B6F98FF19EA120E,118,138,20,0.2112995473337106,PASS
3E4B6A70EB3198BED42894100354055F8E8C9A1FE71B347DC3BB81EF0D5F06D5,129,127,2,0.9005235503397743,PASS
4E26FDAC0D437BB88DF9460AB1F844B4D666E4CCC6D71BB555125591571A7F46,125,131,6,0.7076604666545525,PASS
75EC0BCDF76515063310B5986AF36C784C6D0C85637DC60F0AE03D3937D0FEFE,124,132,8,0.6170750774519738,PASS
70A7CBD4658DE2C5A9CC4EB74B16EA41E55EAB462C84F3442D0D701061AEDC1A,133,123,10,0.5319710580974012,PASS
785F95540F5E9841BC8258952B1894E971B4A9ACD7761324F1778C9393F786BF,126,130,4,0.8025873486341526,PASS
AA0CBB4959BC3814358198350C56B592A7F43EF085C211D72E9814CCBC034EDB,137,119,18,0.2605890342736178,PASS
A1EE0C670D64988E02DABBF6D42A7EE0933CB752ADCD347593F076B255C0863D,127,129,2,0.9005235503397743,PASS
9179B8D8AD535EFAD113BF1629E99B6D26202157CF29FF8EF58E8232453C964F,122,134,12,0.4532547047537365,PASS
D74C7EE6FA0189CD8D63D5780F9389AB782BFC97299081E65B3A3892D331E019,128,128,0,1.0,PASS
64983E66ECC43911547A685B3E0EF1681241539CDCCC2C1727DE803E15247EB3,135,121,14,0.38157390570502125,PASS
73A63BD7CAECA55DA95D588105F538D0A79A5FE96A526E1B66D939AF8378C47E,119,137,18,0.2605890342736178,PASS
377EC7333235ED8767F6B13D7D68FF997D3FF09E395ACAF776A7AF022E48FC0A,107,149,42,0.008664896726025117,FAIL
3011A51E8511B6A2E8DC004919582BD9B2DA4E2018734D4C64055E4D3B98F23B,144,112,32,0.04550026389635853,PASS
71D44C1666C5688129251B8DAA322A96D17C3E19FDADB6C18B16859608707EC9,136,120,16,0.31731050786291404,PASS
372450B5D9B6CFCDA4108F8A42769988F32AF0D14EE915D7DC24F455B91211EE,130,126,4,0.8025873486341526,PASS
EBF3A062122EFFA8B37B96B5B16345EC6254DAF2DFC7F1A864197AFEF42589FF,113,143,30,0.060792723530522785,PASS
DE0D1239AB32129C5C75006FC25709E296995E7DEDDFC8CCCA75C6641D73DFA6,123,133,10,0.5319710580974012,PASS
FF14646F4158E7574D14D7CEADA30AD41CD5E3AA1E1534622FD66C10A6F8ECB,127,129,2,0.9005235503397743,PASS
2E8A1515E698CED97CC62BA1FB5090F85A349968F5D6F413EAE72B3D7A306A2A,126,130,4,0.8025873486341526,PASS
2BB3DC7A7266BD92AE3D1FB1DF3984F3D080FA725B2DC0ECED9615C68B23D73,120,136,16,0.31731050786291404,PASS
3A18D3D20EFFD5EDD3FDE0415A56141BF7D9EB145DD88730001B3AD40AAC7902,129,127,2,0.9005235503397743,PASS
59E069BE8B8C863CBCAF859670C48F71A8717E2EE09F5EF2AE7A8501906F8954,128,128,0,1.0,PASS
8E0EE476F9F5D8A71E42EA6978C392C27F21FA6E95A78AFD9F28F09D9256884B,121,135,14,0.38157390570502125,PASS
D216F72E912C4A4A63C99707DC98E9BAB2CBEBB457FC4903B33BCD4BD6D7BD5F,115,141,26,0.10416255883043901,PASS
53D0F67E21F2DFEAB40C24985C5B983CACAEE88E64D741A5D4B8513CEDC95EF5,123,133,10,0.5319710580974012,PASS
E66C118D8C116661C51F5D137B9CF0504A7F35565B4D1DD55DAFD3BB877C58AF,120,136,16,0.31731050786291404,PASS
B99E47D8852E2BA5D8299412A60BBFA4B6FB8AFF28E7A10B497C6424CCE5B0D9,127,129,2,0.9005235503397743,PASS
5A78E42BF99813B65365D31A4F985D160973F35B64A6422BACCCF35746767A00,128,128,0,1.0,PASS
9C46312BA0B480A3ABEB45904D31191C6CFC51D38CA5B07277B74D086CAFB43E,134,122,12,0.4532547047537365,PASS
F3745973A3379EC0CF4037DFE3D9AA82CCCBD3A7D41EFDED70B22D6B8F71FB76,109,147,38,0.01754895019147673,PASS
3718278F847F00B5D1DCC8CD56F66DA5831F0CF17665D56EF8BB7BB64FC2DF40,118,138,20,0.2112995473337106,PASS
27EED8DC123D988BE711326A1E0974238DBAC827DCE813515A4722CAF979040,138,118,20,0.2112995473337106,PASS
B93540E5BE3C868F985FF42F58E1BAADF59A302C09F7D24AEFE9B7D0C554825F,120,136,16,0.31731050786291404,PASS
6C3E9B4CDDE0CCEFF2797C6E1CD72EBCFB191141C6484495782BDE7EF0AA1DB,120,136,16,0.31731050786291404,PASS
620296DC5058549FCAD19AA8305F4BDD8F081B9F031A6B87BB2097DCA147CC06,136,120,16,0.31731050786291404,PASS
897B3AEB9245A63C6D8980159D58986E5D82446DF65D5885661D91C92224E0DB,136,120,16,0.31731050786291404,PASS
D7E8DC6A3915BD0D4CD13CC012CFE0D2FE878C53282A5AF41AA8A7421D90372D,133,123,10,0.5319710580974012,PASS
D0C9D7E18B5A14762D9BF5771636407B451C588C3AD1EEB21AC0E100D1450932,138,118,20,0.2112995473337106,PASS
1587D2455365BFA8BFA2AE2A35F3B4F10E312E7797638D206D064F9CCAACAFC2,124,132,8,0.6170750774519738,PASS
99EF00680B77387B4282A268D13E100B156605CF2AC0CEF8ABF2B85B483324AD,139,117,22,0.16913144470267139,PASS
77376B25FA675F1C92BA9FD5DDAFF599D0E060291D4840ED5C31259AB49AB806,124,132,8,0.6170750774519738,PASS
F4932BCD9D586D95C6D6955AB5C4D56B0593D52CEA1FF04CCF33E3B1AD22E7DA,118,138,20,0.2112995473337106,PASS
3E6AF16600AA4F833CAF95DA69A8F82036239DB096318B93F865008AC117C0A1,140,116,24,0.13361440253771617,PASS
AD7217CA32E04782F946BAF9C304412AD0813ADA5138D443C7AC8A80FB61565E,138,118,20,0.2112995473337106,PASS
57CB992A9F94553D2A93DD0747401FD719A2B2D1F2C94DC814516FB7126BC43A,128,128,0,1.0,PASS
701748CB792300F29BF0B2A5037BEC51906387253E387212A9C566DC1EF11105,139,117,22,0.16913144470267139,PASS
195E2F921D39D2F646C964FF13BB0CD2C49A235B40A903E06876DA47E3B2FBCB,126,130,4,0.8025873486341526,PASS
8CB499003A845A9B03D47CB6BD8077D91EAF2C3AD5116777BB88AC7B6FF6D803,125,131,6,0.7076604666545525,PASS
E2927EFB3C5579D4D328E5FC92536C46DC98E153291E5816716F30EE66D14E97,123,133,10,0.5319710580974012,PASS
D65EC69F54550B322BE6C1802D45CBF9ABC4C3E6EE3DB693DEC4CF267B55C1CD,119,137,18,0.2605890342736178,PASS
9222E9285649A98FFF384479CC9DCC99E7AF815FE1792ABA6D55563E561E18FB,121,135,14,0.38157390570502125,PASS
13A9D4480323830CFA343598D4B374AE9DA095C12106F544C2A1499BADC75EF4,139,117,22,0.16913144470267139,PASS
6E7555DC3C40DFF1ED3F1E6DA6F8BB0D8B5FD6FA5C33F5A1AB7F2BD65C361101,111,145,34,0.03358661289689768,PASS
6678A178CF2DAF736D3B5C2B1E248D2604A798A24CE7E9D5F45633A1364D71E5,125,131,6,0.7076604666545525,PASS
7D9F03495695C886A5F0E8B21DB3158088D49D843BCC1D24674044F4DDEB7FD3,131,125,6,0.7076604666545525,PASS
3CCA167F86C9C8AD923E9FF946CD38E8E91ED79A164C6E12EC4979B0B7134566,124,132,8,0.6170750774519738,PASS
5F8D1FFECC1ADE2AD9182F93698584A927B1E113A776CB47A6FD2E9D4AEF15DA,117,139,22,0.16913144470267139,PASS
B70CACAB250843940C68AAA16411024BF6AA88DC4214D3625164E476F8404E94,150,106,44,0.005959526470109114,FAIL
1DD7FC79E6CF8F482AF53455A3E2DAAE0BE16BD0CF09588E4965A0E88936896,128,128,0,1.0,PASS
B67382EDC33196CB21A4C39E46E57D9F9D6970A802D441D610906DC31FEEE961,130,126,4,0.8025873486341526,PASS
D2203A4AB20BF0972F0918DC17877A64F0FDAB5BC3928A08B5F779EB48C95281,132,124,8,0.6170750774519738,PASS
7628419A9D91890CC2369F7E9F2764697E39A8B3E77729076ACAFA0F9813DDEB,122,134,12,0.4532547047537365,PASS
834DE8229CAE4ED68F54EB67460B0C31A1242C613D43574871F2665EFEC52876,133,123,10,0.5319710580974012,PASS
F1CB05D27423B5E865BA6D32368C72F4C362A12437D54E15A0BEA7624D0A42F0,134,122,12,0.4532547047537365,PASS
4FA77DB06E9FF9FE255DD269A5438F83097D3E6B3EA15B3BA0145BF2310B4359,119,137,18,0.2605890342736178,PASS
DB6B719D2EB94609AB041C65E6574DE36F3E032ED393B2A6C18D3B99FE5798B6,120,136,16,0.31731050786291404,PASS
88ED46D5287348A30B7F9B34EAEEF6118467BEEEB869F63672715AF503AC94D8,122,134,12,0.4532547047537365,PASS
A1C46CBA63BE1D5EEB1843495BAD1C77F1B0E432861681DF59AF44A4083182EE,132,124,8,0.6170750774519738,PASS
DD86DD641F071D8D2F106768CBB02196EBCFDED89C9809033B3F435D65AACC28,128,128,0,1.0,PASS
EFC510E5D552DB847A2734AEDF8A95BDB7DA6E8DFED6B764C645C2300BA8E04F,119,137,18,0.2605890342736178,PASS
FEFB6BD72AFB4E6FB73E8F37E7FCDBCA1DC86E9AC0E016944273219BEB8A1532,112,144,32,0.04550026389635853,PASS
9DBD163F44921881666E89C7D5BF4A0CE02C524A958B3F37FA7E37E037CDF770,122,134,12,0.4532547047537365,PASS
4F9DC8F92AAFA4C5B44DFEDA5425883286900F6D0DEC6C9C54E2CAFA48D3CBF2,126,130,4,0.8025873486341526,PASS
FC09E4ADA69C25948626A7A9B7F879BBE6793F72F7661CD0181CC2065A59613C,126,130,4,0.8025873486341526,PASS
D3CBA67DDB8F854A7FC7E84CE7C9D232FE4F8648706FFB1E3D56C43B8B2739BD,111,145,34,0.03358661289689768,PASS
64288B36D839C6F39170CA63CC426E22C4D02D777B3DA3C7431D3BDB5FAB930A,127,129,2,0.9005235503397743,PASS
26887C6F124DFE304350B290F978145445B17F5E8ACA687384601E6CE8F6659D,134,122,12,0.4532547047537365,PASS
18753708B5BAA6D2B44663D6FA8ED73AE5C034D830A6F1FE980F996379B9467E,123,133,10,0.5319710580974012,PASS
CA62169380CEC06182D29271B3EEA2C2651AED4C67082F382FBD772E01A66FF5,133,123,10,0.5319710580974012,PASS
FD0C234A3A839F8A57E38D1D4400F21F627BB6812745B6E9033D256AD2AD7A8A,131,125,6,0.7076604666545525,PASS
CA549F2F07DD3DB6D427D7E994C49A59BFF2604EF183A3C8591508CD983A7C70,125,131,6,0.7076604666545525,PASS
5E6D32EEA81D74BBA496AACF6CB52D05509BE59423EB0CA34B25DBF8A28396D,127,129,2,0.9005235503397743,PASS
5F8C2425D2780270C20E1DF3B4DA156EF01D4F5E7CDAFC9ECCE1F7B4428C1685,128,128,0,1.0,PASS
CE5789F32823AB0566D19C8D7F50369ABB7AD4874AF034B737C533FD4F0865DB,121,135,14,0.38157390570502125,PASS
FF0CA8B891D96CB8382DF89D5AA5B519089BD56AC30EE464D90D6430EFB3D0D2,129,127,2,0.9005235503397743,PASS
8846E510C022412F9948E1B508A8561398C321F5AC5993990FD4DC8E7DB4B49B,141,115,26,0.10416255883043901,PASS
70D893FB10891F644D933B7098F78F85C3C7BFD71EB96F181C6F5F0A9098B125,124,132,8,0.6170750774519738,PASS
19CAA20768B17A87ECE396842CC89282DE933D26DC7EED09CE37BDD98E161881,131,125,6,0.7076604666545525,PASS
86771A49F545E7D6A90D2C554E0EFCF1ED2F103DD3E5CF7A573F86A9B57F02AD,115,141,26,0.10416255883043901,PASS
9B42B1537D2690E0338B951DFCD7BAD0477911073FB82318F70C8C14DD83F0B2,131,125,6,0.7076604666545525,PASS
27D9D0FA71383A996D256C735EBEB8F5DEC49DA4278E6E5A9DF8D884FBDC1916,117,139,22,0.16913144470267139,PASS
CBE4D15B40B60403C0767EDAE0F79F9F0414A4E9B37C1E4745C9D3B099AD3805,131,125,6,0.7076604666545525,PASS
411A46281F05CEE49A2D2F889CCBABA26C844A44CAB32243627D64B309CBF363,139,117,22,0.16913144470267139,PASS
98CFFF6D7DB2FF26C7CBB8710085B9D48A3DD99C29DC6B943CC3E2736AE55B69,115,141,26,0.10416255883043901,PASS
DD8ACB04FAEE03268F39DA0D2ED01F81288C68BF9B427DC4183301261C935788,138,118,20,0.2112995473337106,PASS
4F2DCC555F3430D5080F7E444E43A1C795D92A2535862124B97DD321CE7D1D41,134,122,12,0.4532547047537365,PASS
C038612FAC1FEF69B68FD43F4240BB206F1B81F110C3A43D10E8CAED473CDA54,132,124,8,0.6170750774519738,PASS
B745EF4D1C687A06A8D1A88F67393FF2B946AA3CEB8C0F78ED65CD76D180B61D,121,135,14,0.38157390570502125,PASS
4BE70081987C48FC58EEC690F33BDF63F22AF88837F64102DD8BA3CE7BD3E714,124,132,8,0.6170750774519738,PASS
6342EC3EEBC77F5116891018C6342F446F39AEACD0531DAC7419136705CD19F9,131,125,6,0.7076604666545525,PASS
C66D57BDACFFB6538CA180736ADE474EB804D2236C51145789BBEB613101B8C2,130,126,4,0.8025873486341526,PASS
AF09B79DCFEE0393F1045E981A84F0213D3D0005AB83671AA8734323C6E00BDB,136,120,16,0.31731050786291404,PASS
916BC53FBDC16B70CB08BBD82B5187457E5493BB5BF84ADBAF7AB63AE6167B7,116,140,24,0.13361440253771617,PASS
DAFC5A029CE306EEC93CCADEDD5608BA3DB4C49474D787BA989FE311B0D22BAA,124,132,8,0.6170750774519738,PASS
89872A0908D27E5C293C22C765DAF19EA084343EF522EABF3FCA22C07C29C103,137,119,18,0.2605890342736178,PASS
3131C5ABE216D3B8A3D9284A216A93E3A830DDE70F3B699A53E256D118297454,134,122,12,0.4532547047537365,PASS
E4C2871D8E273562D2CEEDA6773478738F2982490F53D16D86715365B474DC48,129,127,2,0.9005235503397743,PASS
EA79FFD647F3BEADC4A6E8AE0C28167A97A8DEDE32D2EFD0668D8A99791ECDF8,113,143,30,0.060792723530522785,PASS
49A723DCF1952A17EC5036992832871819234C0587922FE9BDE40F8164E41896,141,115,26,0.10416255883043901,PASS
11D6CDF4D492D2C4510F8399C2E5DBF6E5F948BD14B4A8F87B0DA9E726C8420D,128,128,0,1.0,PASS
D411970DFAC438110C98A9396F2C2AAA3CF3E48AB19D32180755FA7132BA5067,136,120,16,0.31731050786291404,PASS
DE32E4047F4932B2D36F440417EC0E69E1E1267A8A603DDF872F09428B1B0499,136,120,16,0.31731050786291404,PASS
6535C80A6157E88A8E7A22C4C01D29C78EDCF5468DEB4BAE2F06A6BFBB595AD1,127,129,2,0.9005235503397743,PASS
B224FF7DDD94769EA7D53F9108ED7DA3D15AD098E7B5975D2741930E4D7FCFC7,111,145,34,0.03358661289689768,PASS
48A6EB824FBD77CD90AADA6C50045D96DF9F6EE4C765C435AC16D12ACAC8A2CE,126,130,4,0.8025873486341526,PASS
5F9C45B8E66CF81E8D47AA6E9BA5567B04C595D6ADBB529ECF0F908AC80B3185,125,131,6,0.7076604666545525,PASS
3DCA72E5E45F325C816DF2840C5CC21D17F209593C5AF2034BB593026D9419AB,134,122,12,0.4532547047537365,PASS
562D968315952E6F4BAF646B618A90EDEB24C27DCABFA529BB500F766C79E640,125,131,6,0.7076604666545525,PASS
CBEF0313C4141051999E1CEB581437CCDB2F59994C690A6241EC28DB21DF9178,136,120,16,0.31731050786291404,PASS
93B643F9F7F8B12BE174751479E890046779FB1DB5CA4B729E06533FFBA7CB08,118,138,20,0.2112995473337106,PASS
1D416CDFB2F301D845568D58EC5119215580FB446E44E918CE407168F310B059,142,114,28,0.08011831372763423,PASS
2A8A1CA451B71DD852F0F4A8E9B4808D94C5154059A296DA7DFDF14B9A4FC376,131,125,6,0.7076604666545525,PASS
459B71296CD4BC507860F860018DE149E5F08D95A36F5D48243EF532EB10231E,137,119,18,0.2605890342736178,PASS
F5DD2DE1B3EB926D2E215BBEC12EA211C37E73691092FA49A6240C7DDBE78DE8,122,134,12,0.4532547047537365,PASS
2C3C112C8475E9A78D6286D72BA2218FE30A67A96067E214DB50762CC2CDEFD7,131,125,6,0.7076604666545525,PASS
C9D46669D2D1F8DFD1330BFB6C9270F636766706F7E37E214434B6E1C93218BE,121,135,14,0.38157390570502125,PASS
663A22E60F50E15F5C2AB2B7BFE091E1F4AECD7E905F7A73A8B102DB556224B,126,130,4,0.8025873486341526,PASS
95CBE6117B0AC837F66A59FB0F97B41A74E90AECA3CCE77276F67458C4B0020C,126,130,4,0.8025873486341526,PASS
B729F44522F1674AAF6FB9E084657E475DA54B04669073BAAC5B556B70BF592A,123,133,10,0.5319710580974012,PASS
F63F9CA07A3D788F5DD894EF232A27D99D8A38A06E45F509C0D694CFB9344BA2,125,131,6,0.7076604666545525,PASS
911399A13FB2F5609BC6E115CF22EAED11F8B9BA23FA34ABDC05940C55A59305,130,126,4,0.8025873486341526,PASS
51DD6D67FFC1F92ECAEB1F84C3A99A6CC7F1AFB0ED4D41623EA7FF92436CD200,117,139,22,0.16913144470267139,PASS
79624AF072527CB6D150B1CDA33EBF9CDA6AB94C210AC689B683D0CC2B4052F9,132,124,8,0.6170750774519738,PASS
2EF1A2D63894EA2340885843AF85A2EEABBA84C6835A05F8E87D8F73F8E6585D,130,126,4,0.8025873486341526,PASS
ABA32B95E9251AFBB56FB379D513E0656A2B2617BE80CD1F38AF6BD9A7FB6C25,115,141,26,0.10416255883043901,PASS
CB2EA970F90F6318600B8FCE1D05BB0D6E01998275B21726F3E704D5E86DBB4B,129,127,2,0.9005235503397743,PASS
A20CCD76F8F0D2E1802C6572CDBDEB9AAEA9F7340F8F4065BDEAEBB8C1A4172,126,130,4,0.8025873486341526,PASS
455C08B4B14F3E4779D7FC0AF99F0507AF5278F3669C4B573060A2F146831814,132,124,8,0.6170750774519738,PASS
F2CEA7780D09A02C5ED37BD6A39FA4BA218A90E7F309A0CED869CD931701CAAA,130,126,4,0.8025873486341526,PASS
4E59C295452508D1E27343786AF0D81540D0342FEC819F59615ECDE3BE85A283,137,119,18,0.2605890342736178,PASS
85CE0097845303F9B716CCC20BD8989B90A4F02C88C1F46315705B18B2DC7ED5,139,117,22,0.16913144470267139,PASS
41D1781E8EF91EE5F8941198DA543C24D28976FC4092B47B3279CA4D7AE02AD7,131,125,6,0.7076604666545525,PASS
754DB326052DEBB1798C21AFBEE83CF5BD2AFB4B4D0BD968A6941048FBD8127,126,130,4,0.8025873486341526,PASS
902C21B65F8A18841C6EFCC1F1A0EC4CA97649DE816627307B48F4A12A8D9365,138,118,20,0.2112995473337106,PASS
128D5D2D8ADFF123F2D2DF5E4933B362F7998F422A7456004F2EBD20D5F8ACFE,121,135,14,0.38157390570502125,PASS
CF48CE857F1BA8745C4ADD3BD6B90DEB44D74C1C3D6D6EA89677EE0400EF0BE5,121,135,14,0.38157390570502125,PASS
89921D311018450021478A4C28FC0FF16494C7077CE1EBBBCFEFF57190CCA713,136,120,16,0.31731050786291404,PASS
B4E05E2B10D6641D48C9CAAAAAFAEFE7DF25E0A2068133BA666F68BD97C94DAA,125,131,6,0.7076604666545525,PASS
68BAF4E5EBAB6CA177C9230D5E3378AF2572765D9A54BF7F16FE9FF7207BCF07,108,148,40,0.0124193306515523,PASS
4344D83FFBD2F3810906F1C2AB30D96B5D5A9226A24E405B77E1DEF859838A71,130,126,4,0.8025873486341526,PASS
94DB45B9DC64075AA8B7878FB0C63A4651E6DD5756313F0FED89F215C9E7F362,120,136,16,0.31731050786291404,PASS
D3022B0AFED0670AB2CEFEFF08921B6C7EEEC4A3A2782FBD5CECF6D1DE57001,123,133,10,0.5319710580974012,PASS
1FA1E2FBF823C4593D7C19DB2F7128FE6420C9D4615CA2EF7412F34F34616964,126,130,4,0.8025873486341526,PASS
9BDBBD4389B5D80247878BA623A1252EF2C4BC8EDC96AEAB7F3BED103248C8B,128,128,0,1.0,PASS
68B981C9B82E4F68790DA7361321777B6577D42AED28561E11AF1F7AC330F18F,125,131,6,0.7076604666545525,PASS
26D48618D00EB2AC14A2B3778384FA080B2BDEC3C0FC0C52BA29185B7277D3E2,138,118,20,0.2112995473337106,PASS
5B4754F3F69F82C100EFAF59AEC1BCBF6FAAFD731A6C21638F24BE28A6724BA3,118,138,20,0.2112995473337106,PASS
6C5DBD79FBB7C76C4D182A3CC707D19B3F223C252FB5B5102F965D8884229BF0,124,132,8,0.6170750774519738,PASS
A70840B4DC03EF236561002481C727B3162E0AF25DEA6DD0CB646D26842B9402,145,111,34,0.03358661289689768,PASS
9FB46C0BAB2844142142A04AB13E19F2B753DBBF9257C34C47E2E783DA5CB1CA,130,126,4,0.8025873486341526,PASS
CDC4F6D32BA5248F4C59FC1330DF416F4B71CD80A57FB5BE723592FF706455B8,120,136,16,0.31731050786291404,PASS
77CEE6ACCB097C7F1C2E933B43F9A799202828202E0181F433CE9845AF998425,135,121,14,0.38157390570502125,PASS
A117F547B5B395087C56DD22DA250154F18A3098D45A6ABF02D0C32938A061BE,138,118,20,0.2112995473337106,PASS
DD246C0F4B204D4338F431004A49CA3872E282964ADF962563B2AF56BFB62801,140,116,24,0.13361440253771617,PASS
A4EBCDCF3A141F3019F045609F8F9BC9931158B8FE3A8BAFA96546947D45ECE0,126,130,4,0.8025873486341526,PASS
E67F2C44EFA7AF9021F7F058B3CC875377D58F8F65ABD3471099F2D2C8E496E,119,137,18,0.2605890342736178,PASS
D2FFCD722E81FBE1E68D11DB5A72651931A43630646B7E1278EAA302F26692DA,127,129,2,0.9005235503397743,PASS
45A009E1D62CBA5C981B8295735A34D89A1F0DF7AE9AF4ECC95C41769241A7E6,131,125,6,0.7076604666545525,PASS
AF1B55B34E4C4483DED7A1E6701B75726EF31FA5E81F23D3A9B1BA33C8720C4B,122,134,12,0.4532547047537365,PASS
BAC90B058A3244173D44CA58DCC7E75B4161F742D013C1B8EDB6DCB414710254,138,118,20,0.2112995473337106,PASS
5DE858594D4F2B1428CA9FD63299C41CE0754D542F03EDA4C454474D4021268C,141,115,26,0.10416255883043901,PASS
9792000E65D0316D7B3F672CB1B6A8C9F7238223C30CA29529D6E8DE464EA4DD,132,124,8,0.6170750774519738,PASS
8FBEBA1DC1A913EC6F4C1E75A2933E9215F7543174956EBE115F880DE448765A,125,131,6,0.7076604666545525,PASS
78CFF8CB7F6F1A80CF86F9137EA20C337714290367A0C15527E52C42D79EB028,129,127,2,0.9005235503397743,PASS
883E773FA37034C4F1DC3171F3DC4D503A4D7EAAAD517A8878959396FAAB755F,119,137,18,0.2605890342736178,PASS
9F45977C41DB5CB1653A71C036E5627B3EF08D3C57FC25C4B74159DD5ACC62A3,122,134,12,0.4532547047537365,PASS
447394E3A336505AD0A83993825DA62C564B20B6EBF81F0913533A24670A1584,142,114,28,0.08011831372763423,PASS
D4F64503DE5D29758AED7C9C8CF12A34CF41651C9A6452D041928ECF2C4428F4,135,121,14,0.38157390570502125,PASS
76DDD0431C149A984304C5B176C7F67D11ECECE544E56EE432342B9BF0F11B15,129,127,2,0.9005235503397743,PASS
82D356123E79CCEA9ACB835D7A62F7AEDACE6A8681D444153A58ABDF4F9D7BC8,121,135,14,0.38157390570502125,PASS
B1EC1B4800EBBCBB4270EBC9E92BEB820D93A3CA0B6CDC91BA61DF7164014C8,135,121,14,0.38157390570502125,PASS
C1D120F9B7EE867B0410D1BF5BA21A8D2A091E7F6ADEA971BE9846C287DEC83A,127,129,2,0.9005235503397743,PASS
49BCE4D2E5D14ABA1CE15B744527E0AFF95A8CAE91EEC9C6439E6DD9A84EA9C6,123,133,10,0.5319710580974012,PASS
756BE24ABDC2E78339C0118142B5AC4A90011EA238CF2CCDC4A493E58BF320F0,140,116,24,0.13361440253771617,PASS
E504E2B9A3A532117A765B67283C02E289FFBED0372D4B7F07E3307FEEB23C51,123,133,10,0.5319710580974012,PASS
D4A094ACA8C30F2F8659D09FFAC6FE077E65F1E94B5ADBF94570519F550157E2,122,134,12,0.4532547047537365,PASS
AB234C1614DB3C5B9A017733E3E6276F95755B7E564EC2AF14FD468FBD48EA47,119,137,18,0.2605890342736178,PASS
5113B721C864AC5315DD2FDB5B3836FA46453C39D32CD2C2216FC3A79DE5F7EB,121,135,14,0.38157390570502125,PASS
1BEE14A4BE472391B284B5963047E619B99932A6CBF8CA3178D9C9D7119EE1A3,129,127,2,0.9005235503397743,PASS
142F29CEA9E43E25830EBE7D79FA44D494ABADA53B082B598E1AEF237BC9EF0D,122,134,12,0.4532547047537365,PASS
966139D5D62F10202F8F1FFF9F9A85162C5F9DDAA1611AC917EF33C2BF80F72F,119,137,18,0.2605890342736178,PASS
E48069FBC7FF0FACFA184F268996AA961FFC6297CF035051A127AD7314111297,128,128,0,1.0,PASS
6C73F10B9F3F0297AA3B47D781BBE0E798E28BF1505A888B50FC63760B822CAA,128,128,0,1.0,PASS
4AF1F81359C247CDB1C0FE1AE9ECBC82463F0ED697FD7B15AF80BAEC0FA1509E,122,134,12,0.4532547047537365,PASS
C3720F9B69BA8540BD106711B71D18BC2D581B625E3A134B4FE3CD73B231D87F,127,129,2,0.9005235503397743,PASS
CF1F7C2507C750A70219EC29C757B5CFFF1FAE6B344B5B6FD0694ED2F6C5FDE6,111,145,34,0.03358661289689768,PASS
D6FDC70406E59639ACD2D02A9026539B2E9B8BDB04D454D77E1D9C1D7A1B4770,128,128,0,1.0,PASS
332E268F7423E5E1610B093C36BAB4B3BEBB29AD142F376FD8F8C9FD29085880,128,128,0,1.0,PASS
8F6CC667C596407D6B057A03F007E1C51104A3C1F18F2C95F9AC648C2300C80D,142,114,28,0.08011831372763423,PASS
913064BA44D7AE3FC0DA36AA7CECD2FB9EC22B52302D44EE428CF23C8DA290DB,130,126,4,0.8025873486341526,PASS
BE8DFA26BF85D155C48D5AC36FB24B9662D6EC14B68A912B97F4637CC4EE40D6,122,134,12,0.4532547047537365,PASS
7C6DAE4D90F6922347F877DC6518C8E77671D9CEA388E02AA12973652392B,133,123,10,0.5319710580974012,PASS
4A8A971683643F162E28D5463EA9854DDAFD31A0F6A39ACC6C8C682197EB4F08,133,123,10,0.5319710580974012,PASS
8D8AED4240F7DB7B151A57E131DF3516ABAB4CE026D826718CC0DD2CDE204E64,131,125,6,0.7076604666545525,PASS
579C8BC07CE652E3F743D08FDB0B5583748FD27384E9D16003EDEA1BF0650748,128,128,0,1.0,PASS
AF1EFBD3A5E57850DAE05F76C1DCB03CEEEFA77E25C5E4AC02B5CAEC229D1E6B,115,141,26,0.10416255883043901,PASS
D2C8A73B85E2F5442907EA1C22498008415A4CCE2544B3154927CCD56306D7ED,142,114,28,0.08011831372763423,PASS
F7A09ED99775452648A56B2202F36AC6C00DE2E7A76297FDEEF8D17DC88F7A5E,119,137,18,0.2605890342736178,PASS
4247EF82EEABDF7A7359341A547B25D935762D5A3457CD0A616288F5EC4611DE,124,132,8,0.6170750774519738,PASS
4AA078E4C41F12A578B9FB93A6E533F21796C618DC3E4967BE12598B0A2D12BC,130,126,4,0.8025873486341526,PASS
FCC0B84177F6787A10A79283F04D40B2265C6A950DFA560F6A0B5DE9484593A3,134,122,12,0.4532547047537365,PASS
14E2550115EC6FDE78E8D47675036CCFD8820032E4ACD34A4D75A47AD8204B66,136,120,16,0.31731050786291404,PASS
327C720CA44C9559EC32B2C681B1B33E00E9533A2B55C06F1A3BFCFB34CDC576,129,127,2,0.9005235503397743,PASS
FCDF3E2348D4C5673215F515F948D23154159A93FC269C1B2283ABE8DA953E47,127,129,2,0.9005235503397743,PASS
DDFA872CBB4F7FAA3D08F01A966DC0396F28C22427343492813D015A6B8D43A2,134,122,12,0.4532547047537365,PASS
8C387E711A8D24DCAEBC3BD0C87E83AD2E9453DFC4DD29AE63B806410C35A868,132,124,8,0.6170750774519738,PASS
B34D1EA3CC27CD9AD73C3D6E15BD3842476947E021628BCBAF49D0647B31CD2B,126,130,4,0.8025873486341526,PASS
37F9EF409E420357D9ACF8FDCE1F5A33EDF04886C460B3336B6C130272989D89,127,129,2,0.9005235503397743,PASS
16643BFDE11AFFFE16FFA37496CB6EEC8986A374585CA8DE28BA24C1D2457334,121,135,14,0.38157390570502125,PASS
810F403F217F37B9C1B6B13F1F7A3D26561ABED912E09FBEAD2E2E0B254BA8DC,122,134,12,0.4532547047537365,PASS
998788C9B6E3786274CBE4E1E02BF247A3AD3550D242876B11675628C0DBF396,131,125,6,0.7076604666545525,PASS
A7BE0E0B328C2036EAC33B09D06C7D0629D31FD3220CD0768E13161D739D8094,139,117,22,0.16913144470267139,PASS
89817B274E4673A316474893773061F1BBBEE83EAF7E7A73B29A8FB0E1D8723,123,133,10,0.5319710580974012,PASS
935BBCEE33F5461943F841276FA11B3867ABFDE8B15773B23DDD71F2CCC27724,116,140,24,0.13361440253771617,PASS
17E933D613A62CA1195F29C0CD9CCF672918F583E332062838C0EB821A08285C,142,114,28,0.08011831372763423,PASS
8FFBF12E6F5669FF2EDB22F17B41EB36C56B54555C8C55FD8B78998C087FCA04,116,140,24,0.13361440253771617,PASS
2E6E9EDBE7A32C5AE01F5637976172E448C55C88A678CB152B231E524A4E6589,130,126,4,0.8025873486341526,PASS
1BB3C4400D801E18EB621F97C85992133AD6084073EC6A5EB07C5B3122F742A6,140,116,24,0.13361440253771617,PASS
920392B10A98E504FB64D62DCBCCF26914ACBA55579362200A14E86EC6ECE7B7,134,122,12,0.4532547047537365,PASS
C4944668DB2B177918E46D6806FB3049370307D1964C390D3E0E48CBBE50859,141,115,26,0.10416255883043901,PASS
C73E8F403A4BE047B3EE7680B087D53AE267EB0C57218F997E7C345FD4C73E10,124,132,8,0.6170750774519738,PASS
63750B80571B1C0F92753FB7852336DE8D5B0A4770D63E7A9C74ED794D603F44,125,131,6,0.7076604666545525,PASS
A09E28E6A7A8B2A88B27A2DA5C6BB971296A04A9F73DDA3D8B82204C3866B151,135,121,14,0.38157390570502125,PASS
5FC79B1729511828C8915B90E0FAA819DE909CCC92C597A9E40382554AF01F6C,138,118,20,0.2112995473337106,PASS
441DFB5229D1C1B9F0C14D3E67B8A6962F2604EFCDAEF93B110CA32C66F61DC4,127,129,2,0.9005235503397743,PASS
3383E91023D2E0DB4928895FF1F0F24D30CF2D5F6B3572F6D44A01E1803222B3,135,121,14,0.38157390570502125,PASS
F4002ADF88D31E4CFF0CE3741B9BC6E65B3A8174088360F2C5C356A59A3AD91,134,122,12,0.4532547047537365,PASS
5B0DBEAC778CA5368E3E7B47322082354C19C3B7279EEE7AF3511A30706BDE13,125,131,6,0.7076604666545525,PASS
5375AE5215B9B2160B106DB486D42BB722EB5FB1F2082F223E01D7ED38916003,135,121,14,0.38157390570502125,PASS
6EABFDC57FF44FF00626E8674597E3D1F980BF80F401BE368C4448E0B91A18BC,127,129,2,0.9005235503397743,PASS
A09AF4FEC77A6E06E742684D8446F0D60DC2EBFAFC759856DAF0E310D1DE6EE9,121,135,14,0.38157390570502125,PASS
9699292D0CDDE52EA50EF667CA0FADF83DE637B51D57F0DADF49FA47048B8906,120,136,16,0.31731050786291404,PASS
290EB2E06699D12AC6CFFC8D804D8AF3E1B4AF2BA64270B648366F70D98FA735,128,128,0,1.0,PASS
AC4E0BD0083603EB8E89A70F15EB4DA8001EC5B2F0E57ED373056D58B7F80D7B,130,126,4,0.8025873486341526,PASS
DE5D04AAE2AF3423E3F07D62D145AD3ED46E7CB46CFFA14FF62F5F2165F0BB73,113,143,30,0.060792723530522785,PASS
1E5D4C92C0BF4A06090577E00F24F1A137EFF0FE6B35B8BB7DD05E0BCE1E0D8C,126,130,4,0.8025873486341526,PASS
9D20BA423973D9E8011B2DFA6E925321E1EA3B35907EC1399A934D880D27907D,134,122,12,0.4532547047537365,PASS
B677AC4590EAECC4CC87185672AF3F48049CF2E66D830EDE597EA708C2AAC639,128,128,0,1.0,PASS
D3AA3CA4CE8B0A445536CAB17292D10A0CD9432F2C49E6A4A707B680B1F4CEA5,137,119,18,0.2605890342736178,PASS
E1392A6CE19E9A3A86FC7EFBA5C5007DFC9401A9D2CF07D89DE287EA3413FF4D,121,135,14,0.38157390570502125,PASS
786C9A31DB16263D82AA9BBE28F0BF0F2DE70D9A2E9B915F0CC18900DC9AE098,132,124,8,0.6170750774519738,PASS
7FB0D80CB16535AE1969E77662EA7548D63E4070322634F04417A9F620A4A429,137,119,18,0.2605890342736178,PASS
AAA465436826AD9AB4386E1AC7363DD384BBBB72C5E02EB68BF60D68E22E7158,128,128,0,1.0,PASS
D9BF735EFF65788EA83D6CFE13D2B7FFBCC168F5619E9C157CC11604E1C6BF5B,110,146,36,0.024448945310089426,PASS
E6040075798CA00333D5F93DBBAD8B506A4956578955A28A0CAAD95C6816CA34,139,117,22,0.16913144470267139,PASS
50318F51FA2C7373DE8F94F12F669C64BE8C3068AB06AFB26A6EDF0465B7E05,126,130,4,0.8025873486341526,PASS
63023EEBAB9F75EDBA4319F4787F25EBDC21F49D470D9B8C4D0700B6D2CC5AFE,119,137,18,0.2605890342736178,PASS
404C4901BDEAC5B6A10B15F89F2B63300A2FDDEB166390A26AA940281F40CECA,141,115,26,0.10416255883043901,PASS
F32B79A6388A5757FC64AE1ECF933FEF4DB05D8A6F587C1F8F97CB730665FF5E,107,149,42,0.008664896726025117,FAIL
C72076F8F713F64EE196835962039E750058D285EC6ECD43F9CCFC9A4FB2E82C,126,130,4,0.8025873486341526,PASS
85E7562FE35741644E0175B2CF7708234DE18DC47F615877D2A4C320B098CCB4,133,123,10,0.5319710580974012,PASS
C4B7C0042CBBF930AD37F9E7936919095E9C93B968CC313D1DE3CAEAAA33581A,127,129,2,0.9005235503397743,PASS
7D2419CBB41C02DC1C3A00827B57D4A2E075C58C6F9B61EB59A66DB4A58C56BF,130,126,4,0.8025873486341526,PASS
120A96F4E683F66A918D7F537B8C125B41EDDE408588B06E33E9E85D624EBFA6,127,129,2,0.9005235503397743,PASS
AEE2CADC722F7260063C02C9E3E3294F43CA8FA6014955AF3C308ACDA2BF241A,135,121,14,0.38157390570502125,PASS
8CF410E5FC626FB1E3228728B1D0196DE92CBD3FC48AF30723AAFA44EF51A9DC,126,130,4,0.8025873486341526,PASS
DFF531755B8CACCC697295D4AF7F2B845B050F7CBF2632291B814AE20BBA68BF,121,135,14,0.38157390570502125,PASS
158F2397169FED82DC86EEF5378073196CA5E37F63DAB98458E1DA79DC910153,123,133,10,0.5319710580974012,PASS
E507BA353762954C1DFF72667ED2398AFD392111629CCABD995286B2FAAB9106,125,131,6,0.7076604666545525,PASS
C551DFD720CFB6F50EC5D7F46B01AA0DD9DC712F7ADC8D3F711E78747C78B1B4,115,141,26,0.10416255883043901,PASS
3FB2C09E959C7BD468EC7E0AD41AC2594DA6F4E5CA1F77B0FF80D10B8CBF24F2,122,134,12,0.4532547047537365,PASS
BD086F87CEE105281EDC73F78DB4FB23452324018E49C55A669569FFF20DD19,129,127,2,0.9005235503397743,PASS
BD2FF7B3E1156196342EE58E738D5FA3B7A84085A15AE0781830903A67528DD7,129,127,2,0.9005235503397743,PASS
EFF3DC1B7BC051E1E65C68E5784CC753E614585EF9D816C3708811539154CEAA,128,128,0,1.0,PASS
44347651325BB57F0AFCBF310A49035312EF6CAF07A5761E5A6BFC0BCD57A152,125,131,6,0.7076604666545525,PASS
546E9612EE3ADEB5C26FF35BC53447D35B6733F7A2589627CDD38BB662E268BB,115,141,26,0.10416255883043901,PASS
50A0FEC14C20253A37A7F55C3B12ECE0E8D6E4AEFA337AB41EB00998D5DA487,132,124,8,0.6170750774519738,PASS
8ED5CF5C026263F176C89CDA903A15EBBF67033DD06683026C6129F85F9F85E,129,127,2,0.9005235503397743,PASS
12897EC64FF4224863F0E04D03C8BD9F525FE432618BE035328A1FB80663DE37,133,123,10,0.5319710580974012,PASS
37F4BB8414EC4C4801AD257C1EE12F80E9FB7F97D9C62F780EC4B183AAFA6C71,125,131,6,0.7076604666545525,PASS
16B900863B7B030811C448C8E3B67483ACC1CE74093B0B567FBE12E90385E391,141,115,26,0.10416255883043901,PASS
E137E0CAA1516B6F454E3AF388173EB79548069B3EEBAEC0B2D158C6288ED5AB,127,129,2,0.9005235503397743,PASS
AB32D5259CEDF4EEB975290DC361C439F746F7886C38C7DB545FC255BCFFBC26,115,141,26,0.10416255883043901,PASS
ECA79BEBCB8012E5155A3B9620EC68C461F7E3B20C06366F33E79DA9B8CCB2F0,126,130,4,0.8025873486341526,PASS
6199BC0668EF0F3749E165B591162E6DAD5DC088EA8F27872ED0A9CC8A69BCDB,127,129,2,0.9005235503397743,PASS
C0ED53AE3E5B18576E962DA2B62B66A69177A6209905E7E4C0B995E4E64B196B,127,129,2,0.9005235503397743,PASS
46C8C242421205304C82FA563BE6A2B205032519D7412439BE03727656A5D947,147,109,38,0.01754895019147673,PASS
D48C4C3A228C7979A6737B0A81844EE8024D09089E276F79B1EA3E03BFD4E489,136,120,16,0.31731050786291404,PASS
D5B81AF22B291FBA7F178038C0F10239BD8BF027254B6AB03B743DAE78F3FEC4,124,132,8,0.6170750774519738,PASS
B0D6642DE264F6187A3C2298BBC6153F7D27E21D589E79066735839D5121602D,132,124,8,0.6170750774519738,PASS
105728FB0BEF14278A085B2011EEBB69B79BC0BF8D26D77079CEED59FBC38DAE,121,135,14,0.38157390570502125,PASS
A085808B581059876F68F51A342D8D529B193B3C9B1C282AD8E7A12BBE5F5005,139,117,22,0.16913144470267139,PASS
69384AE88D802DF683DA46486CD01FFD3F9759019A803AE67115214B7E6003C,140,116,24,0.13361440253771617,PASS
D1A071863683141F0BF5A9DD29487A0504C4F7C54F321176BB6EC524B26244EB,136,120,16,0.31731050786291404,PASS
C6C890FBCF259B8AF3242A70154271932AD20398C231085699EC488F25984892,146,110,36,0.024448945310089426,PASS
1EA90F72E1B5D0AE691FC467708A66F01970BB5D75DE32DABFEFED964E91102E,120,136,16,0.31731050786291404,PASS
573F5176C81F54ED7EC3D99A8A46A18F28209CB3F89AFCC92FDEB0F09907BEEC,120,136,16,0.31731050786291404,PASS
BCFD649511806E05462F90ABA60B1ED5498C247EAC2FAE56DFAC422998DFBD04,131,125,6,0.7076604666545525,PASS
D43C856B025151F5935132288B83F94CF0007DBB533896BD895780E1765ADB92,135,121,14,0.38157390570502125,PASS
FB8DC2B2D914FCE6A81830FBF76BB54BC60F5D73E64287A716C58FBAC1AC6BEE,116,140,24,0.13361440253771617,PASS
447BDB74A70906E7EA09AA19B184086A21D5E64B01BCB5415669BF55198C277D,134,122,12,0.4532547047537365,PASS
8B6B2DBB887A58B59C75AFDC41E24C47FBEBB6B704CCCF948C0608CE0A6AA9C2,127,129,2,0.9005235503397743,PASS
559D150FECB381248AEF4B092D5D08F894142491E642195F81E272176859481D,142,114,28,0.08011831372763423,PASS
A56BF5A0015754534620D3E477BE5059DBE3B214E0592C13FF3A301C4C69AE65,132,124,8,0.6170750774519738,PASS
B194F4813DA6EC171F8AE7D90DF551D2C7D9101CD3E10F0ACBB65AFBE0D6AD97,121,135,14,0.38157390570502125,PASS
92D24BAE11B11CBEFBFB9A233B2AFB104AE4E02C7E5136FD4BF7A01FD1A97F4B,118,138,20,0.2112995473337106,PASS
BD01DFFDDA75F6B427EF4835966FADC05F1D2EDD76AF718F11574EF77BED8525,105,151,46,0.0040402749798920095,FAIL
E0C0145543FAB9AB47458DAED604FF0F97CD246952D37AB0A2BCA38F599A6FC1,126,130,4,0.8025873486341526,PASS
7007CA692E2C85657529ACFF15CFF96BACCEDB9A2189F5B2909F628D09111C99,128,128,0,1.0,PASS
32AFA89525DE98F30178B7F590B6844E19BC16712AFD7F8BF9E26C54BE12E58B,122,134,12,0.4532547047537365,PASS
996A34D0D7A42FA322132FE942EBDEC0CF4DE4F219FD2390F5A1FD23EFCB90DE,120,136,16,0.31731050786291404,PASS
ACD1B23BD20B7C31F025C1D5D345F1BF7CFB97A442E2F0AA5B8AC5CFE04F6A59,121,135,14,0.38157390570502125,PASS
F5B781FE5BCAAC544BC7C7B25AED5CE3F9D59CBA755F8CB55F951B815B91C101,115,141,26,0.10416255883043901,PASS
287A3C608B42161F86940D025B13FAEB627E1AB06363BB400826A20AF180ADA9,145,111,34,0.03358661289689768,PASS
37DF41CEFDF828E2A9A36FFAB3801014D5BF36F7BEE126B8CE24104949758E1A,124,132,8,0.6170750774519738,PASS
C5C61F8C7E8DC4642E9C8340942026C435E27DD445E451A1FF19424B00002EF,146,110,36,0.024448945310089426,PASS
3E88CCE71B542425492953CC4748D40B97467471B97B5A9A39547109692CCD2D,136,120,16,0.31731050786291404,PASS
9A39828412F19F7B0AB3A28E17C36EFC79F54C465C2FF785BB7CF8BAF7A2A5BD,115,141,26,0.10416255883043901,PASS
BFC3629F2A87652A5099D33D719631E6976250952C05043B484AD4D73E1585CE,134,122,12,0.4532547047537365,PASS
F423842419B964D24C7E15E563B0653AD622FA197C3E2AA7C76C1512F2D768BA,130,126,4,0.8025873486341526,PASS
E26D7E54240EE4A775FC035A800BB8EEE6163D8D38038115B6EB47E985B93F66,128,128,0,1.0,PASS
DA0CFFE1AF7817942AAE7780A2C7966840E1861E688317D9EF40FED2A0081BF8,132,124,8,0.6170750774519738,PASS
4F4D760CE7F6604A34F64671FF256AA9BFB95B01B66695E1DF7E23E9281394E5,119,137,18,0.2605890342736178,PASS
75D811CEDBAA76B259E9BCDD5F03E5CEAEF5979E50ACE6F0413CD3D7322B4FBE,112,144,32,0.04550026389635853,PASS
5153692542A40234AA47876E10EC63B419797F8F6B9CF08D914B785596C786DB,132,124,8,0.6170750774519738,PASS
E21C4D649F8D99CCD8523CBEDA403F871E329B0600ABB1D4D8D80613534F8E90,136,120,16,0.31731050786291404,PASS
A24F5D939FF27BD178E87BFD038352ADFB824A645444F5E51BA9319F03DABCE2,120,136,16,0.31731050786291404,PASS
EC23DC36A580F8E3BC5D06B9918A257424513093468E275E4FE1E887C00BF900,139,117,22,0.16913144470267139,PASS
9365322443DABBE6603442D47B6683DD9511CDDEA569DA3AAD2A18C9F08D7A3F,127,129,2,0.9005235503397743,PASS
B9780702B437AD541628F7E046FA31ED64D4224F9DA565722EF3F0117F7C4F7,126,130,4,0.8025873486341526,PASS
3890BC35908643E7E5A4C335B15A893B563E5B77D45CD7EC9144F0A6A58CB306,130,126,4,0.8025873486341526,PASS
884A47632DAC697AB3CA2658B1CE9B5DD8CA7E9C68AB81D3B24E03B05B09CF68,130,126,4,0.8025873486341526,PASS
5C97C4F81F7AB9E733353D776992A42769972014B8EB471AEC1DD818FA23E7EB,120,136,16,0.31731050786291404,PASS
C3C35E0A39F851875986D78D8C529193577F79DDC6D32628465DB0B34121F02C,131,125,6,0.7076604666545525,PASS
32891CA33D46F125B6BE59412B6EE70A6B76A1EF34DA33DF12188B4C2D91E7FF,122,134,12,0.4532547047537365,PASS
BD46E09FFD32E9E584BDE0E588B9E669EC9598E7F7177406DF6C7F25700D6A7A,115,141,26,0.10416255883043901,PASS
C7C4915597A355925DDB02D4FE0E02A6D44064AA2A6DEBD76F83A822C79C49A8,133,123,10,0.5319710580974012,PASS
9919CC51935AD7F81C7E1FC839097BE1EEF3D9EA992748E5092505E76597B95,124,132,8,0.6170750774519738,PASS
1E41447A0B866FECB030ABDA5535E1BC4F79095E9A995F2769C9592B98612D13,130,126,4,0.8025873486341526,PASS
17F8FD5CE0B500A9726711805117106EA43C95AEA7DD8DF1FE50DA64B62886DB,130,126,4,0.8025873486341526,PASS
DD4F12444BDF2EC3EBCE70338E59421CE3F2FB85164FEF3E75968BD444040729,125,131,6,0.7076604666545525,PASS
2651ACD8BD06295EBBBF561C163594AF7669945694F7DA8D93C466967560BF4E,122,134,12,0.4532547047537365,PASS
A46C67816A6122D7CEFB209F54EB04922AA36982ED36A4CEF6A085FA2F55E405,132,124,8,0.6170750774519738,PASS
C15F9F27DFB2B638723E8F76F4C2AC2C24835C7A17D00A11F8CF2015B471AF77,124,132,8,0.6170750774519738,PASS
B7C1C4F7A10409A49830E08EE62DA62FC03F1F5D81610FC2AEDA12E0270DFC5C,136,120,16,0.31731050786291404,PASS
68B135F532A0DA865582FD4B1B88D2AC0696B2CE306A7668E34EA7FDE71887A,131,125,6,0.7076604666545525,PASS
C8EBC61256C8D2888CCF016AB65D03E18E433D17CFD91EE11C6FC52584CCBB17,131,125,6,0.7076604666545525,PASS
4F5380600C5FC2702A77712696D849CE5F9DAE341154FDC34594037B9A0F95CB,132,124,8,0.6170750774519738,PASS
CDF86BAC14298C1C8BCC350022AE3AD8AAD58133510103A3725CAB0DD52F79D,140,116,24,0.13361440253771617,PASS
60E701EFD44B0FCECD3ED6330CB2E821A36D72DE1CD5A9C1C1377EE5F0E6BCE1,121,135,14,0.38157390570502125,PASS
CD3D47CDF2FB334CBAC69C1F16802C69891104984800FC77EDD4320D9049EC40,139,117,22,0.16913144470267139,PASS
B5B9AC8935E45EB6D43AE1C601B1033B516A0D797DCEBB095345D093B39FEE14,126,130,4,0.8025873486341526,PASS
793E697B374BC52CF624CE9A29A73777A4EC0073B65E48D8317EB28956E7345,124,132,8,0.6170750774519738,PASS
B05AFEAFDAF2F549A9CC952012BFB75E8341204896F729AB16CEE1CA8E963A65,125,131,6,0.7076604666545525,PASS
1E8586FC60C00F009494038F568105048311BF21EFD31D3FDCAD1E6A197A9712,141,115,26,0.10416255883043901,PASS
B0E88339609A878375EF3E609F70D3A3B083F95960381F44216F3BEE93EE1E0A,129,127,2,0.9005235503397743,PASS
8E5E9FADFFB6B5910BD058B288BBFEA4A45D3C5A05B8B5044776993BE2350781,125,131,6,0.7076604666545525,PASS
A3B5C493EABCCBBB52DDD4D7043F59FDD8ECA605CCE9C69B22963A2A5C560AD2,122,134,12,0.4532547047537365,PASS
60B48548C10869EB16627567E36EF8EC05974A42A2E6CAA81AD90DB662B54A5C,137,119,18,0.2605890342736178,PASS
BCB6683BD2DE79CB7DB4EEA46ACE9B7F6B815500C786E522F3BC5B2E793EC666,114,142,28,0.08011831372763423,PASS
68AE6CB3935F96BCDC1B03703C8172B67628FD8CABD0F11761C792322D157DF1,125,131,6,0.7076604666545525,PASS
2AB270BCD9FDE789E88DC028CB2F3C976C94940692102023777FABCBF609E4B8,130,126,4,0.8025873486341526,PASS
FCADE4F2607E3C9DCE764DBC24FA2074FD9226D91E2C2C4B5532B0B94FA23B1E,123,133,10,0.5319710580974012,PASS
2ACFA43AF920FD3DDED50F2D65C22B03E4CB531D9463801B546860645637D424,134,122,12,0.4532547047537365,PASS
1092EF7945B8FCD0737E401D01367BE143FB57BE552F9F6AFCD8DB6C9161E224,121,135,14,0.38157390570502125,PASS
B791992BBC2C923B2D0F2C90DA7239A82F71CDF842BE633BB68C90DBF66E2D48,125,131,6,0.7076604666545525,PASS
A3FF7FC8E79B76CD34BAFD8AC5F963FB14D2F1711A856AEF129C650E2762DFC1,112,144,32,0.04550026389635853,PASS
8110B196C9C2743448CD63B15CD42C32C05FE2144C9CDFF99B397D11BA8F0EC8,135,121,14,0.38157390570502125,PASS
845B8C055CFB9AF359832535F4359065564372CE3C1705EC318A75606C303F56,134,122,12,0.4532547047537365,PASS
3BF9A75A98DF630D46809220795C2810905D3F4509A007C05BA6DDA5B287EE,141,115,26,0.10416255883043901,PASS
43614095BC65FAEFB2A0ED9972BDA6DB49B3AA3E211E5F2EA68AAC5D141CB23,127,129,2,0.9005235503397743,PASS
DEAB2E9A8B587AADF491BB0866F532C418EFF9995968C61FC394E2BD46FD39B5,118,138,20,0.2112995473337106,PASS
86A4C226DDB539227EE6565954B22B3D7DF36CC638F44E957199AD9AC80B263A,126,130,4,0.8025873486341526,PASS
A6A744576A927F6AB999FDBD8CA0BA2135835650BD91B5AC7F6998F39FDED2CF,115,141,26,0.10416255883043901,PASS
56D3F3B2CCB7CA0D4C988C866FCCCEAD37902D231F67637DF9AE5C7A3E7EDFE2,112,144,32,0.04550026389635853,PASS
D5349649D1C4FCC7DA8DF35D0646047251ED160C508EC4BEB7552DDBAA09C330,132,124,8,0.6170750774519738,PASS
76A6E7AE9774E196F69F7A6AA3D9778712BCA8F94B606421B92A9257CB0CA934,122,134,12,0.4532547047537365,PASS
531F8FB99026D8CCD5C719388E30BD3F2906B49FC0842759BECF93CAB89C0566,129,127,2,0.9005235503397743,PASS
BCE9DC59EC95AA32A65E8F3506BEF790BA6C99F2831B116DC081A13983BC079E,127,129,2,0.9005235503397743,PASS
F110EAFA19B320C05A3C056E7D45A2508FB9A8A7B47DB9AFD69D2C4BE9716AA9,126,130,4,0.8025873486341526,PASS
AD746E600EC78D3B8E2BA496B31B82A203AACCDDB5D1A24C55AE26584328D63B,133,123,10,0.5319710580974012,PASS
945CF1E0D4DC3B30B12CF5E633F96B087C131C9DE3DF5F68E1392DDD1FB3D8AB,117,139,22,0.16913144470267139,PASS
A35755CB955D238BE99BF646171BBC8F3BADFFACDFAAFC9E1809225CD62151C8,118,138,20,0.2112995473337106,PASS
263F7C0E1C667EEC584BF72A739643C1B4F38AD66B629547F1070B114E6E318B,126,130,4,0.8025873486341526,PASS
A7D50E0AEF5A576CF5E773E11F58F6672236A30D87C8F98CB60AF1C2E5E848CD,121,135,14,0.38157390570502125,PASS
3704D3E3F890BE3B3A6F50FB780410A28D0838CABDE3CB59007776C5F650376,132,124,8,0.6170750774519738,PASS
9A711406CA7635F9A292AC3C6D093C2DB746E16880F90F43832806B08084FFD,142,114,28,0.08011831372763423,PASS
59301BB7502791B06DD2C7441AFAC9BD1EA2DAB9B0F3451806778B22C47DDE85,130,126,4,0.8025873486341526,PASS
8A31C06A9F62017BA5E269EACA24610EC0854AA655D9B9491372095DF37D34C0,139,117,22,0.16913144470267139,PASS
2410ABCA3157B9DEB96FB940749B5DC193E44ECBF3B97D30DA1049DC85EDDD2D,122,134,12,0.4532547047537365,PASS
14DD8D7F814B80A05F010D33309C9BFF7F8D2FF77359837532B66697D4325C6D,122,134,12,0.4532547047537365,PASS
E8D00F795269297C7D5240C9960681FB219BE3D29222D96007827B4A5F8E099A,138,118,20,0.2112995473337106,PASS
4528A6FB852CD32DCFF58E03F2D67A281618364211AB558B86F818774322EB0F,133,123,10,0.5319710580974012,PASS
4C8812E01F4C637148139E79409052D1EABF88CD4C16593654691232170AAEB8,145,111,34,0.03358661289689768,PASS
B6930E5382E9F888E5D61F4737510786D7543F3426DA8206B64973A9C91CC179,131,125,6,0.7076604666545525,PASS
C5B1AB265F287B9F4AB6E24CEE7FCEF073566E2E0FD5155B19FE6DBAFA8FBC9F,106,150,44,0.005959526470109114,FAIL
2C962B68096C93BCBAE9CBA6CBA719F8110D1F4F06349E5E73F4CB5E4197A807,127,129,2,0.9005235503397743,PASS
CACCB29B6305E72D1F84390EE041255B478B204B6B7A2A9483728C9820143770,143,113,30,0.060792723530522785,PASS
2468098B3CE56B8B5B06716148B33D138B59FC0B2D8B3C194F4599BC5ED7D977,127,129,2,0.9005235503397743,PASS
BDA7EB1971DC849492A303F6AF2177F7A3B28E89DC7AFA62C7AAA708DD13C914,122,134,12,0.4532547047537365,PASS
1C13844EA918D6342DD2A89AFCC265FF46E576B1B0571427A25254B8545B97FD,130,126,4,0.8025873486341526,PASS
BE58C6DD552D4CC9BF9315A98F8813AB992A41B4825F9291EE9408F0041C6058,139,117,22,0.16913144470267139,PASS
8B392AE422A16A119E9BB0FD7D5FB23A0812855FCA318077ED9C7BFE5066EF4C,125,131,6,0.7076604666545525,PASS
38054F62A5E6A82CF319C76D4C99E5E58EE103AE910441BBD0A122D42CC49CEC,138,118,20,0.2112995473337106,PASS
E3BDDCDD83C4CD9AAB04F74068F9D4CF77147AC64471406A61F9BCFB15D2EB10,123,133,10,0.5319710580974012,PASS
2CAB9FE68F621E788362EF55C07D58B754533E9B2410495DEDA71739B11EDD59,122,134,12,0.4532547047537365,PASS
20AD17F1CDFC28119D70966F4C289A088B0B0F73DAF194352C249B9B104D88B3,138,118,20,0.2112995473337106,PASS
F9B2E4B37BDDE86B189C80323EA4E5D13D9FE149F890CE91C72B432BA18A6674,126,130,4,0.8025873486341526,PASS
1AFBDB4380238DE847B8FC3855F4502E34D9E5E9E00EED24CCF2BCE83E944BB,128,128,0,1.0,PASS
58E0A44EC9BE32F7450BBD95E596A2A1E58807E28564CFA0FAD8DE2909B79916,130,126,4,0.8025873486341526,PASS
BBAEDD553AE4FF3A04E2405B4C8BBFD294551336B298F2DE4917F05CC8C66014,128,128,0,1.0,PASS
E2E5E9DAA2F6C07B3B2DB2DCF0613A699FE38A77C926501416B5BA1E439AD0E,126,130,4,0.8025873486341526,PASS
161E64F2FBEA7B415C65841270224A7026A21D16BDDF43C21135AEAA2B675E6D,132,124,8,0.6170750774519738,PASS
DF4D9FF02CA3B27FC3C2147473AC2829CA9CD36C2465A189C19962311A454A31,136,120,16,0.31731050786291404,PASS
C7038788895EC73148F2DFF68DF88F4EB17C75727E3D6AEEA9F297053E91FCC9,116,140,24,0.13361440253771617,PASS
CA22D408414F38D0DCA4A667E4A480814F3D3574EBC8EFC376F35D1B4C9DD2F1,130,126,4,0.8025873486341526,PASS
19509228E57E693F78B8508832C5F49D353E4990C367AEE930AC41F114DD511E,135,121,14,0.38157390570502125,PASS
B069FECE416092298A2D14DD7F04FFC4C254B605CA202E2E229A69F328774EBD,133,123,10,0.5319710580974012,PASS
EED35E14D000558D7BCF87DF6E26F1E86C2B0261620FB0EDDD219CF8B453FA,128,128,0,1.0,PASS
256FD49A7202C3E2200AB0C60E746006967F6BD2FA659431E1E73D71861A1476,137,119,18,0.2605890342736178,PASS
57C025D71FE1BB11ECCD3224AC06CE8905C2888656981C65E7483BE3CF69B48E,134,122,12,0.4532547047537365,PASS
9C103EA09D1AD4F788B710A2AF04CCE164F64168218ED0D9E8CAA8FEE31A09EE,136,120,16,0.31731050786291404,PASS
A8171D74E3EAF2380CFC362E1D0BFB8D61D54E5BF40C518756DDFFDEDA1CC7F6,115,141,26,0.10416255883043901,PASS
75E98B6548D02F5C6601681E8FC139D7657AD95FF46D9480AD684BD6AACD91E8,127,129,2,0.9005235503397743,PASS
59D10D7C2916443FCA64A61746E6C344E0B16C9256435B4084AB5A2CD277654D,138,118,20,0.2112995473337106,PASS
7E676C7CF478BB24BBA83E3453761800C9FE0EB3696E87A7E051B10AAAC7E590,126,130,4,0.8025873486341526,PASS
BC789B7626CE861223925DC38A276E8320328A00EB9013032527DC7618EA5E6E,140,116,24,0.13361440253771617,PASS
E01F42A9E4ADC0B372B76F001A733A87E5B03E65FA04D616C648CEBADD21C0D1,132,124,8,0.6170750774519738,PASS
3CC356F251400F347D8FE638422355283A8A1E7F69EED93B42F23996A21E0BD4,131,125,6,0.7076604666545525,PASS
4B0F54EE7427AADB09DBE6164732B6B20B105C79BDB201DE3437A22FC1F031D7,127,129,2,0.9005235503397743,PASS
42CC1E90534106098E50AACBD8FECB6B6E83EABCC068362A350783EA9CD08CCF,137,119,18,0.2605890342736178,PASS
ACEDB51DA7E89DD02E54FA7A1FC2E2A24ED042D9CBB717F3EA6AD314BDA70262,121,135,14,0.38157390570502125,PASS
13CD6DDE20394782DE20755DEE45F25E2D4482DD07818E8A1850A6BB94E11AC3,136,120,16,0.31731050786291404,PASS
255CD83AA1AC5549101732C80750551D169A9279D6FE79C8FB17072DEA327F2E,131,125,6,0.7076604666545525,PASS
BD26B8ACF519DB32A289BE2944F92474B4710EA2EBE9B259EBB696F7A173347E,120,136,16,0.31731050786291404,PASS
AFFB7EBBBDE9CC508FE6D04C2E4B1F3461E0E862A1EA7EF3A2DBAEF2118F7401,118,138,20,0.2112995473337106,PASS
5C05844F37A7B2C67DCCF2057C07D3910E008A06D77DCA003C69A1FEA4F9113F,133,123,10,0.5319710580974012,PASS
D3C1DF4BCEFB42F2DE81ECD3074F2891D79DF4AFA0FC044278FDA39CB97824E4,120,136,16,0.31731050786291404,PASS
AC9BE666A5801F219D96DEF6E7270A61BACFCB570E41DB9FBEFE8F7F4AC5CB76,110,146,36,0.024448945310089426,PASS
8150DBCAAFE5848C8069C3DC1B1D7264C81233F63E6BAC96E9F4831553887122,136,120,16,0.31731050786291404,PASS
F363249EB87FBD564D865CA6960B976CF0A41392E86FB8DFD9120CC5BB51E94E,122,134,12,0.4532547047537365,PASS
A653CBD2F7881F0821695ED8664638F539A0984118B3B6F8201E7C23667F8B77,131,125,6,0.7076604666545525,PASS
183012CD79BFA9ACBD4589F52DA35DC8B4173C4BF76F316340F924DC7CA4D579,123,133,10,0.5319710580974012,PASS
DC78B358B56AD940EB2F090F10EF9A39BE68918A493AA446D3BA22C7F88A0852,134,122,12,0.4532547047537365,PASS
AAD8BF326D002D1EA2F9D93B31CAB3C040BEAB5705D10B43A61686F6C12BD040,136,120,16,0.31731050786291404,PASS
1049DFD1653533C6DBB56404ADACD1E04B7E91B0C164F51AD76D98051CDD1582,133,123,10,0.5319710580974012,PASS
F06CCE54021AD2ACDA5CD04C9A775F4BB6B0DF6383259882B46339693A56A4DD,130,126,4,0.8025873486341526,PASS
8E4A05B05F8CF0D5DBB72A65A81373B7C02822F2CA3A488F1F4F9D6135A7FAEC,126,130,4,0.8025873486341526,PASS
87662CD2BFE39C39622FBF7F3730416E7A2B10A04889A4C9A1AD9B07D98D5F82,128,128,0,1.0,PASS
C05BE0C70AF000F5BEA0F8D920D019D30221883D86F770EB5CDA8B08272A4650,144,112,32,0.04550026389635853,PASS
2C90F7808C9A0577FFA56CA86A0996D8496940A826EF0376128D0E1DAD911D51,139,117,22,0.16913144470267139,PASS
4C00D1D4E67028F788CFC189EEA3165863D7EC0776F1910F6BE89A4AD89DD713,129,127,2,0.9005235503397743,PASS
9382EB55C21141223E9A17DAECE3414B13B6837CF9DE2EA449827CE0CE1677FF,127,129,2,0.9005235503397743,PASS
7898CFD625C9F07DFD2C0A0B38F6ECA73EA6CA3AE0933F575BD27B54108E5A23,122,134,12,0.4532547047537365,PASS
82B1E50ECD6FC6E56897998161CC5D7372CE6F894BA05C4A7284C8672526EB6D,129,127,2,0.9005235503397743,PASS
F15055FE700CC06D52490BDCB23E4E9A33F90D46B7CE1EBEECA04D0983917CB3,129,127,2,0.9005235503397743,PASS
9839114039DA5B60342241706E492488FF9AC742358EFA6AD1A26385F61FF1BA,136,120,16,0.31731050786291404,PASS
8FA3D07E80A22DAF74A4F0CC673B5D41684882FE10DFE477E5E081EE85618DD0,131,125,6,0.7076604666545525,PASS
F49B75F7BDEAA7935FAF418B15F8BC7091EBCB7A881CCDDF48B5091AC3D9641F,115,141,26,0.10416255883043901,PASS
DFA824972DB6E32FC70357093A765899CD1CCE02C64AE4B92E0F164343D4BACC,130,126,4,0.8025873486341526,PASS
42BB02FF9A410F634904E7D2D1C333CB3DBA0AAB20E8D19E935A3C185B63AE00,135,121,14,0.38157390570502125,PASS
3F1F614DBA6A740AF3ABDA3F61F9DE6D898598FE6E39E8E7D69B71841C8745E5,115,141,26,0.10416255883043901,PASS
84FB43DB35F705C4B6E4C3A727CEA8A48D1B59CDB4A6B5A6F50979357F37BEEA,115,141,26,0.10416255883043901,PASS
4619F01687F8E34E25870FEF560C425B51B0C20F21D13CE1DE0B14E054903D66,139,117,22,0.16913144470267139,PASS
DCA48FFD7BE614D4A14B55091133ECE682132470B99201368AD39044FA302AB0,141,115,26,0.10416255883043901,PASS
B963F26F76552B5D71C9B52E8863C9B6D15D09F245D9902D7CEE7492514ECEBF,119,137,18,0.2605890342736178,PASS
10DC69ADA7507AF66311C4737C4471622DD065AD4838CED98D47F3082718C5E,136,120,16,0.31731050786291404,PASS
954E5A4E88BF102495A6B7FAF08264E07545FB15BF1EC17BF9826D75DC8492CC,126,130,4,0.8025873486341526,PASS
8AE75961D4A70720B00B4D52F7C4259B6E0CB067A26F209374A4D0D32061EC0A,141,115,26,0.10416255883043901,PASS
9C34AF7B7DA737DEECF12B02D4143172CE5ED848DC7786F8518083F253D9E50,126,130,4,0.8025873486341526,PASS
F308EFF399A168BC45CF640ECED51C6F68CD6AEEE06CC3D8DABA89C5F9A36B9D,117,139,22,0.16913144470267139,PASS
7F148EC89BA160A6E2BDFB04835614B0D4A4B12199B529E663337E1195CF483E,133,123,10,0.5319710580974012,PASS
788BDC97BB3AC1DF49D2F2C3A37FB16C5BF38A674951F08CF59C48F3B9D01E01,120,136,16,0.31731050786291404,PASS
E5F8F55856D5409F507BC1FF322CCA70FF77F0518D9D541754EB10F606C42B23,124,132,8,0.6170750774519738,PASS
29C9F83CBC5E174C886A85BD5DE6F78C528F1A8E7DE7CAD83C39DA20CB817FEC,120,136,16,0.31731050786291404,PASS
7931830E54165032019D61C2E288BEC8325487EA1071CC250C8A3E559C646B00,151,105,46,0.0040402749798920095,FAIL
6A4CC2D1FCA7502AED12D6CCF7592951CAE952A4F43FA5EB411EE03AC42238D2,131,125,6,0.7076604666545525,PASS
44A1F78D59AB5A968173DC53F95D68CE140CC05326ED7B3948171D0167C78FFE,126,130,4,0.8025873486341526,PASS
8B95012CE39C4996012F69AC299F3546675B0F066DF758AAD0ED8E30ADDA781F,129,127,2,0.9005235503397743,PASS
20C78F8A2130A9355C85DAB008879AB92B1C6C780E273FB4F3AE2E69261203C1,140,116,24,0.13361440253771617,PASS
59C77FF3DF2E79E7450290B8124CAC60829008D92C826E564018AB5E2590E76E,138,118,20,0.2112995473337106,PASS
49399BF67152683CB81EA411E16395640E7AA1232949B8FAF6CFBB4CA448C2C4,134,122,12,0.4532547047537365,PASS
5C2FB2B7FABDA5D95593828BCDD0D26C759CE195182F1623F4548135A40D47DC,127,129,2,0.9005235503397743,PASS
5B256ADDB927783549B6FD12CF2513A0BDD8830ECF24D001D0E16C589A53CF00,134,122,12,0.4532547047537365,PASS
948202F079460EAC92F4BA7992453BB79702DF3739B29226D06E82DFEFB8B076,128,128,0,1.0,PASS
E3C4EA9325E1721190417A645D5643BD21FC5277D9A8150545ADCF2CB578230A,135,121,14,0.38157390570502125,PASS
BC07C1FFC71630FBD30AA42A4D04BEE185E5A7EA15BE3EE998F2F6C269365CFD,119,137,18,0.2605890342736178,PASS
D3A6769BCFA724E98BD5082A208CCE477CA5A7E90A5C26B2A13C5668A8C5866F,131,125,6,0.7076604666545525,PASS
A946A4862A25839D93588DEFE5FCE6CC96D226E273407D1889AD147F008C1FC5,133,123,10,0.5319710580974012,PASS
4B742B5CB5DDEAD599D4579FB5DD98E04E9D043751194BCD45CDEADD7DEC556D,114,142,28,0.08011831372763423,PASS
7B0CBE3AA209954AC131D068D8181ABE95E8BB68B47CBD09FE6A79078F2AA7CC,129,127,2,0.9005235503397743,PASS
C652E241801BB38A689EE581BB1BF7BB275555AEB1CB956F3B47A4E16514B399,125,131,6,0.7076604666545525,PASS
75A1EF1041851B9A86B4DB940ECEC313C403F03BC0DC6D71032469B371743C21,139,117,22,0.16913144470267139,PASS
F0EFDD3E44C16D6365FFCA98873FF874D77681570F70C6ED6A28C2471E2F188A,120,136,16,0.31731050786291404,PASS
5A22757905A8911FE0BC3E6CBF71EDFB70D59B3F32F6BBAC8D8118E3944E75BE,117,139,22,0.16913144470267139,PASS
A5E6AA5A6722F3C61F414E382BE5122EFA747D6EA5DD3FC58BAA96DCC66587FC,117,139,22,0.16913144470267139,PASS
9A7FA09797C1D5D0EA099B3CC0D94CEFA12390341EC9A0956F7361D3FCD2C241,130,126,4,0.8025873486341526,PASS
FBD36A4FBB5B0E609044A79086296DEF03179438322866914CE04035A4C582CA,142,114,28,0.08011831372763423,PASS
C63E20EE1F6213D7BE9A14877D3443542D1FD2A42C6710C5CBD11938B5F7EC64,128,128,0,1.0,PASS
9EB2DBAAF89205378A65FDAB5D6E2B5438F6C3D2B6CC7DFEA9A1A4589104C2DC,122,134,12,0.4532547047537365,PASS
8C8F0547EEDB9BC400B2F04A441C8FF4C1A01948703CCF344DFFEB34A3E1D6CC,132,124,8,0.6170750774519738,PASS
796B397802A60D97CE9DBD5736C8AE7546CA0A16C4BBC0352642E8BF2F625EC5,127,129,2,0.9005235503397743,PASS
5A6ECFBFFDCDF7C4A732ADAFDBDC4BA84EA4BF750B41C43AD6DBBB5A87411342,112,144,32,0.04550026389635853,PASS
66297B288419CB9103059158C89A8B29155F6E0426F84D1DC9F638948740B8A5,144,112,32,0.04550026389635853,PASS
422DDFE1D21B9ACA5A26129B91C2BE07E0EF97EDF3C1EC0EA5F6731A1292DF54,123,133,10,0.5319710580974012,PASS
9A41B4414725934964B4B7CCBE092F615C13B5E9567476E4F1F5AAAD69A011FF,127,129,2,0.9005235503397743,PASS
C103FF51684B9C39F3BD14E68A73860C923A5D11D0559C74C9EBE864DAE3AB66,128,128,0,1.0,PASS
66335D3CB0A8F92A91A6A6EF00618F99C04358E54EBB440125FB689D4188A351,139,117,22,0.16913144470267139,PASS
59C42BC16EDA4690B437058DF171AB6D438B8C19537D0397B1F3D05AA442A24B,134,122,12,0.4532547047537365,PASS
9BD2FB110EECA1CC613B940356A380D3EF0E8957D135F3381B0437F75686204F,131,125,6,0.7076604666545525,PASS
B835E167B3F906CE9B7F2E2FDD6FE95752805DC5F1904873A8025E32AE07BAA3,122,134,12,0.4532547047537365,PASS
38EB464ACEDF8F97A92DFE8080D3B3B9725D2E6BB8C112C18122DC7381E065DD,128,128,0,1.0,PASS
463512E13C7CF7EAC9E94CFB0D7E9173D498C56725A9D7BBFFB206E544E7BF58,114,142,28,0.08011831372763423,PASS
7DD921553EF2AE10AC7C17927237E594D94246AF23CA7B00FB7DCA0DB395BB02,125,131,6,0.7076604666545525,PASS
9B91A72DACFB253E5E73645EE0E49D14331B91DFC954409BD93EF96E01FFB665,118,138,20,0.2112995473337106,PASS
E69981C69029DAD6D43532FE189DCFB03E128FA73826E0A2A852BDC66CBA0F1D,130,126,4,0.8025873486341526,PASS
F2AF957E9CADAB056CB3506C1C34FD27CED08BA8A34999DE172F4FE2233F57A9,119,137,18,0.2605890342736178,PASS
924AF9B2C0F344EDE5DC7B6A66CA1A349BCE750AAA95EDF072C2A7A2C9507AD9,124,132,8,0.6170750774519738,PASS
2F430337A7094B82E3C8937EF5ED2587CC20408413D4269818FDB9547D45242D,138,118,20,0.2112995473337106,PASS
FE495F4D3F5865150E0FE93BFEC11E8D40C39D6B16DBE02CA10F6DCA70C20339,127,129,2,0.9005235503397743,PASS
186C92D9A16DA3C63D49EC6965B771DDD106ABCA764260518421A9954071D9FB,133,123,10,0.5319710580974012,PASS
262D4C12AD434CD0620D431795899D35BAD8D342F8074D6E2CE8D0CEA3CD1494,139,117,22,0.16913144470267139,PASS
4AAF886895B85273B52E606F02DC37AC7AC7841C2DBA87C71563A81EA385126D,133,123,10,0.5319710580974012,PASS
11EC31C086FB337C2A4E502431C25C36770BD31118CCF518BBAA45795CC517C6,136,120,16,0.31731050786291404,PASS
60E96770668AB5D0BB87EC9F6B536E651849E2B646EE103B446D2175A9907BFA,126,130,4,0.8025873486341526,PASS
69566EA199A41AB3B9F0E3D1E05D82292C2A648240F69E94FC73DD638E585D6A,131,125,6,0.7076604666545525,PASS
7229D8A6E2AB531041E17D934818EF675677D7913241ECF1CFE48C7DC2FEED73,121,135,14,0.38157390570502125,PASS
F0C24A68C2D9A4C3660830D92FCB2B3BB93BDA2957E4A677F39138603554412E,133,123,10,0.5319710580974012,PASS
18383CDA276EA34E34A7B6906DA970CDFE420448227B42802E0EF8D11B0F5E31,138,118,20,0.2112995473337106,PASS
8BCF80898A4D4B16BC886B2BD2AA9D65B057DD7808803402E80DD5B38ACA3D3A,138,118,20,0.2112995473337106,PASS
3ACBC2E308CDECE148F09B8C7142C6BB6C5D553BC6496DFFF5FECB9D3956B170,118,138,20,0.2112995473337106,PASS
C01BD95CC49455369A1679664198B6D46E233CE2393462F833A289C26543402F,140,116,24,0.13361440253771617,PASS
E64BCEB01BBED81591E2175C71C6D1CA857BA315E37EEB755AFEAAEA9380FF46,117,139,22,0.16913144470267139,PASS
15C661611E2BB9C3323FFCC44ECA658A9F614F2704F58B4EF83DC40A32E38416,132,124,8,0.6170750774519738,PASS
47A20D11582BE30EE307EBF38BB1A1738199927E3CBCC382DCD713198BBBC759,127,129,2,0.9005235503397743,PASS
80CBEE56B055040F9E84FCFACE67B3473022208D4F8D18B6EAE76ACE035E432B,131,125,6,0.7076604666545525,PASS
A3859CCDD7CAF2709BE1CF37AEB495E60BD455EF78C0B5EF0C258867F7AEB299,116,140,24,0.13361440253771617,PASS
C42F1118C5FDBC4BB7BA90F951AE560020118C330641354B10055F147549CD00,147,109,38,0.01754895019147673,PASS
765004739FAC3F0562A59E1D6DA884E9219F8F5EF9D680CB9689DC330C3DAE43,128,128,0,1.0,PASS
9486E8FC9BB3EFD0C44F8DB322F5AD777246A168FBDE51EC7D91FF0B977654E8,113,143,30,0.060792723530522785,PASS
9E304F0FEC96ED9C1CEAFBFA1C6AC1EE29DE9B401E8E8040D4C5CD2CC70BE666,126,130,4,0.8025873486341526,PASS
9E31ED5947A7FB76D798AE53D398FFAAF98FDC9417027562764CA411710BE8D8,119,137,18,0.2605890342736178,PASS
DA03168FD98ADA96702A7246FB56F0F85DCE93477445C0265635F357AED5B143,125,131,6,0.7076604666545525,PASS
C8FEE6821F4D0C37B2B8405D545012680BC0299948122A4C448001279FBA2492,153,103,50,0.0017780505982168669,FAIL
8592087A7EFC585CFB0908221955C6EDEC6CDB78833400E961AA263CE546EC8,138,118,20,0.2112995473337106,PASS
54C30CB5E8C6F65AD710628F6EA9F2024A8D31D1541B99A495AA9AD909966422,138,118,20,0.2112995473337106,PASS
2BADD2CBACECD70DF7F898E15D5AE0A4637C7A352CD4F174E34AEDFB155CACDC,115,141,26,0.10416255883043901,PASS
5A8322A460529D0B460F42167E8D0F7EEC99BEF9C137E690C7580C9A5784F6C6,132,124,8,0.6170750774519738,PASS
EBE287647BCCEC1FF5099ED71C3762FD1EE0B888C1069AB99F086439F46888EA,126,130,4,0.8025873486341526,PASS
9CE034CF424153A7A568ACCDA4843FCF6073FF04909EBC3839B16210EB8D3E2F,131,125,6,0.7076604666545525,PASS
62DDDBBC859F82A253D25825AEBD2B7AC644F0BF69CAA519A60C15A405DF1CB1,128,128,0,1.0,PASS
6EC73E0410E36992D4C22D89F9FE2E88FB9098435FAC033B1C3288BC0CBC1C7A,134,122,12,0.4532547047537365,PASS
10DB82FCED8829B71626F5A012E352CF61D7720BEC6E0BC9AA6C8228EF10494A,135,121,14,0.38157390570502125,PASS
471400764DA0A1E7121B51769F9ACCAA13BBD0767FA07BC94BEC06D23E12C63,134,122,12,0.4532547047537365,PASS
B0AB8BE72AE92003980951A8BAB1BE51EFC08D86D50672185D93784E669ADBE0,135,121,14,0.38157390570502125,PASS
A9F0F2D127D89B7C4CBEEF58F9E2409D84181DE9267519BEAD5F9969A9C0A465,124,132,8,0.6170750774519738,PASS
4F59565BED7FDF2417219E9103635C652D082F1C7AF4C9126B2A92C131D87E3F,126,130,4,0.8025873486341526,PASS
BC7D05B608C3DD46E07F17D4C2146502F9CBA298C7897178381CDA8FD46E04D,134,122,12,0.4532547047537365,PASS
212068F7F143733BE1864E0E94C7F2113ABBDB9DA6BF84B818BD09673792E6DD,124,132,8,0.6170750774519738,PASS
C5AE3A2B35705C797874C7D4700DE4CA0601F4036507AC23B726A400B892BFF6,136,120,16,0.31731050786291404,PASS
DF34E01972C33B6535FF2F237A2C1D410E9B0258A3DD3546D47C191ED37F3927,124,132,8,0.6170750774519738,PASS
96DCD730617C491A2C69155D62CBE3785C82867465866761099AF275B8727EE4,131,125,6,0.7076604666545525,PASS
CD333249B32749EEABABBCC7852BDD1FFBC7C7FB4077980445C3DCF6227BA4F,117,139,22,0.16913144470267139,PASS
4B06F76B0FB21999F4682024AF92DD0F395438BCBB63E8DF4A73EA6D99103275,126,130,4,0.8025873486341526,PASS
DDDEC7BC02CE14582360B24E4332B7435F9E895AD749F9DAF1BC5F3DA3FCF6E9,115,141,26,0.10416255883043901,PASS
F452575D4B8D0C36E879699A7F6D701D5646B886CE01C3A80A8EC1089A7606A,138,118,20,0.2112995473337106,PASS
ECA1B538740F7CAA62EAD550B9063A8320407291999028BFB9191375E69444E7,138,118,20,0.2112995473337106,PASS
810E4C8C2B50FE385B9F12A0606A00D82B6ADE913F8351B4CFBE4E3D2B3F8DE0,133,123,10,0.5319710580974012,PASS
E0DE25DA62F69C1703B56FBDF768D67C35A65CD87138E48200342EA9A46BFF54,124,132,8,0.6170750774519738,PASS
D24ED2422F51A0743644FA4DED1D4531E20100EF5FB1FFEF282D2159E05E7225,132,124,8,0.6170750774519738,PASS
C3085EA4B67F1DFACA157D54616A6A10E4FD3878A4AF888EBA73866ACFBADE82,124,132,8,0.6170750774519738,PASS
8C49B427803B970A9D65A1E8527439A90B484FBF39C8C253117FAC9F48E40B9E,134,122,12,0.4532547047537365,PASS
886AE03A9F601A20E5092D9FC6E08826358E77F9FEDC1E6671FB58484EB9BF55,126,130,4,0.8025873486341526,PASS
B1A73318FAF240368299F4B21846FD3BC2CC1C593C76BCEBCD40DE192F3CABC2,127,129,2,0.9005235503397743,PASS
6C7939423546206718466021AAE5E666B5A02FD5627D374B55EAE4996AA449F4,134,122,12,0.4532547047537365,PASS
2160F37313C8DF0F93CFFACA4DD9585CBF8076670B5F7B99846D2BE130BDE004,124,132,8,0.6170750774519738,PASS
79C760F9F7CF83F03BB5D70C0B1D73FD7E3934CEF3C2B59312CB8E0912974CEC,117,139,22,0.16913144470267139,PASS
7ADFB462B7CC9264E92E396BCAECCC423E671F14D5899F3B51A109BF43A5A7E,122,134,12,0.4532547047537365,PASS
389C0F96C29FD8B6146188EC74AD6F982B88E34897DEAE224E36A9D2B9C2057A,131,125,6,0.7076604666545525,PASS
8FF153A85A46DD1D54BFB6D7F4C8B38DDBD01FC99FD49D07D7E16AA921436D75,115,141,26,0.10416255883043901,PASS
D588D209A5422B33289B7FFE7EA1377E623E0BF12C6BBF45AA1AF3ED00616A64,125,131,6,0.7076604666545525,PASS
B73AD05676413689E0797EB8D0AFB4A9732031033DE44E01B57F1F2307C00270,136,120,16,0.31731050786291404,PASS
368761D77D06CDD72DAC6FA0BF5D86E9389C3E2C8DA2BC4A9CDC2400596D6AED,124,132,8,0.6170750774519738,PASS
A11788C7AC9F84D5868C7A4FF5654C04844B65729068165D4D7CB247616CCF28,136,120,16,0.31731050786291404,PASS
2DFF168B59BDE621F2FE22AD4604E799923EAFD5B6EAE615DEF81A0D6C85AB64,118,138,20,0.2112995473337106,PASS
9997263874690F55E65EFE6695C6F1D5060B02AC1AE0F5DACD6C962CE98628BB,127,129,2,0.9005235503397743,PASS
620ED5EF01C432D112B2C525F046C0BD71EC2312BED878EF2078B304B7F4B634,134,122,12,0.4532547047537365,PASS
1B8284B236D1C58FCB6A38098413747FCA0904222E7E856D1BD679E2084619F7,138,118,20,0.2112995473337106,PASS
74DEDC8CF83DE0CF8011DA1A8416E28E1DF9E0247E9649F5DCDBE110DEA4F19C,127,129,2,0.9005235503397743,PASS
306BFFC6875214CABD65D099E40E70EE20C7A7CC75C850BC3038C212BF9DE6AE,129,127,2,0.9005235503397743,PASS
D1A3D4850F3E66BA05EA1327FDCB8B060503AC2CB6E543F92C32F191EBA85420,134,122,12,0.4532547047537365,PASS
62F58C85B3655F57F91DD0833580119464FAA8906E8C077F91A487DBD0D7C1E5,130,126,4,0.8025873486341526,PASS
599E23F5882453D06D30E14302CB342BA267780A28C447F110C0A896AA7FD755,141,115,26,0.10416255883043901,PASS
90B56552A3551BE28F40E1609B91B594A70C3873266751EE9562FC3835CB2DFB,130,126,4,0.8025873486341526,PASS
ED1CF9CA896448B8AB0DB018F61183C2B6CE386B6C2A61C7F2A446199849A710,139,117,22,0.16913144470267139,PASS
1FFDFAB6D3078AEED40C494EDABB569D0DDDEA6AD5486A3DF8933422BF9553F6,114,142,28,0.08011831372763423,PASS
F77D1497A1E03B4FB6F04C5902D42EEB156FA54664680BB7F6360C01DEAD1B21,128,128,0,1.0,PASS
4C2D9DF99C9E68DC6148DAA1C7AEEEB0BC215200EDF7CE66D8F23F573D4CA230,124,132,8,0.6170750774519738,PASS
659531C3CB5446A60BF1011ADC2804854474B936316398BD41F5DE821D7476E,140,116,24,0.13361440253771617,PASS
CF1A91AB9702EF3AD874C4F6D829E473D0709140C4C313E6DB38E2D7807D7E7B,126,130,4,0.8025873486341526,PASS
F19C583A95B7029FE972B8D0E4013E26DAD9399478E45CC744F06EEFC477D83F,123,133,10,0.5319710580974012,PASS
8F5526B67814D6F439EA9E65E148918C613866E2690DFAD56B4EEDBE01B7CA26,126,130,4,0.8025873486341526,PASS
9D3C703C34951D76E06D81CBBB9D85A06CBB497507ABA9A205D90F89EABBD51,129,127,2,0.9005235503397743,PASS
45C7C9BE4DD085BF31944E2A58DB8F78738B493189B1AD8443F2AB5F36B1AD32,126,130,4,0.8025873486341526,PASS
312E691C2F6B814B44D8BCA282D00A58B660476544C6A03F3163FCBDE8C0DA01,142,114,28,0.08011831372763423,PASS
D834DA3BBAED3C0B41AE2F94946371A2433FF79C4FF89DF0280D27FB2356F871,121,135,14,0.38157390570502125,PASS
E70EBC0F9239236074084A9DA177075378A674D6DD0CA125EEA129FA69175B87,131,125,6,0.7076604666545525,PASS
BB44609893EC32EFDF0D1147CC99CC3CAE2D96938DC2C5B8E6CC823365628324,133,123,10,0.5319710580974012,PASS
FEE862C5955F4E0900F9A1AC822C40A0E472C4B441F24DB9957158EF665166AA,137,119,18,0.2605890342736178,PASS
7D2B606A46477E45009AB82C7031E7DEAF15FA0AF9D8BB60C2D9EA9EC2EBB6E2,124,132,8,0.6170750774519738,PASS
2AE4808911AC9B9727F29AE47772119FBB4751B6BCB61E24EE368413189DCAEE,128,128,0,1.0,PASS
98353DD699132998E5F58A859B104C38BF1AF8B1249A11C1F040E9429E5DC962,138,118,20,0.2112995473337106,PASS
4D6384963E7C8A2D5071F77BD28944F824AC5AB8EFAC5CCF86EA7A0F4B3A3B0C,125,131,6,0.7076604666545525,PASS
DA20520E5824B2BD669D4826EACF3E3363C9103F70B154B4E7203288413F0F5A,138,118,20,0.2112995473337106,PASS
64C966E7BBBE5E89BFB3F86A82DB69DC751BA9A536084871B3B789D99E471DD2,117,139,22,0.16913144470267139,PASS
855D537F706A2516D699B2A8055854899AAA4C5EF1654C3966FE93DA033D309,134,122,12,0.4532547047537365,PASS
6DE8CCDA9D70684C0EF5840D40637DD1241E6070ABAEB01F95BE099AF893F564,132,124,8,0.6170750774519738,PASS
8FBDAAA37FC6FABD26A23B300B5ADF158EB9F8D334C3857BAB01C3982BCA8A39,121,135,14,0.38157390570502125,PASS
497CCB96D3FE41A01925A863FA75C37AF1D98035236CEAEDEFDF50C1F9863478,122,134,12,0.4532547047537365,PASS
DAF25B6AECE4CE80FB4C7DA9F2CC43524EA80D1D4502988682EC71FD300B0AE1,134,122,12,0.4532547047537365,PASS
F6F957D4EE31683E7D8A0F0175360723A9E36D9065645ECAFBC458486132E2BD,126,130,4,0.8025873486341526,PASS
EB1C8BBF319D5328D89568199EF07EE775646F498A5CEF54475E9EF08E547E98,119,137,18,0.2605890342736178,PASS
E880693D247DF2CF9E8B03DDF0D429241386FDF3453922872B2F4C03DAB70BC3,129,127,2,0.9005235503397743,PASS
D2DFE4F4A848D65678118B808CCCF6C9D8F8E3519D2A7F4CA0C5E4A445D4A124,134,122,12,0.4532547047537365,PASS
5522396B5AF001E9C1EDEDCCCD5A4FCFA21B3FCC308825140F76FC555EACC8AF,125,131,6,0.7076604666545525,PASS
D2CDA4254CEFCA7D755E72785642BC68D83E61B4672EB4854FBED96D9896E52A,121,135,14,0.38157390570502125,PASS
CF78F39122F3AAE7114D17BB2875A7F9586771AECD4D7F251FE671AC34491966,118,138,20,0.2112995473337106,PASS
50C46420A4561C0A5B2A60599A2A9015F88E53EBABACC7C460CA6742D25C174C,145,111,34,0.03358661289689768,PASS
DB50BCB8D62E04EA90EE55C389B26DF6A05FFC4B44501E9A3D2DC5AA92BA463A,128,128,0,1.0,PASS
EB4E5326035FB2A162A5C6785A916626CA12F49EB9236F10D440534A73986F04,137,119,18,0.2605890342736178,PASS
714C08D8239A35DDCBC618608D1A2019C3315E9B92A752AF35F109C460F2BD16,139,117,22,0.16913144470267139,PASS
C03F25570DA64DD12B634B88C35DB32FD73A7FFC634ADEBD5CFD1D6B43ACD859,115,141,26,0.10416255883043901,PASS
669B6462C2E1AD3DFE5E3A0C572AEF290F16D792D86706F4DFAB071485493E0C,126,130,4,0.8025873486341526,PASS
ECE879A9EA11BF76C0F66937F5EAB08818AB7ABC93A9BB50DED1CF0DFAF36E91,114,142,28,0.08011831372763423,PASS
34534A810EDB5E56569566E37D40F2E8C14BE7E059D2CF7571F440960707A15A,131,125,6,0.7076604666545525,PASS
B180E3F4D58BC08C16CE1D785284F71A81AE7F404B5518D1D990EDE01A6F077A,134,122,12,0.4532547047537365,PASS
9CD9B2997F189A01525BFC5E626CBAEF3C9FBE2D5EE86136E99153577BAE4BE8,115,141,26,0.10416255883043901,PASS
97C094DB6AA4636CA8999E3DAB24AEC8482200D76F932E9B14D23A6B545061DC,136,120,16,0.31731050786291404,PASS
80B8F03482D66C927A3662E2605114042C4AB311147C934043BDF7D1C03B90A8,149,107,42,0.008664896726025117,FAIL
2938AB72E8767E8990643FC95FFDFAC03099766DB78D5171857F81B547AABE58,120,136,16,0.31731050786291404,PASS
FA737687A01A3B0043D0F72FFCE46DB0A59DCE45BCDF4CAA98E18A3444FBB729,123,133,10,0.5319710580974012,PASS
3A0B7438A821B8BB5A3AE3B85B77F22F4D2FACAF20353C22F5E3C95F2B0A62C7,124,132,8,0.6170750774519738,PASS
78CB0D099972A094FF6FC5C34CC1AFF4EB18DB70A509A172F67E201C5B918CA2,130,126,4,0.8025873486341526,PASS
CB104C50A536B23DDDBEE7878ADDC406F57224164922E6FE238F8CCDB144686B,130,126,4,0.8025873486341526,PASS
D1A972461D058B2943A0254DD1AB9C51B5A08D77BA270B288333AF6447086166,141,115,26,0.10416255883043901,PASS
BC6C166C3416B08F6C8BAC92490E274336799631390FA1F185CC8F26467A6C76,134,122,12,0.4532547047537365,PASS
35AE806FA06831123B23D07AF39BE1753F2F87D888241DA38B6567F3B646C675,127,129,2,0.9005235503397743,PASS
40CFD94F54B1BF6F7A19C8E171E1142255075BAD60B228FFC58656A4BA32813C,131,125,6,0.7076604666545525,PASS
86F0AA10198E0F5F34C5BA5D5E4AFA13BC66AB83BC652FB37E0982CC036516D9,129,127,2,0.9005235503397743,PASS
CFE158C817B2AF3B1AE663CDCE8FA7BA9625B686C4CC450C98E26CA9A66BA435,126,130,4,0.8025873486341526,PASS
185FB8B71C7C367E7ABC80A85749EF0E108923923B85E2986874DD734FA78E19,128,128,0,1.0,PASS
EE78288224AF1591ED4E08CB8DD2AD109C9E083C47DBEE45A0F3A1B850BD1B20,137,119,18,0.2605890342736178,PASS
10C24EA641F230F070BDF95D20F87E8EC024CE9827F4DF9052F83C4401933B5D,136,120,16,0.31731050786291404,PASS
83C3CC6F127E3C94C68A02BEF0FA067B8CCD8BB1423A36BBFC60520966BCF269,129,127,2,0.9005235503397743,PASS
6F0069773B020104119273AFC17DC0C339B91230305F2C3BE6CF5A6CA43B0A73,138,118,20,0.2112995473337106,PASS
49EA06D0EB0FCB866730093C63A90005172E8C11EAD604BBB5AC0E3118F01E79,142,114,28,0.08011831372763423,PASS
D4C7E9486ACCCA86690B9207942550D8E527EB5CA95ED8255CC9824169F1D615,136,120,16,0.31731050786291404,PASS
4EA81C281ECD7455B3067D611E4E2BCDA75BDB28A7BA77AB513BC8446B835347,126,130,4,0.8025873486341526,PASS
28213941ADB864AB2CE43A34CA4FCBD633EE963E1ADB13CB1E10DD88C0851914,137,119,18,0.2605890342736178,PASS
E72B1EE3A71DC6818A48AFF221DF67FE51E66A2AF9FD3B9EA4F5A569E2EDE1A0,114,142,28,0.08011831372763423,PASS
1BB5722292DAAAA51DBF510955B847F62730DB1A52F410E46E4DF8F14D4BFCC7,125,131,6,0.7076604666545525,PASS
F59252164F6019348627DBA4A6565B40B987AA30E13A9776ECE361A21F2639B1,133,123,10,0.5319710580974012,PASS
1DEAA8F93C718F3B6F67BBAF4DFA24952EF1469F32D9E877F4DB03D41F0E703E,112,144,32,0.04550026389635853,PASS
C2B3A88CF38A0A537D4E232EE4C529EFF88614E3CCD6CCBC3A5481E678BAD43,130,126,4,0.8025873486341526,PASS
E007CD086DFC9DC80CADCBC3DCA2ECE4B7D7C03A5894D39C398C81A1C4F2B855,131,125,6,0.7076604666545525,PASS
6575CEF01E703B42D59BBB4012115DB82C5DB87E5F5958BFA687BC3731DCF923,121,135,14,0.38157390570502125,PASS
8985D42FB93C3EE5E5133496DB01B4DA7924684DC63871809842C8F137ADE262,135,121,14,0.38157390570502125,PASS
8A46CBFD26D669E684B05268695A73B3FE957570D6AE9C5499A5EDE05FEFFFDB,112,144,32,0.04550026389635853,PASS
BE50FA6793BEEC23445525F081D51CACCCC8B5203A30A9DCDB80F169A9CA2559,133,123,10,0.5319710580974012,PASS
778D5BA4B1C3BE5D9686F376B2E71C31E54CB739FF42F0137D358E1C26C54B40,121,135,14,0.38157390570502125,PASS
846E66AC5FD6D55ED17730454F9B3623B528EC83B504171117E3AA97E99058F2,128,128,0,1.0,PASS
802997253AA58FC8A0EDD69DFE1EF081A3C0247B4C22EC92CE27658B854AF003,137,119,18,0.2605890342736178,PASS
1DCB9E19147C25C4318832B080091861D4F8E99D9B413D335803A19A50F87E67,142,114,28,0.08011831372763423,PASS
199899743993EF270DAF80EA0C17ABF85B8B83F6803737A28D0CB1FCC60EB67D,126,130,4,0.8025873486341526,PASS
23796CA62A81D736A7C7611C3402B71913ACD182EF0BEBA0EEA1A20A8B667BFF,129,127,2,0.9005235503397743,PASS
E0ADC454ED7389178EBB1B62A2B34EC4F2465FC3C777F9ACA91EA7B8E3D21F70,119,137,18,0.2605890342736178,PASS
3AF4D216A421D81F4FF7A5F67EE82D1B65640D9F069F811391C422380AC39CE1,132,124,8,0.6170750774519738,PASS
7AB2D590A2B1C46FEFCB6616BC9D03591D31DA1A7DDCDC5783776B132E6F51DE,117,139,22,0.16913144470267139,PASS
A36CC0F6C722061C6B55DB2CF70ECCE5467EBFB32523D8B43E50DDBA3CCD1B9E,120,136,16,0.31731050786291404,PASS
6FD9978E8DBDE1B48BF027190DDC43EE00635E09D6EED93C5283A815F6CBE987,123,133,10,0.5319710580974012,PASS
58ECC8E0FEEC10E2498182103825787AF4F2B789290F18FC4A49978D3281681C,142,114,28,0.08011831372763423,PASS
280C71DA910ECA626373DECCB6117E6AF437E02EA9249E15C9F767CAD04DDFFB,122,134,12,0.4532547047537365,PASS
F2D077DEC32F870C274649EA350569C0DB672442EF0C7FB20D60EF094C1637F8,129,127,2,0.9005235503397743,PASS
F80CF73D124B39B8D64C0AEEBFE0087197F305C088292285CAE56A56A1AB711C,135,121,14,0.38157390570502125,PASS
5C5188F0A33C880DEE2FDB7CFBD467E6B8E8180F207D231F160965F49B0F0BD8,128,128,0,1.0,PASS
D9C722C17C046429CBB447283E00868BEC353564A086AE9545C0332A9CDA896A,144,112,32,0.04550026389635853,PASS
AA1C033688FC1583E582E3C5384CFABA84D387439597BA1C9D6EF0B940963E57,131,125,6,0.7076604666545525,PASS
DC7762658BF9E1913F1718E5EB4C2028153F2FD919C6ECD16C6E1B77E305B749,122,134,12,0.4532547047537365,PASS
894BD18384946B8A127015A80F6C3CFD4B3C3431F8A909C7DA2B26A32740163A,141,115,26,0.10416255883043901,PASS
5520D7E56874A6C3D2F644277328B5F476B627C516BFA7F50E2E24C3884345C0,130,126,4,0.8025873486341526,PASS
B30C7242D63E9AF281347A16C68C8E0F557BB7A9472BBBD13922F01C29CABE9,130,126,4,0.8025873486341526,PASS
952042717499C3AA683F4A172DDD9C5B0AA1E1746FBD92B9B652BE11669AC638,130,126,4,0.8025873486341526,PASS
335E4086B87375673C60E57E4F430AEFB076D5728B9A2ACFBA7A90D2CC1886F1,126,130,4,0.8025873486341526,PASS
E1DF5F88EF6095019146E4BE2C0074E453D28267ECF58FA9C2D7255F79D7EB48,124,132,8,0.6170750774519738,PASS
A9487C52393418C77CEB00B4A95BFA7309D7DA34DF937F9F22F7EB8CA36E79D2,117,139,22,0.16913144470267139,PASS
5EAA06AF7CA9416FDD2FC97974C2ACF6BBBAEBB1C244D9F8F7B82D1254E5D4FC,114,142,28,0.08011831372763423,PASS
CF19B2E70A0E39659FF022CD2D821F268D8EDB8A505BBD0F0A7D6CC568BDB0B1,127,129,2,0.9005235503397743,PASS
9DFE9B65DDA49D3DE42D46563071AAA6719168D0C580844F37B2AE720F00C192,134,122,12,0.4532547047537365,PASS
51E38E957479CBB00C10B82A042B68828FC7FC13A761F31F6EBEBBF1D6280533,130,126,4,0.8025873486341526,PASS
5CD85297DA9567DA5128C4D2EF120C75BD747717AC2EA28D55F1BDC4884AAE3A,126,130,4,0.8025873486341526,PASS
25CB219C2EFE9079568AF9EA1CB32CF9A7E3D233061F6B8644DB88C4C7C47578,126,130,4,0.8025873486341526,PASS
91A282A2714CD476764AA4EBAFDF8BDD3F263E6AD18448BEF6A38A6695F9D14B,122,134,12,0.4532547047537365,PASS
3191B831AA595FADA8FDFFA9240FA0015A77CBFA32976841CE7666E998C5E4B1,125,131,6,0.7076604666545525,PASS
2F84BD4D927E639D610A1CA88479A4865A10413A3DC49F5B2B33449526A84730,141,115,26,0.10416255883043901,PASS
777F92DF1E897EE1EB7820397A757AFA55599BC9722A8470D213551EED5C46B2,119,137,18,0.2605890342736178,PASS
775BAF5303A5CD3BB9C5F88653D1C9F44DBC0913BCB260417458059221E77CC8,130,126,4,0.8025873486341526,PASS
4BA1C5F99A3C5BCF42AB1B10028A6A1EB35EDAA28A7D38FF151E76FE32185C92,127,129,2,0.9005235503397743,PASS
EB856CED45F8A03A7158FDABB743BC16495AC228137E81582255BA3AFDBAFAC9,124,132,8,0.6170750774519738,PASS
1A511B1D97E8BDF5B49060A587CF5A740DB018D4E0D1E94110A4FB05FDAD6273,132,124,8,0.6170750774519738,PASS
654BFE1BF8ECDF5F07D8DFA3FDA50C5AECD5B4EC6B4E636B9A3A61D83C160A20,117,139,22,0.16913144470267139,PASS
1F98821AA1D79AC29D331F5261AD98295FF070BF19147289EE68D6B1AE139D58,130,126,4,0.8025873486341526,PASS
40A47215108D8DAF07821CC60BC630A1A142FD70062A7740EAAF8A53692FCA5B,143,113,30,0.060792723530522785,PASS
1FD7198F7A18AFC4F74B4751889B989571CF786457FD53C12D4B9454242340D,130,126,4,0.8025873486341526,PASS
A55CF8D29D2BAB2E067C4F6C89000939D1520E09D40570E9FF8E2AF7AF6791FB,127,129,2,0.9005235503397743,PASS
3B229C3A933F388EF7C0B3A66B990F8417F8B1F16FFA9A9B5D4C934A32C9D56,123,133,10,0.5319710580974012,PASS
13746DAD93507C9F7F74045770C028830CB2CFE0884F9BE99AE6D40ED589949D,131,125,6,0.7076604666545525,PASS
220CEC841D4DF18F12E276CA8CB6A9539D76EC9D75E3630A1115CD453246B027,134,122,12,0.4532547047537365,PASS
4B0E556CF3031246897AF012A87A66D532141BF86039C53CEA6800047434A747,144,112,32,0.04550026389635853,PASS
DBC4CCCCCE959835EF457990FA8C6AE98D3A09CD2C255A5AF86FB4569B76267B,121,135,14,0.38157390570502125,PASS
6C0FDDE0D399B55B4A01BDD0490A7D0C8AD7B752B0B1B1A857157208BCF54C07,132,124,8,0.6170750774519738,PASS
1E1F7059445EF3A50BB237E6DB4D1F8E6F90B3E66DBD6CE907D23E1F5D14770E,116,140,24,0.13361440253771617,PASS
F550415A119B9255F59499FFCF65997F54026E283B6D6A3BF9E771CD7CF26E3D,115,141,26,0.10416255883043901,PASS
3DB5C890E0A91E03AACE5C5E93EB9B627A0E59313C58D031DF5A1B24494ABE94,132,124,8,0.6170750774519738,PASS
1B1C4DD213B7F95301FFBD3D9C72C8812A60DDF54A21012E8DC25A0DA577D6CF,127,129,2,0.9005235503397743,PASS
44A5AC06938EA5427675A83D99E5D055049477C1D70C3E63CF40A7AFB9956290,134,122,12,0.4532547047537365,PASS
3B9A92F3D50E1C0671A88755173BD2F600AF40F79778C590B7DE8A0F9A2F64BC,126,130,4,0.8025873486341526,PASS
123C6A8A0BF10B7788EF3C31BD679F74F1E8759F74024B9825A322C2097899F2,130,126,4,0.8025873486341526,PASS
A37242AE408C13F77011029EF01B8D4E715CF21BD7510A5153D35C5BD9C12202,140,116,24,0.13361440253771617,PASS
15DBDD2D808DFA75C56CBCF01DE7414E1DE46E0C071294D934E549D1FC82C2B8,130,126,4,0.8025873486341526,PASS
57BE5E53222816191AF94968BD0D6AF6C3867658C783F88059890299C2D91145,138,118,20,0.2112995473337106,PASS
3A948E7F10F71B003D06853505E9A765EE4C501CE1B0A00EEFCBD8723BDC8683,134,122,12,0.4532547047537365,PASS
90FADB6362E06116793AA84CDC568660295769CF88637C3D757674D7BFA74455,125,131,6,0.7076604666545525,PASS
D15E7221E8C6156553714A4888CB4BC5FA00BED5E9BC93BDE7E489ED6125FFE8,124,132,8,0.6170750774519738,PASS
25BB4E70313CEF1A31654080C67FC601A187111E9E15A3BBF7D4AD7376CA32BA,129,127,2,0.9005235503397743,PASS
2DE63F52C6B7C5B3D31287143378FA244D5F58D7855A5C332186AAF7FD3EB367,118,138,20,0.2112995473337106,PASS
52FD5D05EB81BC7575836798A5B602806EDA8B1E939B9A35718A90EBB6BC8724,128,128,0,1.0,PASS
92AA4437ABDE25BFC72BB1A5ED22A5AAB3053952B0712060A8BD2C9B217D57A,132,124,8,0.6170750774519738,PASS
C976BD4D257863EF75A3C4AFAB6D215E3754783076ABE03EB02CCF2E94703447,123,133,10,0.5319710580974012,PASS
25D9009FCDE6CC96D36FE69E4CEF9F0C9CC2F068C464A48E5055FEE4E2E8F93F,121,135,14,0.38157390570502125,PASS
C4DD0F3ACCF67E9317E1370A300517AC4D7C3004BCB18B827F21692DEBD45DB4,129,127,2,0.9005235503397743,PASS
19DC14CB1B78CB13E20D45CFBF15A290F3DDBD96B09DC13CE9A8915311BC9F2C,126,130,4,0.8025873486341526,PASS
D844DC1323FB0409363614141DC0B6C97E687D8F33E61B97C442467DDFA22905,135,121,14,0.38157390570502125,PASS
ED02C2725682813CE03C5E2123F81E18CF5826D6C9608F5CE3F178613259BF93,135,121,14,0.38157390570502125,PASS
1CA32106AA9DE91175331D8A3CC0738CB2326CFD1136C24C0A619BB6017C6A1A,141,115,26,0.10416255883043901,PASS
69B95E6B59430BCEB3C68B83BA3DE86B58EAACC6FBCADC2E29D2DA5CA812F950,122,134,12,0.4532547047537365,PASS
AAE13D7DE9FD01C3E3A4FAD608680AA6DCE2BD29B76D45870C913BF64216966E,125,131,6,0.7076604666545525,PASS
991D13342F43A42063E7622E9D7FB493DED7F04136DCB57973A6F87D8D916722,122,134,12,0.4532547047537365,PASS
2423C0C3E45410DE61CB9395D0A7C6596522657F35F12136B8638565D346B635,135,121,14,0.38157390570502125,PASS
FDB64F507411C0806B23E5B74CE674BBAE3E620198BB6A572AA14C6572C053D0,133,123,10,0.5319710580974012,PASS
5736D007300882254158DA0002EA9602A5C34B861E397A6753AD728D25E4C18,151,105,46,0.0040402749798920095,FAIL
45A917C238527824584CDB71DC972CEDFB124B3905FE3CA8FA1125A297046345,135,121,14,0.38157390570502125,PASS
B1A4AEA755BC9E99D23E443D82B7D3F8E68B227580A65BBE59CB74D00F9C667C,122,134,12,0.4532547047537365,PASS
A53EA63C2D525CC01E739379C7D6041E4A6EEDDAAECDBC79EA54172B48C2CDA3,124,132,8,0.6170750774519738,PASS
1B50E845D4217D1E25625A31B0C716BF0027496C21C4EAC3757637CCB6A20C1F,137,119,18,0.2605890342736178,PASS
8F82E60122C98A9F9F81638305CA22586EF6733A8DFEFB7588C32552D13722CA,132,124,8,0.6170750774519738,PASS
E59367D9FE90198FAE429720037B33EB1C146EB82A03BA945EE9A2F135D75D79,124,132,8,0.6170750774519738,PASS
164532888CB9143262111015C022932943F7C80AF8F2539AD1E26A6D52DECA8A,146,110,36,0.024448945310089426,PASS
D6A92693FB64E84F3DAB3E152D0BC10E719A2C303A40E7AE9BDE5C15A8806587,131,125,6,0.7076604666545525,PASS
EACFA536577EDE2C8465A77AB2D819010F4B196E7C6E0702F32B87A09BC30685,129,127,2,0.9005235503397743,PASS
72B607F12BFC9DFB2D8F075C37070D5E6FFB519845920A9B9DC522728022C84C,129,127,2,0.9005235503397743,PASS
1D3BB272AAEBCC38875389DC669B847E10E8F7B92B1E80D69FA1D679E8835ECC,123,133,10,0.5319710580974012,PASS
F9858F8F3A8604055174FBE533D480CBDFACA4A186183ABBEC35401F1B6E9C0E,131,125,6,0.7076604666545525,PASS
,256,0,256,1.2777508801076536e-57,FAIL
F333C5AC2EBE251FF2BD8333F22DC8A8DB203F3EF0C41E3B9A94B33384B4504E,125,131,6,0.7076604666545525,PASS
AA99E72D31E58AAE2FF876800D0EF66D25A2EA7C71FEEC0C21D07982782E8F36,126,130,4,0.8025873486341526,PASS
CB6727869559BB12256B87D64D903C1668185B4C7A62C40A8C227CFCBC0CBB15,135,121,14,0.38157390570502125,PASS
8CAD779DC731EF2A2FC02D0190076224467715D2ED7D6D372BD5ED26015F925E,126,130,4,0.8025873486341526,PASS
287F8BC55B274F8BE6D8F71054AF9DB5D33EE96AB0778239E73CBD932A9A9258,118,138,20,0.2112995473337106,PASS
52B1F591C86F4DA745358DFD0DEFEBDAB157AB334D717B151D1654E622B985EF,116,140,24,0.13361440253771617,PASS
66631A4162000E29E19BC108B7980E5059C7D66A0EE2CD2D8E36E1AB577F6777,133,123,10,0.5319710580974012,PASS
4707C35F9A7AE248F9FCFA060101AC998004887C0A842D1EDFABAE2C1635C88D,139,117,22,0.16913144470267139,PASS
5CAB7D1A576FD5751583A401DE01365CE211A78457EBD9C417FAAF526CF548B,126,130,4,0.8025873486341526,PASS
A12B6A999F6D31C6BA98E0D2528546EAD9E6DE8F8E28D824D1548DFC3D53784A,128,128,0,1.0,PASS
D7E943540344F9C1551C66382CF6FAF09163A036A70DF73A5ECA6F0B44E836DB,127,129,2,0.9005235503397743,PASS
3E8A372D29DF07E20CF38E375A2418521104E0FC3FC7EB86D3FD1C519CEE307F,125,131,6,0.7076604666545525,PASS
EF05EF6312CE72E221D450ECD78C2AFAAA8ABAE3B076DD0C0EFDFB12C826386C,125,131,6,0.7076604666545525,PASS
795CBCF780B389E847AD25EF8B8130F4163386280B7F55C1D969288000303D2F,137,119,18,0.2605890342736178,PASS
3572F40BBBD57478788CDCCAF73EF189DFF6FA01F2BDC4E08D89E7C339312DA2,117,139,22,0.16913144470267139,PASS
DB755A02B93A577598F7F69602A9AF0A3CF1870358894C8FEF744B8A78844248,131,125,6,0.7076604666545525,PASS
E1FCDFE41F35C9887A4463CCCC8F867973D951B73F7C101555E4B016071BC85C,126,130,4,0.8025873486341526,PASS
1AE9BCF9B10B3A5B202F67B07E6D7529A94EAE300FC802EB6FBA8C174FC6D7BA,121,135,14,0.38157390570502125,PASS
237E9627424B59A5F27E3EA1964D6A19D46946F86E1A49BDA91FB59CEE65F82E,121,135,14,0.38157390570502125,PASS
67C4048B4B71E5E536E2223AF92A969B570F710E216AA78730409BCB77125619,134,122,12,0.4532547047537365,PASS
BA8762AF429C32197ABDD764D7E20F600AE402B4355A6512F8F7E7BB4FE93D20,125,131,6,0.7076604666545525,PASS
165A727F31D8C742627227EDD1EB763B28CAC18315B94B06E878BC06303BD2D,132,124,8,0.6170750774519738,PASS
53709EE04E10583FE9C1D37D034F7F8E20226F7C27BB6AA72769E90902F589DB,126,130,4,0.8025873486341526,PASS
F6F5DB316CAABBADB71BAECEDC4EF9BA2EF633F1B984B532CBAA245421EDC825,114,142,28,0.08011831372763423,PASS
E89F9862C102B72EA943EAD18475F99DAD0187987C955BBC17C7FFF0858B9746,124,132,8,0.6170750774519738,PASS
2F61E9D94FEFD79EBCD7A3D35DABC91DB08ED107D6FB4FFF0FA267F6784B065D,105,151,46,0.0040402749798920095,FAIL
B2C0A2396A3F2DDF7C6F24094D8B7F6E1F1BD4E1B4B235A2618A89A121379983,129,127,2,0.9005235503397743,PASS
EF90926C9D76CAC2C43A6893A52B5EEFD5566084E7CA1CB49639DB9693ADD7E6,121,135,14,0.38157390570502125,PASS
D598C74BFF8C740F011F685DB2F49682E22583D615FB7DD8182689B46E907DA4,128,128,0,1.0,PASS
153194327905CD988AAE78586EB5DD83DAD23971F10BCE389EC95E9DFCED9499,124,132,8,0.6170750774519738,PASS
23539FC16DE948792DB84F5B38696DACBF7BACB72D6EB0068154393D34D4140A,127,129,2,0.9005235503397743,PASS
6671C5BE043EB4BFAC92F0096080810A972BC24A6DD07686A7FAAE25E8F8829,138,118,20,0.2112995473337106,PASS
A23993B4D786E7B82C5FCC9F06BAE68743D638B05B908DC3884D2EC825610BD7,130,126,4,0.8025873486341526,PASS
1E1007D8F9B7C8E2D522C95A7415B1FCD420E18296DF5EDB4D1B6A276BC920DB,128,128,0,1.0,PASS
145DF4270EC88DA91BB021972618A98186C9DA1D8199B19252EFF8620AD1A14,144,112,32,0.04550026389635853,PASS
C299B0A3996F264A4BAFA295A1ED9F5DE5610DADFA4E34FD26628DED331634A4,124,132,8,0.6170750774519738,PASS
1E0E9BA817D176611A2CDEDB2186F6BC4BD0EFA136629AA2EA6247B67399F9B5,123,133,10,0.5319710580974012,PASS
7609372137831451B256373E3CB988088FE4EAECC5F9D71A2566A93F6E588BB6,127,129,2,0.9005235503397743,PASS
8474A76F3FD1E40C445C5143184365A4CD4C764F3E0D2FF0C2E11502BE8D82F1,136,120,16,0.31731050786291404,PASS
10C13B9B4997409EDF740265B67BC2AFF3C2DB33A21D417B30613EC6EE8D9909,128,128,0,1.0,PASS
3857C3349904A6DCD21457F371F180ACA316EC4FC15462175040664CEFCA5156,138,118,20,0.2112995473337106,PASS
A1FCFDBD230A2A58BA236518632D2E70E5CF8E0C156ACE80CDE0440F133A3258,137,119,18,0.2605890342736178,PASS
BCA59CE900B36DBCF81C6D72EB04DB2F28E925FA19C3F319727CCC8CBBFBE467,118,138,20,0.2112995473337106,PASS
2199D85E76F30C945BDC60327D9EF01BB67AC5EF92CEEE4C5EB7B4CA74742A97,118,138,20,0.2112995473337106,PASS
9D1AD87B14C7F2BAD95C73361073B28F4D64620BD2BFAB200FCE4AAEBA62D903,126,130,4,0.8025873486341526,PASS
C235F87D74FED8184AEFCEB6D7558A87425599284AC923A8A1377CB89EB85FA5,123,133,10,0.5319710580974012,PASS
E9FEEC3B047AC9A5C8FC1660F2215E7B514434714F9129F4E7F3D6E2B4C81673,124,132,8,0.6170750774519738,PASS
6904CA85FFFB2F8F05C7FCF87343ACCEACA4DFB1240C12B243520431812B1773,131,125,6,0.7076604666545525,PASS
22BF83B1B22EBCFF2F25DEA68E7E8D3CE6C2C4A17E2153CE54DBF70C4D291EEC,118,138,20,0.2112995473337106,PASS
11CE756C6F55591E8B2AB084ED586D1EAB8796EB1025493009A02C7716CBC223,137,119,18,0.2605890342736178,PASS
35BE180B45A6DEF14BE09DCF69604DEEC2A8D608B6836A318EE87B4FCC0626F0,130,126,4,0.8025873486341526,PASS
FC92FF64D20893734ED8C678F65FDA3191A8BD71EC1D04C2F0E081A035D05166,132,124,8,0.6170750774519738,PASS
58D8E484C6145394C0EC1FA3EEB4370986C7D81F0A64C464509D48AD90E488AF,141,115,26,0.10416255883043901,PASS
2CCDDF2458C511B1BECF31B0DE52D4B094B5EB7B64518D02D1F5E1FE3EDD422,126,130,4,0.8025873486341526,PASS
B1CC7830438F587A850845FB1A74453AB9610C1A20E4CE803ED0AEE31DF7EA03,138,118,20,0.2112995473337106,PASS
DD2E148CB783B6E2A5A12E1A541EECDFF064E93230363FD4D7D4BFA7B1B4A436,122,134,12,0.4532547047537365,PASS
BCE10111921AA9E5B26D849DA4B542E62C2259EDF2BBB9D01BE7D5881B777BE4,127,129,2,0.9005235503397743,PASS
345BE35C7E51DA48802ED0EC928A07EA60A29D5AA0CC66B399B288FE5EED4E56,131,125,6,0.7076604666545525,PASS
AA9FAC3D6786F8AD2F6EDE03351072A6840A3FBE948F43C984DE6210BD8F3E8A,126,130,4,0.8025873486341526,PASS
C5BBEC95D7BD2E21CB9577B94DEE170FBA74BA512E5AA40E12E2C596D8452239,123,133,10,0.5319710580974012,PASS
31FE231B9A30546E583C93386A4A9694A364FC2A83666956B8AE541B150D5A80,139,117,22,0.16913144470267139,PASS
778C83E23F6019F71AF1C473A529C462697673E6C3EB02A6518EAF440B66E7A,129,127,2,0.9005235503397743,PASS
EE6B304579B567387730928149E88968648CFA88240D0397B98B2DD980AC2084,144,112,32,0.04550026389635853,PASS
D7E66C69DC9CC8B5AB8E7F99CBDDD33898532FE2B2D5B93FBD5795D15743E208,113,143,30,0.060792723530522785,PASS
BDD361440D8A5D7A702B5B9DF5342C7721C3A325C50420EDA135807CA201B00C,142,114,28,0.08011831372763423,PASS
D991BC2BD16ACCE9AA453F92F8E9BFEB62761AA2073DCD20E68F3A6061056E28,127,129,2,0.9005235503397743,PASS
EFE1519C38367D7A391F36798521258E7AF91991B1FA856E8619A174FAC411DD,125,131,6,0.7076604666545525,PASS
1BE1144AF966BEE9B2274388F7C1299990A343AFA353F9645DF955A33C3EC66D,123,133,10,0.5319710580974012,PASS
E49252730326FA326EAA4EEC05BBF1E416BBBB422BBF545BBECEDDF9F5B6D806,116,140,24,0.13361440253771617,PASS
C07F57FD80456474F71FDDAF2A729739A569C04BF040BA54C3552D5DF309F0C8,125,131,6,0.7076604666545525,PASS
2B2EB2EB91193B25CFF09AC955C503B8C6703628E151DE5F7D78F2477406C63E,126,130,4,0.8025873486341526,PASS
C722457378F83625BC8FB039DD1D37B5678C7A130466AB7678C48788C233A0B,132,124,8,0.6170750774519738,PASS
D5C5FD46EBAA56F1EC6730692FBFE87BA18B1895CBE517778A8FBEAC8304498D,118,138,20,0.2112995473337106,PASS
EF133CAE201E79211010492915BDA857A17BACF0D23B56DF608EC5F7016668DA,133,123,10,0.5319710580974012,PASS
FEA179E5C1F1DD94B2F5A6B75A40F749AD46D6F6B737C4E0D616C5A58B93BD76,113,143,30,0.060792723530522785,PASS
E2322440FA4EF3080AA580435296FAB055223A446286DB0148F9E22A7448A81A,151,105,46,0.0040402749798920095,FAIL
2C167600B08D68E40F169E5B1323EBF1C2E46C6F38785FA92C24712B882D093F,136,120,16,0.31731050786291404,PASS
90A4576EE7667FF83B43E0D77975D44BDFACD7C1F68B6E4842A72869D0A607F,120,136,16,0.31731050786291404,PASS
BB49594D8C05EF1EADE62E38C7354BD95CA3E3FBCF79B70FE6510560EB5F473D,114,142,28,0.08011831372763423,PASS
6DB94FAAD07DBD195F9A289A0DC661778CC619C10B27D122C28087B3384CF945,133,123,10,0.5319710580974012,PASS
D6D254500F0CC953A4D49FA60F826C7ED226601B89DAA28524A08F473CAE2185,141,115,26,0.10416255883043901,PASS
286EA3776295C660165B3532A759F7CAF814A1489209E8187BC09FB687436544,136,120,16,0.31731050786291404,PASS
DD976EFC0FF49B0AA6CB0311FF6E46E9D35BB2613C1470E50297CDAA881E9BE6,122,134,12,0.4532547047537365,PASS
1A59C8582D504E6116519CD6239D14922DD289135EAD1E6E7757D22DEC1B9A6F,131,125,6,0.7076604666545525,PASS
E90C32CCCD631DBD0778B9BF9C7125BDFDC60BA095758B2A886BFE1899B1BFC4,121,135,14,0.38157390570502125,PASS
8E5E4A40D1B4640ACD40BBA223BBD4B5A021533FCC4C15447795F3C02C658399,139,117,22,0.16913144470267139,PASS
C3804E60452BF43FA35167EFAE7FA357A60CA8AFC35063729B49352DEA6E0AB9,125,131,6,0.7076604666545525,PASS
DD18AA64C7F5B49865E9540D8D18459047EC20DA2106328EC8664F77C0D8CECB,137,119,18,0.2605890342736178,PASS
AED8692905B499F18EB5E73EA9883E98FF0C6C2573EE5EE35672BC2088094DE2,127,129,2,0.9005235503397743,PASS
151D9B6565DC54967513B4B4480B844D3DAE54D9374A2EB885A45BF8CFA52DCC,129,127,2,0.9005235503397743,PASS
717587AF9F544E893D1B9E42B3416614E4DE453813897673DCD5FE0B967A5D6F,120,136,16,0.31731050786291404,PASS
3DE82F81956A1004B7449DACB20A425BC41A202C06D167FD5FE951D87C2F85A,139,117,22,0.16913144470267139,PASS
185E46CAF320DBD5B5C2685A945F3AC01DB41779876E05BECA374F9BADE4147D,124,132,8,0.6170750774519738,PASS
8CA52C799241BB56A0559B6DF8CC33F90C587D908C2AF06C278DAC09ED284DB4,134,122,12,0.4532547047537365,PASS
32724A1210757579C07DBC402A3C58A0619020CE6D16D032EA2A0F4A9A1F81C7,146,110,36,0.024448945310089426,PASS
90CD33CE1B97BB53E6AB136EA1A94AC8C501920D2D5E5C6A2020CF94EA17F0D,135,121,14,0.38157390570502125,PASS
9F6DEEF65B54D1358C735AE7E8E9AA29B22A716CE87D583E81AC810E5C347F01,124,132,8,0.6170750774519738,PASS
E5286F168543AF4009815362B308758B8C3234F939DC06CEC70D3145A3DC080C,144,112,32,0.04550026389635853,PASS
2C5AB6272C83657C83962FC19FA719F6786C54779E97B81B4374146DD21F598F,123,133,10,0.5319710580974012,PASS
955DE178889915CF6147E0D08711A87114C203EEFF93367E095AA1FB92D8D51B,131,125,6,0.7076604666545525,PASS
FC2A6274D6709497C3E0962934863A61744A7DD74351AD5E2040BA4FB0889367,136,120,16,0.31731050786291404,PASS
750F09438813834306EA8CCEF6A3CE9A2814071261304C8A64D645B2609FB62D,145,111,34,0.03358661289689768,PASS
F05E6EA297466BD52A6F777EA05503324C8EC952E7C5A5A2CC401CAF1D2BC7BB,125,131,6,0.7076604666545525,PASS
E53D320369C708708BE00CBB1459BA00ADDD3D9F56E4898442085D028D92C690,145,111,34,0.03358661289689768,PASS
CDAEF265D1976151CACA4B64A77E44E70CFEDA11E5FE40E85B6050041BC5B9,132,124,8,0.6170750774519738,PASS
FBEBBA1C0E752429FC3F94A206D20FAA0D422C27709AD85C0C93306E6FCE1770,132,124,8,0.6170750774519738,PASS
2A494FB37826EAB9D1B0D4E1052D0A072C592C92DEDA577FB5457DA143DD7D08,128,128,0,1.0,PASS
323A9D3BD8D579B5C2FFA76F3EAC19E86373A026524A0ADB06BED564C3E24ADA,122,134,12,0.4532547047537365,PASS
B582E067C2B76A3BA116B6CCB80325012393C6FB4ED4BD08CA9797ADF23DA53E,127,129,2,0.9005235503397743,PASS
1099C56066396454AE5A6889BF5445AD17A4CA0165F6D01E005EC863AC23B6CE,140,116,24,0.13361440253771617,PASS
6954FDD1F159FD20F2B9D7F863E6B1B600E73E544DC9702551E79557EBEF80E5,117,139,22,0.16913144470267139,PASS
87B321E7F166D3FF26BBADDB5A9B1013229EDFE3222C2D6D91409D86469FDF7A,118,138,20,0.2112995473337106,PASS
8652CD7FAFD74D49FC5193B658E779DD77E2AACB3BABBF253644659EE8F58204,114,142,28,0.08011831372763423,PASS
AAAEEC5DDAC7EEC3CF7A520B212A02F78F89BCE365C4DF439CFF52C4EBA9A0F6,116,140,24,0.13361440253771617,PASS
947DBC0DFB87BE389316550B0B356C399E516C8A4E3ECD3927CCC4CFD9FE2B39,120,136,16,0.31731050786291404,PASS
8D8CE6C4DEFCC2C1E22E34D25051FE9FD6CC1BD1B0870B2BE39439B5F8CDCC8D,124,132,8,0.6170750774519738,PASS
387A42372FC2E4CBE3F2DF7AF1167A987A96F6EA3A45DEBD369BE165A7D4353E,112,144,32,0.04550026389635853,PASS
D51B8B57BB900A7DA666EDE9873E9421D56529E3670A1FF8E1092A268CDBCED6,124,132,8,0.6170750774519738,PASS
7358AB130A94C3598CAFE748CAE8B0BE89A988245F84F473A9860F9350F82450,138,118,20,0.2112995473337106,PASS
6EB81FDF71753DCE89D0EBD503F5035DB0B78AF2B787A66DD57FFCEC26590C62,113,143,30,0.060792723530522785,PASS
AA6DAA3896855D6E205D77317B852D191EA5F3109827FA598FEEA56E69342052,129,127,2,0.9005235503397743,PASS
E98C15ED847E50633712A148DC1FDFC5634F2C3A34397EBEB17FFEFD411BAF66,116,140,24,0.13361440253771617,PASS
8139CA77FCCA6164EC914DB114E5874A8B59BED0D15D188DD871748DFEFA3990,127,129,2,0.9005235503397743,PASS
97F689F8BE7B41C4B240684F48C8AAD32A054AAEF71F43D6B13248B80C4C186,138,118,20,0.2112995473337106,PASS
E0C8A517941C16321AEB3B43E12ADC1AABD35DE12A195EDD5CB35F3DB5C773E0,124,132,8,0.6170750774519738,PASS
735E9F87DAA9A8BF020412BD06890562BAEC306311909B8E798CBF1EBF788ACE,130,126,4,0.8025873486341526,PASS
AED6A33F0DA62373D721A71A9E6A42D05E30A5FAD472C0B5F8BFEE6A21CFDC98,121,135,14,0.38157390570502125,PASS
8F806A9BF1226084B4FA7DEAD537E4A10DB45195880CB7B42BF2A8FDFB6F0AC8,127,129,2,0.9005235503397743,PASS
8CF7B8DB932D5C7CEC5E2358E30CCFB169B123066751541C1044766E19C4DE89,131,125,6,0.7076604666545525,PASS
771A2771649F4E7DFF250C8313447999826CF947C16121E0DF5813E8FE1E5460,130,126,4,0.8025873486341526,PASS
EA45FE1F5A7062CF1428E0AE6BB117B3766566A77B3F4F7371CF422C80400D20,129,127,2,0.9005235503397743,PASS
316F3C97BF4BA2F4E0FECE8880C91BA03D1A9A93754A9A55A939E495C0A58E36,129,127,2,0.9005235503397743,PASS
5A4A3B7CB44F0EFEE768F071FF289B72B38B6DB32C96D68A68B8C11391DB26C3,121,135,14,0.38157390570502125,PASS
5B43B5BBC06D7C2CE7DF06634F0FB665003FE3371B7D52DFBB1F1009A44B9502,123,133,10,0.5319710580974012,PASS
F59816A890733B44F750C7E1077530E0F089FAE9061BFF936FA416DABC78C2AF,125,131,6,0.7076604666545525,PASS
CECB17679869C3A6031E76A5025969B898EF678755F2641D58DBA5CD7649D170,126,130,4,0.8025873486341526,PASS
A6D4749F4564DE7B753791E26A412D0704BC18AFEECC4E29C5F609548E320C87,131,125,6,0.7076604666545525,PASS
937C021CE4AEF59A64B5B5710940141990A71BA3694F5109F06DCE66EDBC4F68,133,123,10,0.5319710580974012,PASS
5F1C5612F16CFDB062FBE6E44DC834EE14A0CF6EA8586CB79743B01B50D451BA,127,129,2,0.9005235503397743,PASS
CF7B4FF17376A64443A2F8A408318B1A8D26E4A46291B79111AB4CFEE327F8A1,130,126,4,0.8025873486341526,PASS
8BF363480437DFD787A6E49F4C83C11999788CD031B6737976095226B731A9B1,129,127,2,0.9005235503397743,PASS
C1154D4A29031423F6EA411F875E4D051B61E94845FB1CD4D22CE3D5FE9DFAEF,127,129,2,0.9005235503397743,PASS
5C4C7BA97CCE9A092190FC659B322E880840EB0D7F10153B0E2E0D1C18C91935,142,114,28,0.08011831372763423,PASS
46D9081EB44086B1E00F627DD0FC01EFBB0B9539143F3828D942C36C296B6DF5,134,122,12,0.4532547047537365,PASS
12D5A1F695B7ACC7F33F6554C8FDD66B5D27C6DA6665C7ECC5D05FF2E833DF47,109,147,38,0.01754895019147673,PASS
ECB331F342E05F6593B825F993FF5AE20291E0520CC632F4C7263B8F90E61467,129,127,2,0.9005235503397743,PASS
A362D347124771E1C9478D8287BF31499C86FC742735B3E7D7AA4A5F280391D8,129,127,2,0.9005235503397743,PASS
42ADD0293CFF1677D8C19C6AD2F153140DC6D3030F001271416B0585182F40BC,143,113,30,0.060792723530522785,PASS
219E1C57613AE831D06DFD11BECF4123F1A0148FC0A704E3F4765A2ABCA38F9,133,123,10,0.5319710580974012,PASS
D1103E003F1E505D3D765014819FCE9FBC868FEF1F9C64D69DDA3C3BAB56DB0A,123,133,10,0.5319710580974012,PASS
2C34AE6F6D38094353064623085B4A8F603130C87E1FEC6B4D9E1BDC4D9E8F17,133,123,10,0.5319710580974012,PASS
FBD6A6E44B4F6142986524B8846C3897319509E2443A7D823B61A8A0CF4EF5AD,134,122,12,0.4532547047537365,PASS
5815C4FAFCBE8B922F0606A4C402FAD992CAD91D0FCA141FF517362ACBF46801,133,123,10,0.5319710580974012,PASS
7E2047A85D28F026FBC66E0FB71BFB35CC7E07494068F6F205D20B7811ED80AD,129,127,2,0.9005235503397743,PASS
512419D320E6A361B6118E2F01657394AEF38A26B407CFCBDCE0CC09B902A926,139,117,22,0.16913144470267139,PASS
283FB7EC66D588191E91FDFD507F443E0A237717D4D5DF45B61B6B606A096D5,123,133,10,0.5319710580974012,PASS
98175B225303334ECCDDC26D01663E962CE516B024AF875DFBBBCDAFF39169BD,122,134,12,0.4532547047537365,PASS
EC4377EB21F1B70E36ADD9E97E581F6C6C091EDB2D708FCCE23420A955C9C52F,122,134,12,0.4532547047537365,PASS
EA07C4B296800CDCC7BE510DEFCE8D2E7CC8D77B588C14A946526E131DA71034,133,123,10,0.5319710580974012,PASS
92FCAAF3DDA6B0F7F4FD0C3B6C920839B5C5F99C7B4FCEBBBA28D847C0D3DFDA,111,145,34,0.03358661289689768,PASS
13700745DA64C4105D6FC3559194BD6B560C099AAB4EC64910E2350C401FD029,145,111,34,0.03358661289689768,PASS
278F986C1E782152CC39165D937A7DD1BE6B7D1AC5EE8F962000FC0292FDC16C,128,128,0,1.0,PASS
6EB285CE394BB3A5CC1940400ABE2D2C90060B9AC7F102E5F45A482FA86B94C1,141,115,26,0.10416255883043901,PASS
BC953F0ACA6CA1E74D336B1FB5836B5A5B61A5599C4EA7A9C95E49A380A712C8,127,129,2,0.9005235503397743,PASS
53C62832E5BB33A45A307FE2CFCA93EC102B882DBD4646C4ABB19C1515189A10,137,119,18,0.2605890342736178,PASS
5F57B5EF7DAB693521A0722E9F7266CFA34C594563C2A8140FB4C12F22A28053,130,126,4,0.8025873486341526,PASS
98847113618B6336B2658D0C3F05DE5B28E42E573D8281E6114DA93920EF90D1,139,117,22,0.16913144470267139,PASS
E495264D1467F079068FE8093281BA2F1EB82BDD5B65983878A8F37A190F096E,132,124,8,0.6170750774519738,PASS
3BA6AF9250F6E54D8E2F9C6F318C2E2963960721665DD5F1EEE4A2FF9E07DBAC,118,138,20,0.2112995473337106,PASS
1621BC76C793CA71C7A7B033B65C4DB0CB84BB29A748B17D026744443151EFB5,130,126,4,0.8025873486341526,PASS
18BFCC72FB65BE1D6525A00CFF5599557AC995284356319B3EBE5357A6350AAF,121,135,14,0.38157390570502125,PASS
885EE8761997266F5E8214F163A6215FB9999A405C0F0897461789624B4C623C,138,118,20,0.2112995473337106,PASS
F5D37E10CA694665C9582ADFCE63F22E5C3D5011CF76F4693A9FBCBADD9F93A0,117,139,22,0.16913144470267139,PASS
51DBD36FB6A1D8CB13EC72C939E7697F799D7FF66837D6E97F27673A01CB349C,108,148,40,0.0124193306515523,PASS
D7A1C0FC7BB75ABC370320C5D6C2232877BBD6FF333755C3D26E804F1EA1923E,121,135,14,0.38157390570502125,PASS
35B2651C5AD2A269D6FA730759DCB8D0A7626FE15198CA6D4AE5C67DE35709E7,122,134,12,0.4532547047537365,PASS
95253C60248848E1A8B16926E8BF6AAD65D576555EA07208B6B7E529FCF0549,135,121,14,0.38157390570502125,PASS
72A479E2C0CB0D62DB4EB0AA14729663A329B5BC519FD14BC52B98FCFDE48F57,124,132,8,0.6170750774519738,PASS
87391D3500E8C9489074DE7D7B11EF65737527EDCEBD8F785FE2CBF4ABAE56CD,114,142,28,0.08011831372763423,PASS
933F98E095BFC51801A603B908767E0A53BB6A147EA22935AA1D9ACB613BCB32,132,124,8,0.6170750774519738,PASS
766F8B343A52855A68DF3AB4AF46232A499AA9DC2365042415AD2CCB5FE73E79,127,129,2,0.9005235503397743,PASS
412C79BC573680BA932946AF7FCC7A8D8D07B0D95E6E578C9653A1156EACBCA1,126,130,4,0.8025873486341526,PASS
1E1AFB8907E6E4AB2B228B5D8ACF97C12D62497D7B53164389B02318B691AEC6,130,126,4,0.8025873486341526,PASS
5B68F0699A1126359D91A810D11EA1F317BF14BE98278BABD2267CFDC509347D,129,127,2,0.9005235503397743,PASS
450DA85B1351C6A9DF0DA5AEE89A2A1613BCDCFE4E576086BF0DF79F54F8243F,122,134,12,0.4532547047537365,PASS
D66964D0FE5C8E686E281464FE6E70238299E4EDED482A6959ADC142C22EBBBE,129,127,2,0.9005235503397743,PASS
E9BDD42DFD3DB5A4EAADCF1E54791A470366281E6667CC30ACD1574F85057869,124,132,8,0.6170750774519738,PASS
BB7415904F6E69E7EF5D7CD2B9DFB5576D69F3D8EC96B691E63223E3B197E2FE,106,150,44,0.005959526470109114,FAIL
6A59740FC3533982EA370D86712E7B0942690DEAB57A8D7E0F5508DE3E1072F9,129,127,2,0.9005235503397743,PASS
741C71CD7639AF8BEDD6C48EA5D3CC577357914C9DFBB55B028542C8076CA89D,123,133,10,0.5319710580974012,PASS
91883E58651A9C7F55BF84F18C48843FAC2B0B4F1F389B64B66B146DE1DDB34D,126,130,4,0.8025873486341526,PASS
EF2EEF0EE09F104BC68829D3068FF53CB8A6B80E664836F2F4E76C7435240CEA,128,128,0,1.0,PASS
4C12218D97CBFD0113B7C15363D8DDA2EFFACFA37AEFB303D1F2CF2AFE50432E,118,138,20,0.2112995473337106,PASS
95123742AC24E89285528C3FB4E27D4DD80DD792B25F7FB1167AB4A3DD2D5739,125,131,6,0.7076604666545525,PASS
1B688A66C1861ABB5C74134CC671FB3544F2773826C0812E7326A320594B3848,141,115,26,0.10416255883043901,PASS
8C2F035DC8CC672CA9FB265DBA0D694B09FBFC07E58FD4194E3253442591C755,128,128,0,1.0,PASS
3F80EB5BB11BD02D2FBFF7164C4698D06C18F586D00F0394016E726BB77D765C,126,130,4,0.8025873486341526,PASS
1407651B04027F9578FF12F7133F71EF89A0A055286D55D4E38D2A14C177D640,134,122,12,0.4532547047537365,PASS
4A86A080F1E6A2744BC8A2EB3F952EBDB9C88B85975E10A3AB1B3EE70DF1F1BD,125,131,6,0.7076604666545525,PASS
58037786D90558F0B3ABE952CA2D3BC550E6866DDD99693851EEC77302461586,132,124,8,0.6170750774519738,PASS
5F173B1461EE932B93335D29DA1CA10D8BC979514525E9C764DFEAAD05DDE94A,124,132,8,0.6170750774519738,PASS
D6A530F71D032A5FD27616215E735076732F646FE5F5A1115FF11314BF748954,124,132,8,0.6170750774519738,PASS
ABD8F792B05039B79E5818EC741F336CA7CF2D498871F2476045990A195937EC,129,127,2,0.9005235503397743,PASS
8552431F5C7DD8FF69D6E0B7C1DDD9FD0DDE938DD04BB43E48BC0A77D62C58B,119,137,18,0.2605890342736178,PASS
6D8BF9997889E5C691274B9345B49FA65B1D36E71D8408BCE0B02FC2493971D9,128,128,0,1.0,PASS
97780B143211F238B28BB03E72B5A6E7095D215C25285D7A9CE78EB7BDF1FD63,124,132,8,0.6170750774519738,PASS
1CBA6544A40A11B4365D4894F7B280F04D9D145A8C3503D36D93FCFF78A89482,137,119,18,0.2605890342736178,PASS
3BA76D8393DB4D69C9FE9084947A464F3B6671C54F09F7E9B05FACBD3F9B776,115,141,26,0.10416255883043901,PASS
EDCED95BC7E5522B504D26862E6DF3D4861238B6DB8B7CEC69DD6EC3F1192C0,124,132,8,0.6170750774519738,PASS
DD80F8F933F98D641BE118AD863D1BEE044ED8228C938FDF3956854ED6D1F09D,125,131,6,0.7076604666545525,PASS
5977A812A0B8F175A2E04873D12A7BD12A41DF88DB0B87FC6BEA58027502BFE0,132,124,8,0.6170750774519738,PASS
649878E5860AC1E9ED9C95613BB2FAC779F1E61C0EADA0B65A273C659819552F,127,129,2,0.9005235503397743,PASS
6F3B54AF4155A2582E28B30082252F02ECE1BFD8220A834BC7096CD28C57726D,139,117,22,0.16913144470267139,PASS
51BE530939CE591B1BD911D38A173B3813CF6A0768014ACE06649D19786AA3D3,135,121,14,0.38157390570502125,PASS
8C52B36C8D97B6580238C293FF93211A32ACACD62CFA6B718966BEC2955901FC,131,125,6,0.7076604666545525,PASS
5C3E360A4DE137B1C9F66001592BFDD4AB8813E151790F0AD175747F52EDB4EF,124,132,8,0.6170750774519738,PASS
C21033F76471BE1DAEAC027C31DA994D805CD5F4E81EE48470E9E01B6E9A5526,133,123,10,0.5319710580974012,PASS
EACC9620D22A3D03680CDFE2E82A1DDE96DA9005343FE1FFBAA17DDD66EDBFC,122,134,12,0.4532547047537365,PASS
3DAC8B4AA71BBEB5733C69E6A51BBC58A3D069041357D16F56D6FAE53804719E,123,133,10,0.5319710580974012,PASS
E8CCF7D4B47817418E949DFA1BF827E6984168240CEC4994D01A80FE059E9CE0,136,120,16,0.31731050786291404,PASS
4F3D4042DD942B2A7A04A3F66C847D1F2BFD219718CED6B0B0D7335A6030519B,132,124,8,0.6170750774519738,PASS
E9D5E9525145C8009ECB0C21E228D67EE14B68C1B4385D3AA7D043F81D45EEDE,133,123,10,0.5319710580974012,PASS
68C82A458D6BC850B91B25F80A00A54FA44623A94CF2223B5209808378A014FA,151,105,46,0.0040402749798920095,FAIL
C16009B9190CF6EA42E03EF885FE3079384E163AD2A90FE91FE9ACF6A8E31D22,131,125,6,0.7076604666545525,PASS
763A69465A53F76AC667A516B4E5D4B0DB49E5C0D5C9E48DD53A59EDC85CC918,124,132,8,0.6170750774519738,PASS
55CFF5DB140D08FF22838AC50FEA8F35290F5D240A31ABA4CE14A5A28863EF3E,131,125,6,0.7076604666545525,PASS
9D742286381CFDF959307A259AACB70320E290AC5FD2D690BCA5F363B00B381,136,120,16,0.31731050786291404,PASS
39F0810DE04021A4EE3701095F0AD64C085B6BCF7A8ED29AFAC23A411E49C8A7,140,116,24,0.13361440253771617,PASS
15E6B741FC5D1D552887AE4DF00015184CBD06C8F5B59A297CFBD42F4D0A1EA5,130,126,4,0.8025873486341526,PASS
9FE7FFC4996935F487DD2375C1E2678B8061C90F7F523DA0BEFF0D98854D48CB,119,137,18,0.2605890342736178,PASS
1831AFFB12F50B4CF7FD428F7970072F854E4EC33ADA13B2B4EBAF1B939D3FD3,116,140,24,0.13361440253771617,PASS
23A71F8BEA3DFBF9F65C660AB8B00142F16A1F3DA3C74DBC9C9FBF75A57ECEFE,109,147,38,0.01754895019147673,PASS
12740087A178F79B7116BDD9A52B30C9B1BA788427EB3BE4A4658AB01CF67AA,132,124,8,0.6170750774519738,PASS
78B876BA017AE033533A1272BAEA05A8DD4F869A9471F48162C89BA4301E28F,138,118,20,0.2112995473337106,PASS
69F0C0933CCDAF689278774F5B2FC496C8EF552ED61923419AE2C8A9F488120,134,122,12,0.4532547047537365,PASS
4EF7E3216C081CFA4E43A7D50416598F0F76159785795E8D6120FA8EDBEF2876,126,130,4,0.8025873486341526,PASS
5C5A310A0256E991FBFAB7EA843A6ED40488A606DA0DCFDB2DEC640A3ED587A1,131,125,6,0.7076604666545525,PASS
6F2909301C9863585A54AD1769AA1DA3A47A2E5620D532738E2EFC035BF7BEFF,126,130,4,0.8025873486341526,PASS
D9B4B23FBB9417064E1738C7C501A86B20C1C05DD285417334A5867B64B78AC8,137,119,18,0.2605890342736178,PASS
D42CE6A207D9C14B63295CE01C461863F8B48F54AA0F44457B35E35204EC630A,140,116,24,0.13361440253771617,PASS
427ECB097E90A8AE051077638CD66BE61B16A95F457BEF5B4F9FED0587A7F02F,119,137,18,0.2605890342736178,PASS
6CFEFF4EB32CF22D302A52C7EE08236CDA5F61C00A3976D79CAD6EB758036CD8,123,133,10,0.5319710580974012,PASS
D0A7AD8651B9DBD89917DA75E06822BE1BFC4A5EF3975C0D98AAAFD6587C8374,121,135,14,0.38157390570502125,PASS
BB61E719041E8019D5E0CB07BDADAE94947F41EC3D206AC08B7070CF1ED418EA,134,122,12,0.4532547047537365,PASS
1F7BF3DC53D4D115B13AC3813B83C35390A47E7FF6F9C7C59F9AC91613598DC1,119,137,18,0.2605890342736178,PASS
54770193F0EE2487AC9683F49B5AAC21E97A318135E43D126D4A750E88815D76,135,121,14,0.38157390570502125,PASS
21E4B6139D3950B5A610FCA9FD8E515D652AEE39CDEDEBFB7C898B473D234656,120,136,16,0.31731050786291404,PASS
FA94947E1CD5EE033E4DF6CB14830ED141AF4574A47CF60CECA7CA8AB7C2CC63,125,131,6,0.7076604666545525,PASS
343D38F12E78EFDE10C2C70166AAFC721000CDAF0F3576AD7154C8B5E958B6A3,129,127,2,0.9005235503397743,PASS
B68245BC09CDBB343522B68214BD45EA568E26A5C8BF64D391B8CAA6359BE18B,131,125,6,0.7076604666545525,PASS
CAB0C7BDFA32D0A41E841C5037C8F46D51FA16266C185C10416BCE301D792405,141,115,26,0.10416255883043901,PASS
11883D6CAFF244D7BE778A28906B4F4784F704EBF88A85E4F591F11CCC0A5ADA,128,128,0,1.0,PASS
B018F0D30C6316E1B0D4C96D18B63082B97E5BC5CC9C1BC461517A5E801755B8,138,118,20,0.2112995473337106,PASS
6D9A95BB796CDB75F12B3944983D404761E6F1E28E855813E91E51AC17DC9CDD,124,132,8,0.6170750774519738,PASS
A667EE58D9CD1C7B00430313B6984A479CE72DCAD0F3F17CEEA423D20E383FAB,126,130,4,0.8025873486341526,PASS
CBF98DC7084EA79374DE12F68A4E61CA04726B8E96C8790BB4C9CC3A5A8DBEF0,127,129,2,0.9005235503397743,PASS
39D238F13918F51DF4D31AA4CA4B938D068A1FC27BDEC0DC58924E8E2C7F7FC0,127,129,2,0.9005235503397743,PASS
29E5CB3AF514AFE025790522158791FDDB4855EF46EFC64F2BFE2A6EE6BE0955,119,137,18,0.2605890342736178,PASS
70816A0493E1855B73FED24564EFD138A37EA0B35399A5B2CCD2983BDFEBF01A,125,131,6,0.7076604666545525,PASS
A7DAD21AC121716D660CCB2DED937752E2DEEC215B52AB4F0CF45A155E0C9488,130,126,4,0.8025873486341526,PASS
8B0D9E6C7718C55606A0737FB65ED5E6B2D11AC5AD1642724A92EE6B9E8279E8,126,130,4,0.8025873486341526,PASS
E7E9FC57EFFC4420A44BF080B84E9B737781D070B115EF0C46F60B3A08C0AF95,129,127,2,0.9005235503397743,PASS
98201266E8017E8598692456CB575ABB047A0C078FF80FA38C3DDB0B58BB89D0,138,118,20,0.2112995473337106,PASS
E6A703606DE9836D69EF0C617D5C319726B10B468861C7E281DFC0C557D979B8,129,127,2,0.9005235503397743,PASS
3D13D0B95899F4792CC8C94EF79E27FA28A1C88127C65EEE1970442540B81E0F,134,122,12,0.4532547047537365,PASS
332BDE7A019072B7773208CBD38C3533014A7A04C2E00405AF97B5C583C004C3,144,112,32,0.04550026389635853,PASS
5AB734792355DF80ED7ED5CEF72F1A98F93D96F23228A2A3FB3CAEA82290E921,121,135,14,0.38157390570502125,PASS
157B3A7994E260023D51ABB58E0638BE7E505AC467C043479A1551BD20EA82F,138,118,20,0.2112995473337106,PASS
7727C4273BF8BB7EDB8172BBA2F031BD6050A0E199AABE8E3CCBE6F2EA8CBEF8,117,139,22,0.16913144470267139,PASS
6E5919347FC57334542BC8E0C90A9ADAEC8EE770CE333BE72C03269525638846,132,124,8,0.6170750774519738,PASS
CA38FC35ECAA585F844E84E09E67B54D679B6059A471C714BF5DBF0047F308F5,125,131,6,0.7076604666545525,PASS
532378903D4D16610DBDF0D0A63809E45F1FF87308CA0FFA065EFA8CAAD6B968,130,126,4,0.8025873486341526,PASS
2878E9D7898610BD8F81F25E92F7749208EC73703A587920FB05BCE4769DE4F2,128,128,0,1.0,PASS
D95B130329A33D0E55A478CE6DF60135245607395EC1F143321ED8AAD78BF5FA,128,128,0,1.0,PASS
F4DFB114E0DF4ADC21AD89C45C68FDD8C3FD4D026250DDA08ADA90CA827BB147,130,126,4,0.8025873486341526,PASS
12E062EC7FF03C9DFA6A54135A6D524C7796FDB4F4E26F669B3EC116B9276512,121,135,14,0.38157390570502125,PASS
1CBC00DB508AD18D0D4AC4FD689D8DBF2861908CACB1499F9674E75C63D7E0D2,132,124,8,0.6170750774519738,PASS
F448D7AC1CE84EAD47A6C7CF70288466A13D274754195F8205FEECDD4B457F10,128,128,0,1.0,PASS
7F16AC7343F8B23DC458C36B823CB194A37D0EA63B7284E453D42EFC3FBB52DF,120,136,16,0.31731050786291404,PASS
12D4C810652F748210D91210B0E91BD46117630D6B75A6D3D8801E8243EAF22B,145,111,34,0.03358661289689768,PASS
71A057D446803B9D027DC44E208E2B16E6DB0CDAF0D1DA38EFDA6C8C051337B1,134,122,12,0.4532547047537365,PASS
D2643B355295D7B8B0392FFFA28DA6707AE54FA6CCB0BAE39BA92934BC13C26E,122,134,12,0.4532547047537365,PASS
15A2954875A5C02911693C59F2729557422C97A178A7C0EB0C23312451A58B02,146,110,36,0.024448945310089426,PASS
A64384CA386C9C5C325347ABF28878CACF7F421F211D76D95659B9959758FA88,128,128,0,1.0,PASS
5FC0EF3E6B3A4E5F86CAAB19D0819A8E21D1840B71474BDD61D694E1647B18C5,130,126,4,0.8025873486341526,PASS
305828E53529FFE2CCE8AD9A659B9181A0825F8D6AAB3D868C8BE295DBD209C1,133,123,10,0.5319710580974012,PASS
C0B6B3FC0598A7E3841796C8464C5473153DDB8055AE056D6361F4F891C54893,135,121,14,0.38157390570502125,PASS
B4645F2457B13954C7E8FC1F8E15BAED48B67652FB36CEA954440259129DCCA7,126,130,4,0.8025873486341526,PASS
9745C109CAD7E2FECE69E7D517EE247F3EBE08A930D4E3E4088477C26700114C,130,126,4,0.8025873486341526,PASS
48B90EB7459BCF7ADEC4CA449799682500D2E4C985B3E853C734D01AD48EF631,132,124,8,0.6170750774519738,PASS
77FF0C4A35406937F3373C431DD46815BAB93F94B614D41AD9428FCD07DB35B1,124,132,8,0.6170750774519738,PASS
36DC4BC7A6E32A2C4A5D609F588E61C1B21008C49F1C43D89D718154E1DE37C8,137,119,18,0.2605890342736178,PASS
CB47247B09FB7FF5C224F33EDDB658362E8434FCDBCDB73EBA04AE94948C8ED4,118,138,20,0.2112995473337106,PASS
74B9F664C373A389AA44C3E036F53533FBAD40BBD84C332368F50C5F873D33EE,122,134,12,0.4532547047537365,PASS
639ADDB385E41F5C943CF52F57DB6B9F98EF68C4E70665FDB9C515BB742F6595,111,145,34,0.03358661289689768,PASS
A6D25D6247F8364683733CECB6324AC49363DCFE66CB5ED40EB92C8D0C073273,127,129,2,0.9005235503397743,PASS
BF1071EA48239659C3E382C4550951BEA969FFFECA6626A7673AD36EAC19FAFC,120,136,16,0.31731050786291404,PASS
AFAA387CF8F1004C88A14E48108AEE9A85F4D48B60FAFDABE9AD1AD31F74C934,130,126,4,0.8025873486341526,PASS
8001718A9732FEB5D53BFA7B06E1B90B191B72931A5FBE786B2560D529907797,126,130,4,0.8025873486341526,PASS
A9FB18039296EEAF832288680DCED530D5514537CDAAB5210C01D699750FDF11,135,121,14,0.38157390570502125,PASS
83CA8E3557DCA6DB9A5779384F347415F3A6864746102D6B68F8960FC77A1B3E,124,132,8,0.6170750774519738,PASS
6610C89733D0D56708831B17602724B16B8B752E888BDD8D933EBB6615A82A0C,138,118,20,0.2112995473337106,PASS
9B2CF6247CC50D9EBE187504423A77C58FCDF52B62239024BAFF03512F1D6C65,128,128,0,1.0,PASS
3461A2CB8EA98212793D24976633A68BD62833236A4A09C95BBC3265CD3A8353,137,119,18,0.2605890342736178,PASS
7096CE03E5C84BB2FEEB388C677A583E749043896DAE6EBD4B859DFFAE981294,123,133,10,0.5319710580974012,PASS
1DFE91493B8A00A1FD735BDDE38CB32819C428BA6E2947D3480C04A875091AF3,136,120,16,0.31731050786291404,PASS
B7AFABF44482B408E9127F2A5F75B6EE42E72F561F953118EC15CC7B3C102FB2,123,133,10,0.5319710580974012,PASS
B5F2759173A0C62175621BFBBD51660E847E6605D0F59A03E9E8720463E7A2B6,129,127,2,0.9005235503397743,PASS
C4B3C3153723C90E1815E81E6B48CF6CDD9EB10C265F2FFB8398F8FEB80E6305,127,129,2,0.9005235503397743,PASS
A3E574871199D4232DF7FAC6CB252F4D1FE5BECE62A0AD64683BBFFE381F7A6D,114,142,28,0.08011831372763423,PASS
3C6BACA00477A2CE95D446EF28FBC25AC0D719BD2883AD74543F50F7E00A9D52,130,126,4,0.8025873486341526,PASS
5F80C63E1A990650C5B454E114EA7EF699588F6B20A9D1C4066A978CEC3C37AE,133,123,10,0.5319710580974012,PASS
76CDD073314381325AB201CF01B300C16F7C431FF00FB2B1E7B14F986FB442A7,133,123,10,0.5319710580974012,PASS
FA97F1C475A1A5310DFDE13899EC23D42A79A7204CE1188057FE078C70415F84,134,122,12,0.4532547047537365,PASS
9A6D08C522C9A5E5EBA7741CBE2674F181AE85CD04C443DCD5195A5A1D7ACE0D,131,125,6,0.7076604666545525,PASS
4C60C2C6740DD12B92146EDB6DEF20D741339BBDF1EF859F55069185B551C655,128,128,0,1.0,PASS
6B5E7AC35854D3B329D4ADE19756C5886EDD649F632AE9F51F541ABF032F7B1F,116,140,24,0.13361440253771617,PASS
C3B342787EF16C19B8D602E7B5FECC5C39F3310FCF5E60AA600A042EDBA7C2AA,126,130,4,0.8025873486341526,PASS
EB2060AC1C114BE86735C40630ADAEC06728612AB9F1D73818C29F2FE8895372,139,117,22,0.16913144470267139,PASS
259BF6D677F17D1EC5065E87B4034A3AF05409432DB8C08B4B5D656406B3C092,134,122,12,0.4532547047537365,PASS
C0B7687DDBA4ECAE72DC78502D451E32E556570570B093896156EA40412BB346,135,121,14,0.38157390570502125,PASS
FD6FED5AFF2C21A2A86EB7FC83C231ABEEE2EF4D6DD6843AA8E4889314A74554,120,136,16,0.31731050786291404,PASS
6BBCB14219E564AC728B06C7285EADB16DAAADBC0174C84E3F241476A842D78D,133,123,10,0.5319710580974012,PASS
24A02245DBBA84581A5C208171B50E69BD330F71881FF54B9073B8D37B07E4B5,136,120,16,0.31731050786291404,PASS
374C2978FA6D9C9E5DD1640F25367D8AFE7295D0B4C07A02138E15957FFD3218,126,130,4,0.8025873486341526,PASS
B504FE71249046AA56E69EAD852953CF8A20FF6CA11535349BB3C321BCD6E27C,129,127,2,0.9005235503397743,PASS
3BB7C5D7D350BC82DF7C035625DBF03A0EED53837E9EC37895BC936F189906F9,118,138,20,0.2112995473337106,PASS
6318E756FE7BB2DC8EE772E3440A3A95A6F3B2B852CDCC96B6612AEA3AFBDF44,117,139,22,0.16913144470267139,PASS
44A9F71FB1D23362514691FBB8357C0A9F21680DCED9A208FD4496537B18FCF6,127,129,2,0.9005235503397743,PASS
AC20DB5041BAD47E393E8C58FA8162CCF10614C9A895E0EA9E124AA8AA5C78CC,139,117,22,0.16913144470267139,PASS
F6E6A73D1B756F1B6704A5BD55DA70D0C7F36ECBC198803442277B43A1A39BE1,123,133,10,0.5319710580974012,PASS
175BD65F0EFC29BFD738E074F39217464D36CDDE1FDA99E54AF39EF97247C0A7,112,144,32,0.04550026389635853,PASS
3DE6FFD55B60EBA41B3A48F99D1C20A2E12E05BB14E3CAAA4DC69A9268BBAF11,126,130,4,0.8025873486341526,PASS
DAC7C76035B3A90699B259AB3DD9E6A2F537A8B2D1002C4BA953DF560817AE79,126,130,4,0.8025873486341526,PASS
49C1B82FB58E9DECD2E098DE607BE02DDBEBEBB8098A59FF0F2CD7B98E7190DD,118,138,20,0.2112995473337106,PASS
3E709A9078E9BEE23FF3690F4862CD3508EA05BCAEC454A37523E1EC2E18DC6,131,125,6,0.7076604666545525,PASS
D8D5FE41B33A265FDCF0BB5614EB258EF4E9D6A4ED1A18B6C8F4A057AE3E7288,121,135,14,0.38157390570502125,PASS
AACE836A5F82CAB0D43BE663E0870C5DC3A4AB481813B2163B83FF950C4847E6,134,122,12,0.4532547047537365,PASS
89858DCE3D32CA722D4688E36204FEB0268CA55E775F951E800D915C32FFDF57,128,128,0,1.0,PASS
5B16B4EDFFCE24B1D5589B2E2F89626C43CDCB96484FEC815ADC76E7D6C1A020,125,131,6,0.7076604666545525,PASS
A96A294824E12C7D509F29223C0E310B89209738A67D6D61FEDFDDFBB989E18E,129,127,2,0.9005235503397743,PASS
34D08A0823CE8741B1C9FF97E92661343E233787A7D9B0C4AEF9A54A705C4A5,134,122,12,0.4532547047537365,PASS
AC0C4808ADAB592D5E430118EFD3BE03FEC97AAEB9295BE042368FFCC4C6FAE9,126,130,4,0.8025873486341526,PASS
DDFC481E7D8C94DDF03F94C8B2A4276352B79B41E1CD91B388541C77D75FC1EB,121,135,14,0.38157390570502125,PASS
306F30DBDBC39B366FF9C96A509CCC7AD6A916DD315E92299EBAA3096817468F,123,133,10,0.5319710580974012,PASS
58963C3CF43C126FE581460A2D5DA14FF709165F7961E23E9B7BBEC2F887B138,124,132,8,0.6170750774519738,PASS
76B1BDE0C2CDD0E7D810B387FF99849B2A10DC2106B7FE4931AC768328EB741,131,125,6,0.7076604666545525,PASS
355145428EEC04F8F817987B3942DCF314615027D61D3D8AD8EA3BA9DE4360F7,130,126,4,0.8025873486341526,PASS
27BF63181D190C51416CEBEDE153670D36842932DBF6870EDCCE4B7D715B60CB,126,130,4,0.8025873486341526,PASS
59162980DA67E1442E623C095B93E5D6E833BB1E4EAC9442EB7A900EC6616913,136,120,16,0.31731050786291404,PASS
5F960C39331936B9B79F6AAC632D66D11065BB23ED63156256A381B6B35F1257,125,131,6,0.7076604666545525,PASS
46CFA64BF26C7DF52D0E84E2868FA76F1D51E9950C727D62ECD64E7639801DE6,122,134,12,0.4532547047537365,PASS
6C72A32960D267D9E096678E94DD9754668E9F754952C08C0916D4191FCE8035,135,121,14,0.38157390570502125,PASS
9798572AF14E70BFAC9839B97DB570922AEC2CA40360C972357CAFA77179A0AC,127,129,2,0.9005235503397743,PASS
53F64700FE025C1CA7E75AD851F3DA042D589E2746CD56E8CDBEA68C12CC12D0,132,124,8,0.6170750774519738,PASS
205D7B9B6C0D7A4DF5A022E3B768C7A43A5B83006E4C0F4C6A259E493D93DEF5,128,128,0,1.0,PASS
10DDD4983CB5B114135A560F103B46111A6AB69EEB071FE73407D9917C678310,136,120,16,0.31731050786291404,PASS
DB8CB00356C7390EC6EF989FDE52BA687C0A86178328034A1F976E7EC0B797AF,125,131,6,0.7076604666545525,PASS
ADD5F3AB260B6D2ACA3A0B24FBDBFA40358C8EB5DC932CFB996D1F162ADA213E,121,135,14,0.38157390570502125,PASS
C75A6F76093D8292013416D012AA672E0C2344A004E74540F36574FBDF361C5B,139,117,22,0.16913144470267139,PASS
28F93B4CAC9C19680DD965A1C635281C58BEE693A1FBCBA77FE9DE28A49EF21B,123,133,10,0.5319710580974012,PASS
7112333FEEA537D9A0E41B989E739D956BA69D30BE9A45530F57887A1758D73E,121,135,14,0.38157390570502125,PASS
6B32E13DC1404F551D908CE21D48EF4B4AA1274DC27FDC9751D4764A0EF3DD31,129,127,2,0.9005235503397743,PASS
557D0443DD1A453982932D9A45A093F52921D180ECABB967A81A73D85912FBE2,135,121,14,0.38157390570502125,PASS
7B71A52C25661655535A1DCA7D9B2BD30CBD3EF90C3BD8549E5BE585942C0692,127,129,2,0.9005235503397743,PASS
94E56B8A054C010F084055396D1D80A59AB2B88E346685C3B6560F3DB0768723,143,113,30,0.060792723530522785,PASS
66F8AACCE67E1BBF76314AFF40A204131398E2B35AEED30AC5776CA4CE79FFBE,117,139,22,0.16913144470267139,PASS
2F0A3D27C964EE9E3DDDF984D2095C8D568E8915DFC3A6E2F8F70EA5B6D2605C,122,134,12,0.4532547047537365,PASS
B8C4A8CAD26E95F5051A16CC55A7BECCF2244597312A9370BD1D6F0238359D50,133,123,10,0.5319710580974012,PASS
5E95F7BD82CD6F04986F981DFA9F59B4856B48CBDF75B609ECBED09E367E486,117,139,22,0.16913144470267139,PASS
3D2DC4A0645BFD5B2C3ABA63A11EA1ADF8FB2B4809A7D957665B37FE071DA468,122,134,12,0.4532547047537365,PASS
306120D71822E3C70976F8978EBB74E8DE6211BF3C630C0706BA4364B3AD7D4A,132,124,8,0.6170750774519738,PASS
4153A0ECAB84859AADDB6BC847ECDFEA37AA92F8D7B810BCD50D2066E3CB7B8E,123,133,10,0.5319710580974012,PASS
1DF287E6B564D83A0EB4CB201CEADB0D9FDCC4D49B3C4129BD486DCA3B265A0A,129,127,2,0.9005235503397743,PASS
91F76B070B87F2EC48C7C12E4AAF69093A29EA0CAF84576B1AA07E9DAA407931,131,125,6,0.7076604666545525,PASS
83C9D3ED4E4EDD9E6164EC4ECFC7E9BE98DE0938030A9C5683DD03A487CC26AC,127,129,2,0.9005235503397743,PASS
F34AFC0AAA74A44D2A3B6B17C31AB6E1844372C7AE8F880AAE55F2BA3B3A798E,126,130,4,0.8025873486341526,PASS
317C900A688508765F5A5AD64FC3FB3D7998B77AC80D7E803AD4E057F63A69BF,123,133,10,0.5319710580974012,PASS
3D3AC462F44319D57FAE0B3881BEA69105CC80B96176FE253A204CA700ADAA64,137,119,18,0.2605890342736178,PASS
4DED5B32A6890961FE4BFC758A16D10DAF1D0B68AFBF9F7BC9749F09B1CDF98,118,138,20,0.2112995473337106,PASS
AC20AE34546E217F63B6B3A045D4F9F96763A70B00E5A8042EE7BA85D12A7F9,131,125,6,0.7076604666545525,PASS
5B1E52B1BE08C54401CC4C03D663D35F512461DC967E37CF67401F150D62BA15,135,121,14,0.38157390570502125,PASS
88B8970ECE819C77DD8C2C23BE71AE70AD8E574BE17FF522D6C374B2F67E10C2,122,134,12,0.4532547047537365,PASS
97011AAC5A3E5E3164D0E6094FC46604DE63ADDBC1F586F053DAADF46E91BAF5,125,131,6,0.7076604666545525,PASS
84C4D8232A793B8BBA1773D435F958ABBA9720871F096C1EE8293B9087C0B364,133,123,10,0.5319710580974012,PASS
62FF37193B0EF8426AB99FC7A9624B013BFD0F7E043B192CE0439E95776BFB34,120,136,16,0.31731050786291404,PASS
EF5099D5DC570971066CF677D170A10D4437CC93491B75ACDDAE9234EBE56303,126,130,4,0.8025873486341526,PASS
91064918CF8893A8EAECD1A12CD3227FEB093D49B6E76AFBAD31FD7BB57E6B58,119,137,18,0.2605890342736178,PASS
8EC20D2BA3915F18736EAA5E619F49F0231DAF725966738122E757282016072A,135,121,14,0.38157390570502125,PASS
573393E8526BB679D89F0A1B959064117F5B55767A51F556DED07CB0F4289E25,123,133,10,0.5319710580974012,PASS
1E4EB426411B0407ADDE9E8B2CFCE71AC042F16B63B97FAB5596C2E44510B682,132,124,8,0.6170750774519738,PASS
3F0849CA6055110C1D6783A98FB292909B8F7BD1C978CD9E8CCEAB24A44D4DE6,133,123,10,0.5319710580974012,PASS
E25D7E88399F4707D565AA08EB123148162604A94EB72B01827DEE356A13F51A,135,121,14,0.38157390570502125,PASS
85EC3CD2A83F155EA950E18AE9AF8768866EF3961BB3D88346747BA72CAE6637,123,133,10,0.5319710580974012,PASS
239242D247F259677D46F15F4FCAA160F164CD2ABA845401F74B903CFB14D26,133,123,10,0.5319710580974012,PASS
6B3E899327CE72CFE81B66F5E3747DB0B1E628FEB9ADF514457DCCB7ADB22B0A,114,142,28,0.08011831372763423,PASS
9E5E1224F417A3D35E8CF62D3F85B00DB300B913983C6FDAA6CF369A2AB88FB8,126,130,4,0.8025873486341526,PASS
36465526BAC12FDE9A77718F77C32AF2E159C18375EF0978338F531026228EFB,124,132,8,0.6170750774519738,PASS
325CA18FBF34C84A143891D416F80EA84D01417805FD37F3ACEA87302B51EF6D,134,122,12,0.4532547047537365,PASS
CC2087A22A76EBC6B9EFC2AF33BE0B63E4AC9F765454D478C2B13BC99518BB23,124,132,8,0.6170750774519738,PASS
4BABC1EE4E901DF4E5290E12E18D935831AAC72D793DD8A1A70DB4768B12F1C9,130,126,4,0.8025873486341526,PASS
7DFE4C2AE95D97599ACF1281ECB61390BE44A1EEEDE98B061EAA8AAA5EB45819,125,131,6,0.7076604666545525,PASS
30EF7BF384CEA1B9E912CB7BF6D52825B0DF6592051E3CFC42817BD569491D26,124,132,8,0.6170750774519738,PASS
5E60E16C4931FC8EFA541656307C3D2B4557F209D283473A1629A2FE6550E3C,134,122,12,0.4532547047537365,PASS
BB71C1D04A6EB575499C726F6FC043BEF9C3BB6513BCD05C294E4699F9924F84,123,133,10,0.5319710580974012,PASS
FCA5053D1D9FC501642F46F4E0D4EAE570E70444291AE27EC3D51D9709351C44,134,122,12,0.4532547047537365,PASS
BA878219035B8EDAAFED32F243666FB0A4B72B57E6BC6DDB20E5254020BD09B,129,127,2,0.9005235503397743,PASS
A473A8D8B2EB9ED3B063C138720A945E481D7ADD55EB70E3CE465F924FB6647F,122,134,12,0.4532547047537365,PASS
9D6D008812C22E718715205F732AE4132B5729B04E591B2414F4FA2F903875B8,141,115,26,0.10416255883043901,PASS
945DB4AEA4A6FA997B0F00F2730F8D877D5F71AC1A908CCEB311231E5EBEF700,125,131,6,0.7076604666545525,PASS
5BB3C7EBD5FEC55E88C77A378E6E5ED348CC4A7BC56BDE6BE4E4E089655C65BD,111,145,34,0.03358661289689768,PASS
A3FBC4F4AD713140E462FBD2C2ED633456512FE10B8D5AF30695C8982F99A2CD,128,128,0,1.0,PASS
B00B626DE339D2A9F16A8E49E8E7A9286A21FD5874EEF2BE1DACB0C2F2697A7E,122,134,12,0.4532547047537365,PASS
8E6A5A0AAB4D3E78F583E1AEC1B9FDAB242CC9AD477A31A0328844AE867A178F,129,127,2,0.9005235503397743,PASS
5D154FF344FB35A337496E8C2D2C4E271DE8F59C871C41CEB7EED0AE1991FFEE,117,139,22,0.16913144470267139,PASS
AD6C157581E9E714BA908D8E39AF5BA05B51F17F4962CC7DAD8F1F733BD2AF08,120,136,16,0.31731050786291404,PASS
ACFB00495BDD975BF866E6BE53C0613DDCC6288623D5AAFBDCEAA45768F7ACF0,118,138,20,0.2112995473337106,PASS
BF2AA08C8F95825E1FFF1D0F4C41E928A1973B6F94569FF9C24A8B35555B33F2,122,134,12,0.4532547047537365,PASS
E4B894FF2FB80C38647A741CE56FFB5AC74C25B354E6BCA08E6EBDDC61EFC96E,116,140,24,0.13361440253771617,PASS
25B4BB08C1C9F6E15BC9F7EB011BEB6C835BAB8E66D3DA791C55AC7B9EA18BF0,119,137,18,0.2605890342736178,PASS
A65047A394F9D822C5ECE6C91FDC67533E2125D6BAA6D00DAAC58FFD2C573D2E,123,133,10,0.5319710580974012,PASS
E37919E39CC7EFC183BB115A236B14743942ACA8E4AAAEA793EB96C6B185F637,123,133,10,0.5319710580974012,PASS
22FB5FC87F98CCB7A77EB6D40FB61B13DCD883F76EE9D552C76DFA07817B3E4B,109,147,38,0.01754895019147673,PASS
F39970F0A97A0D0A5F4C678C54B1235F7ADAF72BE2F000E02F07386503202D67,133,123,10,0.5319710580974012,PASS
939F7848DBBAA6C3F8AA5203E6BFF9575645CACAC4B9773F454247142E033555,124,132,8,0.6170750774519738,PASS
E5F270EBD6BFD14F1BDC31E10A2DB685ED5F7CD20D0D8679E424A375AB7BB709,117,139,22,0.16913144470267139,PASS
CBB97164B5C31E72917AA1F35C06F56655ED0C2287A1ED8F224D45CCD64E2145,130,126,4,0.8025873486341526,PASS
15EAFCA4D0FA7A0B690ADD1BE46758E46F7995BA5BA9B2F0854BABCC21E5CF96,120,136,16,0.31731050786291404,PASS
5C4DFC2A9BC2F0520B6FD9A7B34B0E1CA282002925903BBDF2EE8DFAB942155A,131,125,6,0.7076604666545525,PASS
D776163446708C205BB359F532E5BC2E2AD94BA0196FF7BD7EBC61770C1C95E3,122,134,12,0.4532547047537365,PASS
C72D81C411F87F074C96B179C23F09B1DB3CD1A580D4A60F74926E6FCF91AAD7,126,130,4,0.8025873486341526,PASS
4CD042F5691F5C3DDAAB29577CBF6BF8367455BDFD6DBAF416EB7BAC52443FBF,107,149,42,0.008664896726025117,FAIL
ACEAA7DB8D6AEF54410DDC1E790571ADEB0506D53A27EDFC011EEECA7A64370D,122,134,12,0.4532547047537365,PASS
D136D9CE81017E8D224164AE3ADDDEDB67ED76B570FAD543850049011B800B51,135,121,14,0.38157390570502125,PASS
5A0077B630DA5ED48EBFB148B6BBE57558B8020108C843B6D121466DDF397886,134,122,12,0.4532547047537365,PASS
63B8FA978127B1B6067CD2C8E1C3E0C31E61A6414872CB456F1E3312C7CCE921,134,122,12,0.4532547047537365,PASS
8EEA63E8A73B618576D419A625A2DE0554117B412F794AA2F0CD966E4CB859D3,130,126,4,0.8025873486341526,PASS
AF0D4677DF5AD9268A585635CED8F1BDE4A95CDC387E61E00433BB05D372DF4E,120,136,16,0.31731050786291404,PASS
C094B5396543FAAEC07E95A155488F925B1F511A0B9C247C8823EA984597B98D,135,121,14,0.38157390570502125,PASS
2418AF56B430FA15F7EC49A7CF6980BCAA971D0E53FDD2C65A484FA7CFF3052,125,131,6,0.7076604666545525,PASS
CBF2A8E5FF8F029E711BB46514E7D1C99CCF7D16797C9B6ADBAF6A8F6917F2BB,109,147,38,0.01754895019147673,PASS
2EF078DEAB60EB906A415FEE56AB2F0BF8A9227D04E15945AD2B0A482B708CA4,133,123,10,0.5319710580974012,PASS
373ACE41303C3F9BC995FCE1B9574914584E71DA0D627608342762B5BA193960,133,123,10,0.5319710580974012,PASS
358BA250A6BBDE666AF300E5E920E9BEE4AF8AF16BC39FF88B264BE8CEBC1468,123,133,10,0.5319710580974012,PASS
31FB6DC85FD68C8736EBFFC33D8D26F6A2A1BB4190B04EA79FB92FFCF764E75E,109,147,38,0.01754895019147673,PASS
D29617ED7F0F4624C8BD293E7146C09718C4C284ED5FC6A74A923C2BF763470B,128,128,0,1.0,PASS
A74D95173E9887706BB8DFD31DF2069BFE1A88227D800643EEB2043A0E8374DB,130,126,4,0.8025873486341526,PASS
8D23A8FC5EEE6EF20862DB5C533D62B993ACAEC236EE756433670E4EBA651448,125,131,6,0.7076604666545525,PASS
EC3C485918E2CEA7ADC2CCA06FE130F7C511E61513093BEA63BC83196E9200B3,135,121,14,0.38157390570502125,PASS
B401E4738112B28E752142554BFC2E8AB3C4EDE88C4E9181665EE6DF69EE3A53,131,125,6,0.7076604666545525,PASS
4DA4197FC4D081CE81EE7EF926F1581EAA8D639BF36CC07D20E1CA1918745A7B,128,128,0,1.0,PASS
A4333072AA44D90153D791E6C9451DFF4AF415BCF88863B3A33AEA36797A5A2F,126,130,4,0.8025873486341526,PASS
77DE95953CD6C22BE895D1239D602073A63538D8498D3BB919AD96456D13304E,131,125,6,0.7076604666545525,PASS
602A49AC9A72177FF6880989696C99008BAF0812C9D8B6CE4FE7EC4357399F3F,129,127,2,0.9005235503397743,PASS
FBB8B1FB3F839468C95B0C0E109E3B64016B57A6EA3A61B9B260C4C906ACD13,134,122,12,0.4532547047537365,PASS
56A18E2C063F2FD6773C4A04170D8E49695FA73DEDE588CAEABE991B0041DE38,129,127,2,0.9005235503397743,PASS
FAEDD047696D692EF09991190010317AF8B79D7CC7FE8BF112160C0BDAB5E9BE,124,132,8,0.6170750774519738,PASS
D80E200EF8C22179CBDFAD8F4CADF47FE2523AC7AF24EC4503225193CD5F4550,129,127,2,0.9005235503397743,PASS
D959BA5642A6423D8659C9AA93FF37FB1B9C9EF2D264722B9CFBEDBC984D394D,116,140,24,0.13361440253771617,PASS
5A7753F2E471511396EC6DFE87543AC44BFA322CB93CCBA4F6F54B95957055C,122,134,12,0.4532547047537365,PASS
28FD63FC3583BCEA74ADE6F8737DDF8DF014077E19BE8D7881290553129A653,124,132,8,0.6170750774519738,PASS
F73925627F7FCD5C2CE34AA9B42EE2768B879619A96A73A6218B45A079F64729,123,133,10,0.5319710580974012,PASS
740BBB10008F139CFF95A00C2149D37EB43692F2B97A7A1207FACAB4B724A574,132,124,8,0.6170750774519738,PASS
297475D0B8F0746E3E865A5865EF4B148920C8F624125AB7F3ED686F1B136355,129,127,2,0.9005235503397743,PASS
27A57664F49E413BEC6D7CA63B04702C13142CD6C53EB6E335CF5DB9B594504,129,127,2,0.9005235503397743,PASS
E5FF44F6711C3B8A2E1C9EB3C3F165AC364F8FA5D4BC7547272D0BB71701F679,117,139,22,0.16913144470267139,PASS
B758821D6607C3BFCC7E2FB545516DB57AA75DC9DD826DE50C697A35A2528433,123,133,10,0.5319710580974012,PASS
3998A53D77216B30C24D2C2762A36CA73B42FA6ED2E2999EA59D09E58701FC1B,129,127,2,0.9005235503397743,PASS
266D3F06DCD5BE370B22C8E2EB90EE1AC28EAE2E484E92E905272F3046D64F81,132,124,8,0.6170750774519738,PASS
B898D0C9F681A566DCAB4C146183DCDBB3B686DAA6AC6AE72E81AA8C96F01385,131,125,6,0.7076604666545525,PASS
D2F68E2F14D115EC8BD094E2A5F14AA1C675A4506CE081ABBA60522DA114EF2C,137,119,18,0.2605890342736178,PASS
7478927E8DC000E7BF1F91852E21ECFC7FB3219C9A40F6466A670C8668971272,132,124,8,0.6170750774519738,PASS
CC25D66CFA3DE3AA14494FCD6A064D14E9C2441C3FAB91DBD9E961A53CB7DA0,128,128,0,1.0,PASS
40A51D96C5ACECF286CE114F6D4B20CDD316010A234BDDA4FB53741B13374AD,135,121,14,0.38157390570502125,PASS
4E01DBB665BE036D7E2FE1932C8E2246277E9E087E8B800AD85EBFE51F17E8C7,124,132,8,0.6170750774519738,PASS
A46DA7A1571D31A1C9F0009F24CFF05EF487ED2D35720FC4639B4EE503C40310,134,122,12,0.4532547047537365,PASS
169E673BD45D9A0A9DC5EC95AF9A1698AA9BB6E5D2CA0062517DF33C283B4786,126,130,4,0.8025873486341526,PASS
FD313560385B74DB0749C7871AF80C3A2FB2BD61DD70A25C500A7237D4F26A28,131,125,6,0.7076604666545525,PASS
265515AD3B31471AB3F74F349589C8E839B05BF0FEDF5460B9262AB0567987A6,126,130,4,0.8025873486341526,PASS
C84DE66556D380A640D9B5F17495479213229BEEEEF1652053E83192727432F5,132,124,8,0.6170750774519738,PASS
B8E8C808B328215DAC055FAD82A1143FBE014C575BAFE2B3CC4AAE21EA78F0CA,134,122,12,0.4532547047537365,PASS
E93844C314C405B38F62662D9FAC6465EBE41C15D268B0431B9E3460A207E5D4,139,117,22,0.16913144470267139,PASS
4B611966DF818E537FE30009D886526BD42558403BAFC5BBC207D88D60F8DCA1,135,121,14,0.38157390570502125,PASS
3FB540B71AAF1195585563EC2B8E9085E071D46890EB947A143761754EB59BB8,131,125,6,0.7076604666545525,PASS
ACFCDAF12A6F87B0537AFE77658A8DB90B28B8E95BFEF3137F944ED9E0E728A1,114,142,28,0.08011831372763423,PASS
864752758A36DDB6E02534108A19C9BA639C7E77484BAE5AB485C5567F5DFD6D,124,132,8,0.6170750774519738,PASS
A467954AB388C0B91327F769C607BAC49D8B714DCAB3BF54A13AB29F60642267,129,127,2,0.9005235503397743,PASS
53DF7AB0C7400BC71253B17E3776D216FA8C2A01BFAC2DBCE783CAB68C8372F3,123,133,10,0.5319710580974012,PASS
856FE55EB0F534FA5578FD8E43E2E4687499F6391071258C3EB1DD2ECC69FB7D,117,139,22,0.16913144470267139,PASS
B2ABB7E5FE1CE429A4A7CF78C7430CC80F67CBB8E8B327142F1405B2D5B16C8A,126,130,4,0.8025873486341526,PASS
191B409C1C328081ABBAEFEA0FF9655C90F2B32CC155A56182786385744DF64B,135,121,14,0.38157390570502125,PASS
8CF9AFDDBFD8FD5CEA829F551B3E71EDBB687A70C9F1420093DD8D913B5F716E,112,144,32,0.04550026389635853,PASS
3C349A0BBB28CFF6EB89A025B6A428B85989A9BC17EFB2791CE1DB12F3010B66,129,127,2,0.9005235503397743,PASS
EDC3FC4D532EAE68BC4EB98DB2B4F03D613BC09B6D98C425FAC4B8147029B9F5,124,132,8,0.6170750774519738,PASS
21CC833C8F5A11B40933CE2ABEEB8AB0A89876EDF93010F604B551D35AD4013F,135,121,14,0.38157390570502125,PASS
4B96EFBA1DFA734A8C091970DD770798F34EB461AC15C0FDAC0CF7F3028AD1C4,126,130,4,0.8025873486341526,PASS
B0CA1973A3AED13B85823A73496427A390A0F1048C5DC7E6DD5BDA9BEE09D281,132,124,8,0.6170750774519738,PASS
B01686C8F538C08EF650C78766A552C06273FFFCC89222AC0A6D18F40C821542,142,114,28,0.08011831372763423,PASS
3049EECA65881B20D988A3B7AB21775CB0D37A94B7F57ADF89081276E0A64BF1,129,127,2,0.9005235503397743,PASS
56047F754CB99D12150AAAE6DDBD835C5F354A392E12CC5A0F34DEADDC3EA3,128,128,0,1.0,PASS
D86A764D22938E61ECCDFD39E73D1CFB78B29CCB332840BF0D404A68FE896194,127,129,2,0.9005235503397743,PASS
8487B31EB815107B026C5FB85D5A0E6DE2420EF5034CD17CB2BC84054BEB8E46,136,120,16,0.31731050786291404,PASS
B2D64AEE45BF17ADDEB04BFB13010D3AB762CFDE7B39755338DF420F0A3C04F1,120,136,16,0.31731050786291404,PASS
A04F62672123D2D50641D226973181ECF237CB4065196D7C4209E9DF2085E948,141,115,26,0.10416255883043901,PASS
706A25BAFC60C60618DFA30E3D0BBFC7F78EE1E77786B9A2F39076DD1E9C180F,120,136,16,0.31731050786291404,PASS
CDBA34CD43AEFC39116310781FB30EC4E62958ACEA7C3163E9AC6C06066759DB,129,127,2,0.9005235503397743,PASS
48EFDEBD75662033C59D94F512765F005719F85E9AF99A820D1CE3F97A9EAA89,122,134,12,0.4532547047537365,PASS
60EE86095D21D63271B7DABAD2A1BFCF6603997EB8A152B25BA428FDBDB4B0C2,125,131,6,0.7076604666545525,PASS
649398CF054635A9270DADB7D81C46A11016F97986325FD2151B11D9E7707B5F,130,126,4,0.8025873486341526,PASS
1D7ADDB4168AF9B60257BDEF8550FA87F999CA464EEF69CA92CC35DE51ACC9F0,118,138,20,0.2112995473337106,PASS
F8D69FA50F576040126BEDE8131AE59D9E846D3D7713F65C0C53070AA4E0F985,129,127,2,0.9005235503397743,PASS
66E385332411E000401D31FA4029F50924D428727C03B961DEDCE6E8B23A2818,148,108,40,0.0124193306515523,PASS
BF822D6C3B9B9C16F158A72161DBF12A2FB343BBD00BBDE94FFA2E0CCF59F33C,117,139,22,0.16913144470267139,PASS
BB9EA9C2DEFBB54DC6BFFB83A25735950D57777FEE447E18908AFFBE8AEE5972,106,150,44,0.005959526470109114,FAIL
F12B8BF2A897DC5C30EC62F5190F6AB45A0FBF9FE4C7D70A814F2F3083B07964,124,132,8,0.6170750774519738,PASS
1F409F701FCEDAC1559E6DDB3F1E0F91214ADA64E38C8CB19590351CD874CB94,129,127,2,0.9005235503397743,PASS
2D2F56D9E4DB785BD34E3C0BFCD4CEAA105783A50164F1574BE533C0592A4B03,129,127,2,0.9005235503397743,PASS
4B62A38B692005F5401363746D87F475DB6E73D2113490A870240BB0ADF02907,141,115,26,0.10416255883043901,PASS
CD5C7D1F5004834C0B53794D485E448E17486CD287D3EC2809D855734EA47711,138,118,20,0.2112995473337106,PASS
A32A34CB97DBCEE7C6317959185141E54BF082D436E3D16577EDFD4E38E41162,125,131,6,0.7076604666545525,PASS
52BD74ED197D07281264A7FCD39DD7EFEF1C571683375973D12C2360FC485FE1,119,137,18,0.2605890342736178,PASS
2D2CAA653B0F5562273B6868B660D10C7DB7D62C4108D85933AA9E713329D0B5,134,122,12,0.4532547047537365,PASS
4A1A6F4C6BD2B88AFF514D33D563C5105B5EB2EAD05126605790C65B8D5A2792,131,125,6,0.7076604666545525,PASS
1368166F0BBECC35BC4955F1127B3986BB718D76F99B3D0F6393A8E13FA2E8EA,120,136,16,0.31731050786291404,PASS
F40F9D21653910E304ABE4665D32AE5BA6ADAC467636910699F84C556D096D6E,131,125,6,0.7076604666545525,PASS
BC4D2F0128F3F6A761BB5E8117BC345CBC43DE9D3705D8CD40ED3D90218A306E,129,127,2,0.9005235503397743,PASS
FED16A746C25BB0DA5E9AE9ABE0866D32180DD272BD1CC9D0F8A399C4FA3D4B9,124,132,8,0.6170750774519738,PASS
A049396D7A46D30ED7B05AB917CFAE9CC9D6196A2D4B54BB86756F65213520A7,126,130,4,0.8025873486341526,PASS
32D0826AEA8FE9EDE1F7DC7CDB1F552E536DB7C1A6CDBDEA2A8D51BFAC74B6DB,109,147,38,0.01754895019147673,PASS
E9716CF1FBDE5F3B4CCB4FE067CD79A524EEACCB5339C2E3B2BB29D3C7775512,111,145,34,0.03358661289689768,PASS
D628946507006C81EC99526751B9269E5F027184C85F4AF1FF2F598D9A955B01,135,121,14,0.38157390570502125,PASS
C5D25B2494F1F3FE9F436FE75C4B0C1168F1D173AE51457E2ACF48F2BA617DF7,116,140,24,0.13361440253771617,PASS
4A1623479ED4B58E13D9CAB78448B4B67A389CFCD9E2C5875FAD2EB9CF7E9096,121,135,14,0.38157390570502125,PASS
34591D89655EE51C14918301993D019AB6CE412D72F6C70EDD732C735EF1AAB9,130,126,4,0.8025873486341526,PASS
9BA966C17FAE13FFC0AB98B388AA9B82426D8399A00EC9DEA49CE503ED2227CC,130,126,4,0.8025873486341526,PASS
80AB60AE0774347678E683CE823BB31BE28C2CF7B6128B65C8E3D32B90333E95,131,125,6,0.7076604666545525,PASS
DC6E68370F88FC9BBE99D0938C20656D0DB4AC6C2E13DC6547B842A7B8B1E6F1,127,129,2,0.9005235503397743,PASS
5BF32C6562CB502B08885FB9A0D799438C5A7525938771B29948ACFA01EB8415,136,120,16,0.31731050786291404,PASS
8A40D9196F74663B92C020375BFA9C5135307ADE63580D828E80F091C6E7ECB7,134,122,12,0.4532547047537365,PASS
4C715C19DC60CBD2E3272DE68EDF7D2F48CC1AD186121379A53737E44D1A9FA,127,129,2,0.9005235503397743,PASS
1EC14CD94329F1A28E96516F88FAF585B1D017146F3710E872883B3EE1E08E39,133,123,10,0.5319710580974012,PASS
A3C80C6427DE5FA87239F153456F6E3E5E50056142FD22DB6B23704E16A92A3D,130,126,4,0.8025873486341526,PASS
144086F847D79EE7C6553F707A40585CFB6A5A485346E708BF5F0F0029FC4DED,127,129,2,0.9005235503397743,PASS
52EE2BE95BCF2CAD970C1E4C9509072980C55D1C3D8B57C05E81FE2BB6C3FEB4,126,130,4,0.8025873486341526,PASS
F2BDF0A11881E3CD09C6D904E51D90EE929E1098D87868D467BB18BDF15F321A,132,124,8,0.6170750774519738,PASS
41652EA5EB0354FF644B87B49222373A1CD4D96FA0965557CBAE209B0BA246C2,133,123,10,0.5319710580974012,PASS
629C3343C1548D5ED15DBE2410052522CB77D29F1E94021800971678A15EE76B,140,116,24,0.13361440253771617,PASS
C8B8E1A645C4CE8F5FFF800C4A0E7E4189D8B4EE2C5702543AB8386691503693,137,119,18,0.2605890342736178,PASS
6D18A01935F781E446C24E7397050812CDA4A75318992D04C2E814C0CEBA7186,146,110,36,0.024448945310089426,PASS
30F2810CE9EF4F43E84F0CF61CF306D78C1F55A605DE389FFED4C98620907CA8,129,127,2,0.9005235503397743,PASS
2EFE8725A9D129382E1941B95B29BE5AD6B2691C13F1CB8E450B38DE38E8569E,128,128,0,1.0,PASS
5DA86CDB27F8D58ADEFF159E12EF4E7286F7EF7B39DB7FD29923AEFEC8886D7A,104,152,48,0.0026997960632601987,FAIL
9E7589461ADC65FFA5B9BD488D205174C03C62B560BDD1E82A66D961CF1A7E13,128,128,0,1.0,PASS
41A6BE66E9B3DB7E0460B404A0BC2E166C5EE7774BCCEB506B20F8F3F2C51C9C,126,130,4,0.8025873486341526,PASS
E96B7B25C9A410DD0891810526788A7C74833D57E560313BED06C6B4722BB532,136,120,16,0.31731050786291404,PASS
6F97592FBE788598D37D4931D66E0C3E6E6C43FFC9DBC49F058C9FCB3C8AD073,116,140,24,0.13361440253771617,PASS
3A1EE53C320BBC31261FAAB1AAB817AACDF5CD518EA483D8D0316BCEBDCF4B9,126,130,4,0.8025873486341526,PASS
F265D2DCEDA1C74D1E354A16CE3416F2F9FB0E61D0BB088893E0E62718393E5,130,126,4,0.8025873486341526,PASS
51EF73C41B6681AFA773CADE290EB26114BAD2F3190FCA3932E50D9C008962BA,131,125,6,0.7076604666545525,PASS
35C33CFBE3CA9E9E2F9EEC489B524C87FEA87D85BDF73FBD03A3B2FAF98B6336,108,148,40,0.0124193306515523,PASS
80198BE0EBE21ED1735ABB9A826F54D663DC0B30749A2F355A6773D86621F33B,126,130,4,0.8025873486341526,PASS
33BEED01C78F856AE2BDBA118A1E041003D3D334E487F2C030CA39E45169A7D7,134,122,12,0.4532547047537365,PASS
8F7DB8DAF5A07DBBB71AA01B1414CC3C065EA7973CC7658BEE02A204C184F85C,130,126,4,0.8025873486341526,PASS
C2DD9787B004F1E49C53FA2AD967F0955D94B5CC016E219F0F1BF57A1EFD3648,123,133,10,0.5319710580974012,PASS
BEE4282A7F2DFB8CA1E639531B768B3A32E770C7D007FBEEF7D87EEEA2E6F3D4,110,146,36,0.024448945310089426,PASS
8239C3C334DF61BF97422BA4CFE12E148BF7B63ED3235A6509AE2915530E066,131,125,6,0.7076604666545525,PASS
3AC317E55B99A92B9737E2943278EBFA4B2E9B74CA7B3C8D584DE1E74AE496CE,118,138,20,0.2112995473337106,PASS
B791FF6293BF4454E252ABD3BAA4CFB8EC1DAE1FF14E9A7F31113E0ED6B0AE54,117,139,22,0.16913144470267139,PASS
7AF21FB008FCF586F46224390BD1B62D4EF8F84BB1B3BB46B19E9F5EF6CA82B2,120,136,16,0.31731050786291404,PASS
7A80A2DFD30C6F2A79A69FC16795381216A6A0766B2C29D68AFA2E7578140A31,133,123,10,0.5319710580974012,PASS
7246D41136740D3279AFA2BA222EBFF93FABFCE1A6E4C92759F079A353979DEB,117,139,22,0.16913144470267139,PASS
CFC50F41DBE5D8945A9ABF29712E8594FAD39219BB0982DD30445DBF3E4847D2,126,130,4,0.8025873486341526,PASS
2085773E048BDBE4632583D7D82061310064467D381547DB973038802B982242,149,107,42,0.008664896726025117,FAIL
F1474912F25621ACC3FA58B1AF396751B42A3F196FB66CCCB79D656D1A4F2AB0,123,133,10,0.5319710580974012,PASS
6699CE926DFBCD8C62E6041849697487460EA47C82908DE9F485D033E431CDF2,135,121,14,0.38157390570502125,PASS
C50C8B2847AC3E10D742D29EFD854566024089B5D37CE9A4DCF80EA44172C56F,136,120,16,0.31731050786291404,PASS
D2B8FB97776200F0AD434DCACAE0637977CC86474FB849E9B2867599A5D25514,127,129,2,0.9005235503397743,PASS
72F7718E4BBC8E7B9A061FF1BBDE1FB736295550F542ADCE631C5859D1DA9091,120,136,16,0.31731050786291404,PASS
78EDFA73D7F91CBC981E802B774CE29CDA6FF012305DB0FFE8D853E1644864C,125,131,6,0.7076604666545525,PASS
B955567037A9694BAAE289A55428F552905B940ED5FB15A0871092F0D6278F54,135,121,14,0.38157390570502125,PASS
4D920971A002C6E12A569F80BA309D3A6FFACAADA354013A44ACE1DE18223F96,139,117,22,0.16913144470267139,PASS
568C04642123E99DB66CC05E817D2C9E6A4EE85FC0F658ED1FD3C349AD4C79D1,129,127,2,0.9005235503397743,PASS
BE35C6B0DDE2A123DA6E0D7714C0245F4027DBD2BDC559FB9A52433957C19EB3,124,132,8,0.6170750774519738,PASS
B48A0FEC1A567BB9B5CF8A106B6AF8B2491235F538BEC3EF00DDC18DE78E254E,124,132,8,0.6170750774519738,PASS
37AEFE8A50106316DCCC94C2B66DCC3B20524E208D8B9A30A76832E38ADA4D1,140,116,24,0.13361440253771617,PASS
634A466C17A52D517BD78056BF36B1C75C008B839F21DB88C0D45D72ECE2B7F9,127,129,2,0.9005235503397743,PASS
D106CD224A55D84ECB1651A5675D5AADC17E4EF8D3AEE1F250AC50076F05B882,132,124,8,0.6170750774519738,PASS
1D1349321C35DCE3CD159BA4A3D47C3737AB466EE44C39F2497E112CF2B8A2A,130,126,4,0.8025873486341526,PASS
A916A8149A040B6A02BE4E3D46AFEC1B332C435DEA2ED4AC7C5614BA9C8C7084,138,118,20,0.2112995473337106,PASS
963AE12785ECDCA44D35B29452D651D3C15269377AAA7D7A7ED3A2D669DD23D9,121,135,14,0.38157390570502125,PASS
A590D51837A2F464EE76A8D26C2527139327FA82A96404AF4A0D9AC9FAE4AA10,136,120,16,0.31731050786291404,PASS
34BEBE61755E4E5AE332252F03DD691EA5563E646F33A74489252B52C585867A,127,129,2,0.9005235503397743,PASS
88D9C24B14C0365F8FEBD91CFE957D7EEE17A566BADC1578894E9749366138B5,121,135,14,0.38157390570502125,PASS
D91E8EB8B58C31DBB25124E9E380EC62FC972CDB3B78B5B9F8BE21FC667AAF29,118,138,20,0.2112995473337106,PASS
17FCC35A2A611678667AE311AF503B3A4CBE24FB233E10427320A092EC6D38B4,135,121,14,0.38157390570502125,PASS
DE909DAB5BC24B395E8746E1BC8C0D423186FC74811C2A762FAD4B8D80816D68,135,121,14,0.38157390570502125,PASS
FB5A1AE1DAB026C1BF82888EB63DD21E9351C84230967317A9F727E82F5132D4,130,126,4,0.8025873486341526,PASS
D7FFD78181629940B9C50376540688E68A1B3B4914A2E12519198932568891DB,142,114,28,0.08011831372763423,PASS
A3ED2959EF2FC5035C03D1D83DF5922D91F8F6F024AA64C6C8732DE10321DA95,129,127,2,0.9005235503397743,PASS
9460202558486FAC0F4928180520F626F35ABABEC72EC47B9C03397BD38CA031,141,115,26,0.10416255883043901,PASS
23220C5ED607F6C440F42BE1C1807C94738CF33C367CBCEC0F8F5658CC1944F1,134,122,12,0.4532547047537365,PASS
8F1EF504E3E91F8D6687C2FB616F06FD4C3EAC147C4D638176407037DA4B801,131,125,6,0.7076604666545525,PASS
48ED63DE2855C4735F7ED8B8B1695120051A00DD4DC0C9868A6B765AE86DBE84,134,122,12,0.4532547047537365,PASS
1F1B1BE47784E5097486C99232FBA2C40A09B6813D245AD66572B2E9FD9F2B02,132,124,8,0.6170750774519738,PASS
4159C2DBDC8FEDD7D4C87D681207F62477513EAA91F239E2C4587D10DEB0127A,127,129,2,0.9005235503397743,PASS
5D698DCD45F4C4DA4A3867A20D06489366586210BC4DC747EFAC7A197147AA0C,135,121,14,0.38157390570502125,PASS
DDBD9267DB3A320C514AF9F3E90ABB27E9A4AE19041D9C40C939584AD87D0800,135,121,14,0.38157390570502125,PASS
46F7907B49409579DB1C911146DB3E5704031FF08C01C01D053F97D1B3FC40B9,136,120,16,0.31731050786291404,PASS
1F62881A0016F8F87A1AF94DF85A5C59F04D1E957B8D8595594CFFD8B41C78B4,128,128,0,1.0,PASS
AAA51272CB9F41FBB9319B49C1A0D780780A182B48FA0B72318761BD8084DE16,139,117,22,0.16913144470267139,PASS
527DA9398AE41CD6D7D13893B6ECF01C3C7F89EC130BDC31BB2C46530D3D2B9B,124,132,8,0.6170750774519738,PASS
B757E0929E43ADC426715D0FA0F532812967D71A4ABDF30A5FBF5AC77ABF86F1,118,138,20,0.2112995473337106,PASS
F12667582F65CDBA13DB8299079311BE262FB2C03036D6FAC2402C19EFDADC24,131,125,6,0.7076604666545525,PASS
CE85DD72990BE7335F6188F1619A0AEC94126BA28828467C6F01D9A8B67E929,135,121,14,0.38157390570502125,PASS
B18F4E927D80335E5086800F61F465265AC4BF62F8B745BED0366A0F354FA045,133,123,10,0.5319710580974012,PASS
2D781EED795DB18DA0BE32E44CEC9B74B78CBC3F675A005E13D0D306817A8C44,129,127,2,0.9005235503397743,PASS
2B3FC23921B067A91C99FDDD79E582CCE3ABD08C0A4BEB07D0E74031A1167E6C,129,127,2,0.9005235503397743,PASS
8BA9575284C19712B23CD8E54E0ED45822E66E03DF3905D34F361010991CC499,140,116,24,0.13361440253771617,PASS
BF0B0342D95C8BF197B2ECF7CFA26F34360C7C5498D7524559DCD34D92D4E6D2,122,134,12,0.4532547047537365,PASS
76F854C249D65064AB4D49ECA217A9CEEDB6D33482E1D399047B0469B5D85604,134,122,12,0.4532547047537365,PASS
212CE63986C424C6F7A1395F4739603BF2C02A98101CD373F3D23F7688419A1,138,118,20,0.2112995473337106,PASS
D04F2F4A3690AB5C44BCD08C346E5939A3A69EF1C2D8620C84E5A6DC9A0FA8B3,134,122,12,0.4532547047537365,PASS
F2D897003F4B4F5247AE7D5250E1D0DED0C40A55A83987472D33BF572E1466F4,129,127,2,0.9005235503397743,PASS
B29F12245A8DA7A9ED9640CBC534A0183603DB9DB4AA0F5B067E16552B04597E,134,122,12,0.4532547047537365,PASS
8F5DF79E2F36DE3BE11F189EEC170DB8EDD2B6228E7245EF039D61388C77CF2E,115,141,26,0.10416255883043901,PASS
59D7D0797C63AA3AEABF71FDC3A29FAEE4859C95CBBB91C6D52CFD273D79DE3A,108,148,40,0.0124193306515523,PASS
2562D2C3331C9AF0B15CF0AB402636E3177FDC22AC3579E255E183C142F6568F,131,125,6,0.7076604666545525,PASS
B0A0F800A41BD470C4573F62C308633C8DA5F9A2407269B899B681DAE27DD149,139,117,22,0.16913144470267139,PASS
FEDEA272D1C99DDFC9BEF8E37B35E7E3A8C545AA511281DAF845BED8E387BDC8,113,143,30,0.060792723530522785,PASS
40A7902CFFB3E4FC62C7222DF7A1F0EBB8B861E9C10EA85D59E96B5C4C5420F,129,127,2,0.9005235503397743,PASS
2D03B77FFADBA9DEAB641A53027F2B725F531A621BB6F3F8C3E8B83008605C4A,124,132,8,0.6170750774519738,PASS
36820648F8780ACAB6957F8AD26F8B22D6D799FE5A965984E1336F23C86C5760,129,127,2,0.9005235503397743,PASS
27E0DE5523879DD69C8B0AC22645DD7989A214E2E662C95B42EE189D82FC5AEB,130,126,4,0.8025873486341526,PASS
9696FD123DE3FB274E1194FC75A6954C789C5683AD4C439FB7C1225821BA7E61,125,131,6,0.7076604666545525,PASS
2B4F296BEA0DD7D64A1B3ED40E9AE5809144369AE89E31E508DAE21951311549,136,120,16,0.31731050786291404,PASS
2C5E6AAE5A1C0DA7D85E30704984CCD5CD783C8E7FBBC03563EB0276ABE805FD,126,130,4,0.8025873486341526,PASS
DB012EA6FF1E9851AC23C6ECF06D9FAAFF84DE74C473852D2F65BDF82307563E,118,138,20,0.2112995473337106,PASS
3E18D67391BC4B948C8554E3DEC5FA8BE514C44665677377C74ECBFBC50EEBA8,120,136,16,0.31731050786291404,PASS
4E917AD9514F4731CC47A4AA18E0EB777CE760856C9BD6E9E970673927A71012,128,128,0,1.0,PASS
A5A14647E061289507A537A22F0674519EB956A5BAE81AFEE923E08FDE4B71,134,122,12,0.4532547047537365,PASS
53210045DC88E7AEF664534422C5871ED377B2AEA1E7BD7B20FFEF1BB116F145,124,132,8,0.6170750774519738,PASS
2A6FF880767DFAD9A05BC627455D14307C86F2FC46454B39278DD0D9E8410D42,132,124,8,0.6170750774519738,PASS
4E127829A7CC8F6466F9F68F81B99E2E4F0D872E7DF3402B601859578C0A8EC1,131,125,6,0.7076604666545525,PASS
F19A2D31284472E1AD77882F72B9EE9CD114CCDC35421E3769C5824F679BB873,127,129,2,0.9005235503397743,PASS
D2BC0623EECE1A336F3CB4DDF89097EB694EF0378EE80E2BB8D176A4A034F6A6,123,133,10,0.5319710580974012,PASS
ED639B686F1F25837F2C7C43ED03B1F0644B7C83DD570FC19CCF9DF7B7488346,118,138,20,0.2112995473337106,PASS
14E318CE4D3F4B4FE4640761572470F65E4CAB47CF88E1548E1DC946754A7A7F,127,129,2,0.9005235503397743,PASS
34198ADA99815B18129D11379C6666EC2A88755391795A8077D44CA0493FE544,140,116,24,0.13361440253771617,PASS
23D5854328A8DB5E014B3FCA33BC2D24BE03AA9CAA0AD09AFD6A2FB0B709BFD5,128,128,0,1.0,PASS
DCBF061647C21EE2D99C2EA241E593628E224D0598CDB079D8C7A391874AA66C,135,121,14,0.38157390570502125,PASS
8EC7B23E3A074D66505620C3B0B011125F601E5149A8D0C9AE0511E75CE15801,147,109,38,0.01754895019147673,PASS
6B8AB5D56FB5F5701F9DEAB982B75206751701361C4AD65D97EB2BEDAF1C20C2,121,135,14,0.38157390570502125,PASS
765553B95BC6E2BF6C93D3E07D7C02A370F23275099101B79E8EC225D1CC5276,127,129,2,0.9005235503397743,PASS
D883A918D473CD6A3967EC9D96A9D0A06DE1640ABE63F9BCE123220C11A7480A,136,120,16,0.31731050786291404,PASS
A7D9E1D830DEAF8A8B08F4351B9938F903F6EA8BDC52D91E645280A10C77AC08,133,123,10,0.5319710580974012,PASS
E660C2569867B1B0F8EC88D9B8C4F0520DDA189FF75AB30080E5DDABCEB228F7,129,127,2,0.9005235503397743,PASS
6288573C508C13C29D43A2AD2D9CE74AE5580C417C708AC954C5E7045B3AB514,141,115,26,0.10416255883043901,PASS
2AA1891600A2F1C4A66C2384C52C4A67E13BD4C0B8B3DD13C486D75894D17597,140,116,24,0.13361440253771617,PASS
1EEA7127293397299F1D80AA44C398B63E9EC44E2D95C94BC292DE4BD729382B,130,126,4,0.8025873486341526,PASS
5653830A73E04C36527D8F7FDE4224369AC63075C7D1F446B4CEA6C56B9499DE,126,130,4,0.8025873486341526,PASS
F22DEF9F5911093558EE48BFF9D2DB78E4934F8AB9251828D33658723171CD13,125,131,6,0.7076604666545525,PASS
A7D63C84F7CD3F7207A8469935F1459019C3C8ECD520F998F177890136BEF74,128,128,0,1.0,PASS
193F748FF3127DD60EB9A7C67655DB48156B156B7E459FFC0F856DCE2D230508,121,135,14,0.38157390570502125,PASS
569766C3E5A8BF9E83B0C5283C4CA2A4B8428E4332EDAE9DEC15212A9D5D6D5D,129,127,2,0.9005235503397743,PASS
975D8247A538D267A2FE3CA087FE87D00BE6F389EE7C772D95A8AAD589D83507,122,134,12,0.4532547047537365,PASS
5668C94003A8EBC6C8BAF5FC868A9306C9BEE14366BF16E919ADAEC891E4B137,129,127,2,0.9005235503397743,PASS
A228D8443B7FF357A84AEBC00A7DBD74D48B33CA1A7453A632BA4FF78E2003CF,126,130,4,0.8025873486341526,PASS
A9BCE2FEF63B905A72430B92D33D804D931AC45389EC4E4DE88CC343F685F44,132,124,8,0.6170750774519738,PASS
85F3181E9CE34CA7BBD85444F6AD9435151B7596CFA0A4A31EFC1E93D6154191,129,127,2,0.9005235503397743,PASS
669882A431EFA9A3E490BF1FC675F98D10283D6BF22F40695FDB4201D8129CF7,129,127,2,0.9005235503397743,PASS
3AC64F78D7F031909BF983621FF2AF226F6D988344374C4F7AE9655161052499,129,127,2,0.9005235503397743,PASS
E4E3A8B1CF9679EC2ADA0CF8F2757DDDF1A5EEFCBC7B8A36524FB5A9B2C76E3,111,145,34,0.03358661289689768,PASS
39CB8CA5956F3A10624C3B36C1EFF47574A7F15CB64CD35BB23F4772719F4B21,120,136,16,0.31731050786291404,PASS
DFBF564D86A9D3C4ADD63E4F957BEF2A2F6BE06C776544AAED9B2AFE674EE0BE,107,149,42,0.008664896726025117,FAIL
FE1852C0C826BFD6A167163CA653FC3360D1B161C3A3DFAB34B2D63B21A08671,130,126,4,0.8025873486341526,PASS
450FE6B93881E26CD07819F0D4B7D45C056FA2DEFDD6836BBD5F78312974BAE2,122,134,12,0.4532547047537365,PASS
F80F9D14CCCAE34B92206C3EECBD29D82D90A9BBB6E9A4C1DC197404F4C0B82E,132,124,8,0.6170750774519738,PASS
FD8AF961554BDA270371F0631585B289DD614D9FE819D43FBDAABB84A740CF7C,122,134,12,0.4532547047537365,PASS
64AB2CA5370B749042DBF85C084284A166D23F8318816F93568DAD636C6F0019,141,115,26,0.10416255883043901,PASS
84721717846B19AAF80BF902848678F9EF8037CD3ABCBF50FD1509A66E40D9E1,131,125,6,0.7076604666545525,PASS
966943EBCC59C9D7C9ECBAFCDBFAFE4A038C921EDCFC2CCD6AAED7D522488D8F,115,141,26,0.10416255883043901,PASS
4431FDCE5E5D029973258B106DA5D42AFEB94A8603935C1197E1412E8106B614,139,117,22,0.16913144470267139,PASS
40900AA2D967FBBDA0A5998C161788F43CD7D77B0AFD6A4282300375044417A1,140,116,24,0.13361440253771617,PASS
BEE01A508E1BD3A14CB94823773A71813D41030CBC1360698F0BB9FED1A8E59C,136,120,16,0.31731050786291404,PASS
2FB7F7880CA293A80A6B39DDA2271FF47975E16EED893E4AC7768D532AFFFA6A,115,141,26,0.10416255883043901,PASS
CE228C1E4F889439D5157FF5EC6AB7790A7E428F72FC755536B1708F1DCE3C79,119,137,18,0.2605890342736178,PASS
83CA72C8F8474E6B32FE1A62F102168E6220392F3F27311F42F5033E32144A4B,137,119,18,0.2605890342736178,PASS
8DA004FBE24A480F9981820E02F947C5F5844BE1FB72BBC25E773DC8DB0FDB21,130,126,4,0.8025873486341526,PASS
480A405D0E13254ECD307ADCE6BDF1D349E895FBF330E1ED1F0CE944353B9C44,130,126,4,0.8025873486341526,PASS
ACC6B80822ECCD91DBDBA7006CA06075FD6692EE105F64FE11483EB3FBD4C28F,128,128,0,1.0,PASS
1FF6B9F7D12B1EB48924F121684572DA233296B6A1D5E142A05CDD6353376FB2,126,130,4,0.8025873486341526,PASS
265D5DBC71369E5328CC637BF94D7DA11BC33C51F016D80E384251CCA0B881C7,132,124,8,0.6170750774519738,PASS
5982B23471C94942DBF15B2EF320A373538D1D9E5BADEF540E89AC930DDFA048,129,127,2,0.9005235503397743,PASS
281B35DD8617FB9E694435C5ED0B2B4EA40435A083A2DD24FDCA60D6B2D150D3,133,123,10,0.5319710580974012,PASS
89555EEE0F8FF5A9183F393229ABFD4A0093DEDD25DAD3A90A1DAB3FA4D13502,124,132,8,0.6170750774519738,PASS
F5C2DA64F8FE01FC77B1E1A6AC561DB8FCB44E2B54ED616B94D96C7B98E2141,123,133,10,0.5319710580974012,PASS
56A7DDE02EF45A7C17580BFC3561D3EC531FC2047426F166C49E7E3D06C8C27E,125,131,6,0.7076604666545525,PASS
5F2D1B3D53C071F14093127D0C5A3E17708A6490E797FFEDF4B4BBC5CC186B4B,124,132,8,0.6170750774519738,PASS
55AA4476B8FFF2C7FF98EBDA852E5F6B15BF1D2EA9F1D1D21A3FCC30000CC415,121,135,14,0.38157390570502125,PASS
C37BAAADB833245BED1743E72002D23BE5FE0850AF5DA7AC5CED98728411D5C4,128,128,0,1.0,PASS
4E6120015F79681EC53D1276D5ED0C02A25C2DF56C4EE811438F363F248FCFB2,133,123,10,0.5319710580974012,PASS
CAF548B114F075B9E31B7B773713F2611AA8EED8257C94DA6B45952463544074,129,127,2,0.9005235503397743,PASS
19B78E513DA35A41FF86D31036DF4ACEEB2699C807CEADD7753BA2BD8B22D498,122,134,12,0.4532547047537365,PASS
81EF431541FBB0BC12853CD3C8DF33AC25805BCD458E68F1C82B7E500B6C5FB2,131,125,6,0.7076604666545525,PASS
EEE4800DF4069A7A698621F11878AAFBAC28DB5AE8BDEA39F769D4A45075BA31,127,129,2,0.9005235503397743,PASS
88AFABF202BFE3C3EF56A33AB2638BBAEB9B4BBB067061E4802A86D6B27D4D1,125,131,6,0.7076604666545525,PASS
54AD7E8C3B5A3DDCDEEAAADB10D3530A29C7E480FA32A7AF23DC291AA1B7B973,121,135,14,0.38157390570502125,PASS
C8B79EA23B4374808DEB880BB20E19D421BE6EF5A12DD4401E5BE7CE628A4237,133,123,10,0.5319710580974012,PASS
11BB290830DAFBC34E1764B1CE9C61C60A2C4879A6B1F346DC86DB2F48ED1624,134,122,12,0.4532547047537365,PASS
9E59344E8387C8A0459B0D64BBD5DE5A55AA163678D3840DB13B9ED4ADC168EA,130,126,4,0.8025873486341526,PASS
2CE9529664ED13FBB505C69E6D375F6EC8ACD285C97C93C4E198F7880D47A925,125,131,6,0.7076604666545525,PASS
97857D664AB999051F9640B1FFFDA6C8CCCDBC7FE471F2E505F81B8F7BE11095,118,138,20,0.2112995473337106,PASS
71369D7341821D5FA56DEF9FDE211771432C04733CBD9AEE38E40C068189EA51,130,126,4,0.8025873486341526,PASS
9667E5B8EFBE57928BF19E84A362FB12797FE2D07921CF7332C6F02753EB5F32,114,142,28,0.08011831372763423,PASS
D2CAF42C20E5837208E17A6B1E29777F79AD9F3C9A20884FA28D9D2742B39935,129,127,2,0.9005235503397743,PASS
51B35B312B8EE24285A3958B1283C5C921CEADFDC1DFF154902CE1BCE642FF97,127,129,2,0.9005235503397743,PASS
3D04C27A5313D5A3EA6157FBE27EC065A1D6E11781A669545CD80AE86723EADD,128,128,0,1.0,PASS
C4C8003C0C47AF6FF404C7946C00A6D1FFBE506C977C47BA862DF2D47AECED7C,126,130,4,0.8025873486341526,PASS
38F550E1CBDEC2F73C5441BA23AA4A157DCE226AD78999B6A76CD0792B5AE593,124,132,8,0.6170750774519738,PASS
82AEFA8338ADF38F6CC942F8B77709F32E379FA6C3F2601BF4CC1B554BB9CFFE,113,143,30,0.060792723530522785,PASS
41D2D5E03C48CC3E1DB91ABC2BE4939D22D29D39A925C043DA2095C8DDAB08CD,136,120,16,0.31731050786291404,PASS
2EEA56EA14018B93FFDBB2C16972B14E9998F5B1946C4BFC9528C6585485AB7B,126,130,4,0.8025873486341526,PASS
1C5BC0BAE4D7282056B15AF5FF16535B50121B2D4304D1104BF401B4BEE04AFE,136,120,16,0.31731050786291404,PASS
1E132F0F83569918D4A98C8234066F2F7C05B1EFCAAB798AA4A3A57E23C8F38E,130,126,4,0.8025873486341526,PASS
14B1A0B5C023BD57EE4C384D000C1BFE6B960976A13F0E55298AEDE44DB17D5C,132,124,8,0.6170750774519738,PASS
1794324F6C5AB805B5CA9F2D73FB76D1FBFD70F51843274A3A18F5B4FC9CB26A,118,138,20,0.2112995473337106,PASS
756ECC7BE01BA6ED85C0582F9CD5710C3936D191A79B979A9C60401A0CF16FC4,131,125,6,0.7076604666545525,PASS
186007D792822E8F28799D378B76D6170447C4ECB62AE6198000FE9093426468,143,113,30,0.060792723530522785,PASS
DB121BAB1600F5F9A0753A280C911EAA7CA6D5AD6D90CAB60FF6FF7C48E5F36E,122,134,12,0.4532547047537365,PASS
E66F5831DA854CBE9907E9F28BF9A42774F30F94A4C0E66E1471A95EDB0C52A8,127,129,2,0.9005235503397743,PASS
D70171394D5754291600AF1AB721FEA1E129E3D33676683AC3EFEE7FE4D5B0A,125,131,6,0.7076604666545525,PASS
5CE3ACAC91BA9AAD638E989B41F13377C8C00AFB724AA5ADC0F1BAA34CF10222,132,124,8,0.6170750774519738,PASS
747E6CCF026031B85CE3ABC36481BDA65C16964FAE1B85AB4A17CB4E3A30F4B1,129,127,2,0.9005235503397743,PASS
C22DBA4EDF51E455459E0BF9B9CFE94F46A26E5F425781FA94EE7739C20B414D,121,135,14,0.38157390570502125,PASS
F336C0F80CD95ADE62261D5AD6F199FD24784C54D4B9F891DD9157E6ED2C8D19,123,133,10,0.5319710580974012,PASS
F2EBE41B191886C89ABCDA8F6D36C420DAD74964E35D1E9B7EA53FE3C867272C,122,134,12,0.4532547047537365,PASS
B30774981392EEEF499B09D87D973C986BDC56E73F496FB78BAF68DE37EF3451,112,144,32,0.04550026389635853,PASS
AE8060D96AAE2FE4BFAC1FCAD7DA62EF8085EE3D54328AD4CBC6BE9EB108676,124,132,8,0.6170750774519738,PASS
16F898B727AE336B113D798686E1FC8919C1F4EE993004A43CACAFA31A1D0AE4,132,124,8,0.6170750774519738,PASS
10EDE8DB11315BCD98C7290DC3A4AFA03CEAD45C7E6C1951F28D434655E8F1BE,128,128,0,1.0,PASS
89A44898A032997037BBB0C0FA20C67639FFCAD7CAFBD075B9E2BEF87E915457,123,133,10,0.5319710580974012,PASS
147AC39F0B882196A51696F7521676AA18F7FBFB6CF2F64CB78E15AE07E1363C,121,135,14,0.38157390570502125,PASS
4345DF0309A33EE76B78F11603E1AC5D7D63C407B5EB0E5E452026CAC87E16FA,128,128,0,1.0,PASS
3AF73BB0FED7A7A88E4B754018C7CF0B19B6CC9E5E13BEEB748B02E67BC781B9,117,139,22,0.16913144470267139,PASS
4FADBB80492A3C4688680C2CEC8455B10B2E57A056124A3696A31783486C04E3,147,109,38,0.01754895019147673,PASS
D426627BFDC1B481441B4C3488DF433ED45735DF64DB2E8D6C6B3B92F2592BC,126,130,4,0.8025873486341526,PASS
970C7FFFAFB19A7A8E1599B3EB23772AEAB77B7ACF4A40B0B36B24FD6DA9ADEB,107,149,42,0.008664896726025117,FAIL
26DCE8407607F0F8AC2062C2861845732DF0BFFF5AC4654F1206E59C915A6E14,136,120,16,0.31731050786291404,PASS
B5DD6959BE3AF5750EF9A7A312D9C0AA73A2A2430BBF21B801C5E38BB3267E65,123,133,10,0.5319710580974012,PASS
10D4D8BD2D31B014DD0A2F48DA3BD6877771A87DA17D63C25E9EF19131177DA2,126,130,4,0.8025873486341526,PASS
5F819D1A3F551674987AF8FB118740682E5B988E082E46C3A8C68C85FD10CA2F,135,121,14,0.38157390570502125,PASS
265118FD150C0D1349F595FE806A29AA08E89B2C5BB6D97FD4A06F7C0C64A1DE,132,124,8,0.6170750774519738,PASS
278BE9E6A20BC8F3C30A2C78C71C88B4E459DEAEEF29AC1A3AFCB11276FF9D10,125,131,6,0.7076604666545525,PASS
DEDD06C9DD0C962C6F012D9F2B31F63F1CDDE1A0A92CF8C6AC04E84165FD2641,129,127,2,0.9005235503397743,PASS
6A945400F20AB937BE8833BAAE9891E6FB315E500B74F369D4E87F8FBC90FB10,127,129,2,0.9005235503397743,PASS
9E30B3163307E3867F964784D8F30491E71D289F8C75CC496DD1158AA53C3E4C,131,125,6,0.7076604666545525,PASS
3B1C2BED551F2FA5926F605BB9F4809339FCA471AEE1B93A9D7803B7FAC24846,123,133,10,0.5319710580974012,PASS
CF30F0801F8D07680E9ADB7D3D094D870DABBBB6EBFE5E4A1CF451420BA70209,130,126,4,0.8025873486341526,PASS
BABC04F31BF7B647401D8CFA8321BC36CF5DD4EAB10C098C03B233C911347AB,133,123,10,0.5319710580974012,PASS
79355C53E119F117AE682C259325DDCA5971F17CA69904A4C2E9814B89DC98C6,133,123,10,0.5319710580974012,PASS
E093944E464B8B9DE73994E62003C0C135A140BFD135E2EBD56E2D44AB5B7861,134,122,12,0.4532547047537365,PASS
1FE74FC37AFE388A767734671C358A4D0F81B99E893639EF81914CDC2F6A3FD1,119,137,18,0.2605890342736178,PASS
FB9899D9725A9A72C0353C7A0BC1CB7EE6576FA12D7C22312539AFF088997236,125,131,6,0.7076604666545525,PASS
F9F17E8BA152AAEA86A6E2B075A826154B07C94D91A39F92CEF29BFF43A82AB6,124,132,8,0.6170750774519738,PASS
20BB6850E7CE198702FBFCA85B226D9694797B667ABC3920488F95B4BF1C0836,130,126,4,0.8025873486341526,PASS
FB9E4F17865644C3E9AC22E86CCD48C823DFEFEDAF54422AB9EC65D23652AF6,123,133,10,0.5319710580974012,PASS
E7B326071F11216D47DF738FA5717A437DCD4F44B5992F52075C33DC09C46A5A,124,132,8,0.6170750774519738,PASS
F8A6C47D6C8A77D0BED41A25E79ADF1B4335127FC2E2B640DC6106D1B0972FF7,122,134,12,0.4532547047537365,PASS
5B53120D6C1335941C1F8F57551D7AEBFD55417D71E31639DBDDC8323A9F42CF,120,136,16,0.31731050786291404,PASS
91C41B4AA831F42DDDD1B49A5D6723D77F3D3747165F65CD9F9C4B35D068E4D1,120,136,16,0.31731050786291404,PASS
367B61850E880B17430AC77CFB2CF7644C0610CBD7BE0B56F25FE7298CF44D48,129,127,2,0.9005235503397743,PASS
883FD0291C493B0E2A434BDE9C4F7ADEAA80F0DEF498A18F9FCDD5B0428256F1,129,127,2,0.9005235503397743,PASS
F2BFD055786D2D589C8D479D202DD5F7F690934CA73B47554ADFF05047DE5B72,119,137,18,0.2605890342736178,PASS
130025239B2B6DB01D4903785154F1A23C927A46DEAEB8EF5EB1FB858D00C919,136,120,16,0.31731050786291404,PASS
9434C454F787854EB979DCB273D06B50375456FDE888C46C081A8647DA5869A,135,121,14,0.38157390570502125,PASS
67EC2569DF324355F64AB6285EBA19914FA3DB287D1E8CE6012FCD7E6453FD28,122,134,12,0.4532547047537365,PASS
B32D8BFA82CCB49E8304CF7E1D5DB626848A18CCEDEA7CF948FAF467236022C0,129,127,2,0.9005235503397743,PASS
E1B9C6209A47B2D00F98EC48322D11FA9D639E9E0E05384AF438D69E07386011,140,116,24,0.13361440253771617,PASS
D1190CC4081A3881359CE213694BB30769E29C21D1FEDECDEDF70DD9793A191B,131,125,6,0.7076604666545525,PASS
E56E7E0827ADC8C6FC4423F773D0EA75D1E639EF8AEE1EFF2B15FBA46D84849C,116,140,24,0.13361440253771617,PASS
575BC4E47115B6F3ABA617B14F3AA6C1F0C7913C0A654354380E3F6B804B1453,132,124,8,0.6170750774519738,PASS
49C10C251BAEFC2B3B51BBF0B870A265DA4C2F34182117CA5639349CB3D0BD64,134,122,12,0.4532547047537365,PASS
38FD0F7C6861B106F637C14FFED460B68E3ED2C7AC294814550018D8931933D9,133,123,10,0.5319710580974012,PASS
D0FF8D4873A849CC7A24B88880C3692EA360D52D94CBDAB999DDDC0769FF3ED3,125,131,6,0.7076604666545525,PASS
2B9138B2FA0B1A3D901F8086DBB9E1F317B983E6D524B74154799EFA261950E9,129,127,2,0.9005235503397743,PASS
6D01D957DF6B82BDCD58B5BABD3238FD66350F0DFFC546A7A36CFB1DE398742D,113,143,30,0.060792723530522785,PASS
AC10F3569B66BE7AE82871ABBED3330AEAEE54C287BB312422478E80C0AC673B,130,126,4,0.8025873486341526,PASS
D704D925CBD675378BBF6743A058A2FCD394EB4393E10814D9DBF7A3AED29E74,120,136,16,0.31731050786291404,PASS
8CD810FE2F32396A18AE5703755E90B5A7B5C15BC37CA1A1D97D4B0C4AA67AF2,127,129,2,0.9005235503397743,PASS
938B00B6F50D0A6588EBC9D842D319EDAB583B9553819BE7271EA1A15F2801F,135,121,14,0.38157390570502125,PASS
FE2C0BAD2444D16CC5AA9FBC724E842F51EA82DEB57BAD0DD003520A7F22896F,129,127,2,0.9005235503397743,PASS
351F90C98A2907F13C4F02C793C5828779DDE69E16D0452A1CD8D4F10233194B,137,119,18,0.2605890342736178,PASS
40B99159724E74C672945FBE962AD687C65934D78A31372F322D87BD506E1F15,127,129,2,0.9005235503397743,PASS
EDD358BCCFF43F327C0983CEBEA4722DEC8946E0C665D1A48610135FE24A84CF,128,128,0,1.0,PASS
6E40733E8BC624289E89C605D08D655E895A25FFBD35E99B92361AFB733D5B3,126,130,4,0.8025873486341526,PASS
8D498CBD505E1AF28A5CB2DA209C3588D68058DAB399D814FBF7CD7A7C5AED85,127,129,2,0.9005235503397743,PASS
606B41B79AF2159B7CB6EC36E081BD8693B597751BB29F476946853D32B2F4C8,124,132,8,0.6170750774519738,PASS
6DC19BA246D685E47F9F7A3F0D7A21AB9313321C604F60E376C73EBEDD8D9248,123,133,10,0.5319710580974012,PASS
7E93B9095D262B7385C053CC94A759281464A3C169FF6276B741ABCE19C7AF04,130,126,4,0.8025873486341526,PASS
CB824D468688B08B0C16ECB239807BBD09CE4B25744A5043B2A3E686162807E6,144,112,32,0.04550026389635853,PASS
CCA269BF1A5092FE46B92081D77EEF7A7AF265B3348D7D8D44166EDFCF72D483,118,138,20,0.2112995473337106,PASS
B6A6191FEC5D3D1979539E00F65419C4592B5ECAEDD62F0922A40FED9EFEB274,122,134,12,0.4532547047537365,PASS
CB8CB6030BE8533CFF4351A621F3A586F97C16B6AB73F36A2B2A969E6101FC27,124,132,8,0.6170750774519738,PASS
2DEE30A6109CE0EAF017722B85D6DEA7610D1B5D7B4D2DAA7C20088B67258CB3,132,124,8,0.6170750774519738,PASS
C30A46B536CAB549175CEC9FC41DB946A474173CE45721B52719A86139E5455E,131,125,6,0.7076604666545525,PASS
F4115CF903C111D0F00CD3B76125B916E01DB67F5C5F14D0378A4ECD88B2181E,135,121,14,0.38157390570502125,PASS
48F81E879FAFAA0A2F9DCCCF24CE02C665A1489B536FB8E23F505C2079E02688,133,123,10,0.5319710580974012,PASS
789E56AADD842E5EF426705C0EC46C0208AE56C68E75AE81B5C3D0CA564D74BF,131,125,6,0.7076604666545525,PASS
83AA41B330B4A56E78133DD64B9CD9299E614863E411B2642F89977E6C1B7128,134,122,12,0.4532547047537365,PASS
2ACAB0605CB43380FC81F24305D44FEB3916F930FAFC34559F90F263268E696,134,122,12,0.4532547047537365,PASS
279898E93052FAC52CC1C75A3784E61308DEF0FFBFD3B9FB3519E99632D93B87,120,136,16,0.31731050786291404,PASS
3C8069D4E80AD746F5F7FD699C0841A1325891BC357EB857BD3C9932023A7803,133,123,10,0.5319710580974012,PASS
50C8E2AAD6A20B58EF3C5E464EA17467E99683E335BE4DCC9BD1B6202AC2FC51,129,127,2,0.9005235503397743,PASS
D875FFE136421D73F472458EBB97165470602B6B4B44960F032FAB23BCD17120,130,126,4,0.8025873486341526,PASS
C5D0E2D795C0E4D31B914B61AD240E9D5CB4D075253A58FCE77E9762EC4CD2C6,127,129,2,0.9005235503397743,PASS
243824570EA162DC54C7F608548311101CBF9E64A97CF971299E907E31F42A47,138,118,20,0.2112995473337106,PASS
35158016F5E455CD3CB2E752C8E421F1BE424D3610A8483FEE80FFE8911C9987,134,122,12,0.4532547047537365,PASS
BB93401F62BA52C6B72CD84CD9392EA7C290CAA36F653B9278AD5F8EF47D9CC0,124,132,8,0.6170750774519738,PASS
2C464180B181338ED712E237860FC15B43E9FD20C6DC53E2B6FB31643C8D7BE1,132,124,8,0.6170750774519738,PASS
5082E477F9B2AD74E8B2222DC1BB5A38724B7B2C58A51EBFD278AAFF3DE4B5E0,121,135,14,0.38157390570502125,PASS
AF7B9F4B05E0BA0CEF507B86C0350A18B9F9F59A1125F2A1BE7FFDA1C2C6E35,123,133,10,0.5319710580974012,PASS
C73B6FBFF5BEC872CE6CEDB0F61881EDD70974D19D14AF8F9CB7DB9E7A7BEC4F,104,152,48,0.0026997960632601987,FAIL
1D699B4EA34325D55436E53CC42B850D2CBE3941DBFB6022A8217FA685FDF245,129,127,2,0.9005235503397743,PASS
A55059349DECC1F1957C35E188116513DA4CCF23BB0EAC658D6BF99F4B28A9C6,128,128,0,1.0,PASS
58D4F9638B2E0A9B11F66776030B8B70366A4C4A554890454DFBB86381392395,137,119,18,0.2605890342736178,PASS
4628DE014FFE3E540EFD7CC87F901B59FF5A3AFE5121ECFE155368177D5412CB,119,137,18,0.2605890342736178,PASS
D33979FBBBCEFBB226EC5DCCFDDADF422D0C2CB26C4ED881A0F13EBB4DA4C5DD,113,143,30,0.060792723530522785,PASS
F0A20C3F7E848C6C85E3F6D30287E361D27F922CD16B29339BE51A60DC31AB77,127,129,2,0.9005235503397743,PASS
340F5213F20DA456FCC284871B4655EE40D07D084BC6506E71CF3175D624BF50,136,120,16,0.31731050786291404,PASS
C6DA1F9099AC8A7EB674540F3CC6354FA84FB26A14F888C85867532032041AA3,138,118,20,0.2112995473337106,PASS
30B92D25110977BB23E8A5C31A96F70B37A2A299B549CFCCC337B6C14D38C9C7,128,128,0,1.0,PASS
D5BA53E22511625DDA2586FCAADE61F7D4549454FEB4C090E16CD950ADAB502F,128,128,0,1.0,PASS
6397781D52464FA9B8489F4BF58156A9F4A13FF08FBC6A7D6ABB0C5EC4B3055D,122,134,12,0.4532547047537365,PASS
F92B0BA7C8682B6E672F1180FFD241F2038154596BD96AEFC66AC817DC3D4A30,129,127,2,0.9005235503397743,PASS
6C4D1561C708ADF8BC9688D211C493F6E2F47236BFD4BA2C0D3EBB1805DC7E40,130,126,4,0.8025873486341526,PASS
90BCEA4748359463EB449EB1B07E042C0CF5569C3C2BB9E966A38E11802B9D23,136,120,16,0.31731050786291404,PASS
24D2F3F4501F5C074B37F1EEBBF6580DE28293CC5099EF713F565FC77647B85C,118,138,20,0.2112995473337106,PASS
D2AF7F332B4E7B631A2633D5F2EDB28EDCC908C553022D810B39C82A6D82E066,131,125,6,0.7076604666545525,PASS
8BD94C64F5CB2C40C6601AA494BA8D0A108B665090E49D38A8791A84432FD439,146,110,36,0.024448945310089426,PASS
98EE739CCF79368C75F2E67850F26ADC28FD57C224BD9FEF3817A47E33B4C839,116,140,24,0.13361440253771617,PASS
96B82F8BB7A75282AC0C5C8A9D537A63944216CB2CEF52F13325A10EBE82A7C,133,123,10,0.5319710580974012,PASS
5DD0510B3138F65E0657A2814CFA5DDC50B0452D13E371BDB64999A96BF8BE69,128,128,0,1.0,PASS
9FFEE095829D632CF8D7BE27ED6969CAA7DCC38445AAA8E93ED87709679AD6A9,117,139,22,0.16913144470267139,PASS
8DD03D6E54B6A1051971C220EFDE8DF1B917E2DA34E68D0D32C04FB5242E1BA8,132,124,8,0.6170750774519738,PASS
60C3C87096A0EEB5118E28D75F6F68669EF9F8530182BCFE4494829333AF7E89,129,127,2,0.9005235503397743,PASS
EF56F0F62071919153A980BC49685968C45C906D9EAB55C9958E47F4F3F15A1B,129,127,2,0.9005235503397743,PASS
6D75BD32965BB1804B11C4F1C630499D4ABC783300A5D62D979E9AA93559D740,133,123,10,0.5319710580974012,PASS
31ED96CEBA173AD950642AA2185BAE17B344AB53821CEBB00FC3A42A8B8683B5,134,122,12,0.4532547047537365,PASS
43B62DE67E799C8ADCA5C4704EAC081941554F6C08B36F0541B16EACE936BFF8,129,127,2,0.9005235503397743,PASS
3603E7A50159AD6DBDFEA3B4D85BBF54CCC7E60C6322253079EC8C158A2EED6F,123,133,10,0.5319710580974012,PASS
7F41CB369B981513BBCCD1777DBD5C26A8B45D48D53AF7D052D636EF5822A2AE,120,136,16,0.31731050786291404,PASS
9739F9EB72F89C44459BDCE8381F091BF62306294E61D27292A60D703DF0E23E,129,127,2,0.9005235503397743,PASS
606DB958156936EDFD4533213F075ADC9CEF05613B291A164AA1C54EC3EC4F15,129,127,2,0.9005235503397743,PASS
58B2F4DFDB237AF182B3B00CA4ED62708FD46B31479384F8EE0EE9C7354EB882,126,130,4,0.8025873486341526,PASS
909EFA69C831B1D236C8C95D15B9BE5FAEC64A625C5352D33C7DB289B2C22F94,126,130,4,0.8025873486341526,PASS
C39D7AD8F922C770970A65D12735E3377EBDB410A642A8D722C26A570FF99ED9,123,133,10,0.5319710580974012,PASS
BFAFBBBB1CBF3C553A12D04491B0873A6CED179B7D591CA80696642AF5EEB61B,120,136,16,0.31731050786291404,PASS
E735A14461BC91B07A6F50268FCB272400697298A2EF2948545349B742D85A40,142,114,28,0.08011831372763423,PASS
DE4ED490B51FFAFFD5662BE08C8A201FF72E5E52DFDD4CE47ED03C96BB9FB01D,113,143,30,0.060792723530522785,PASS
9F6183039330837440791312725FFB17218DB26F4C8B52955DAE367E5B5F11E2,130,126,4,0.8025873486341526,PASS
D30B6330FB9E4521EA6C917625D84E4946C58F48C36777324FFC64157630865C,131,125,6,0.7076604666545525,PASS
18156175416CD33B068F16FC534803E07E1B49F3C093FFC51B4B5AF097192EDA,130,126,4,0.8025873486341526,PASS
A29B9CCD9A8E763CC03FABEEED5252649520CA222EC4F5B74053BB8B61467BE0,128,128,0,1.0,PASS
DA4D4655D56A0C3D6F45C4DEF645F84190041D80DCDCF33226274D8366627A72,133,123,10,0.5319710580974012,PASS
E5E0485E9B06CBE7B6730995E13823D854FBAA186B012A2B90EF3F42D3FBE7AF,123,133,10,0.5319710580974012,PASS
35391C24CD125B5548891B3E42251E8A08B095FD90F1F254C44F498472816296,145,111,34,0.03358661289689768,PASS
5FBF572355654F4D24C37273F00A90496407330776DD367E0E44304070FBA020,137,119,18,0.2605890342736178,PASS
22869727B55AE5B859F0E688C76BDDEFF550F07F238B03E57536F8F2F6EB5AEC,113,143,30,0.060792723530522785,PASS
A07DFC5C5A464E365B08A484206A8CD55088D1CBFD78458878F9A086D9AF0341,140,116,24,0.13361440253771617,PASS
4880090EAD0612C351F60608C477F0182027AD21F2075C140D911FF1E3EEF0F4,146,110,36,0.024448945310089426,PASS
58C61F95A0957CB2F6C318943381F47D30547848EEB111E43C78437EFCE2A580,134,122,12,0.4532547047537365,PASS
330919C8F50C2E428F9BB73020988A128CB11E1361E5B560EE719B144909B5F9,141,115,26,0.10416255883043901,PASS
9D0D6D92D9F288B36B244B31038F8F4876E92B63610248DBC7BDC6B1C56E077E,128,128,0,1.0,PASS
FADDD5B1C4DAA1122DA0A31AA08C13CFE67CC87B42A14DA28A589669D1E4FC20,135,121,14,0.38157390570502125,PASS
B1BAC18E786EB6F62501F106608B308B7EAFBB4C42AE2D18A13EF36A03E9B8D5,129,127,2,0.9005235503397743,PASS
814BCF7E75F2ED969B3BEB49FF64265319A5BD66B33A3CAEC2FD1FF3139E036,113,143,30,0.060792723530522785,PASS
A778694DAC44A025A2AC310B1537EF7835EBCCCD1164420D00BC2638133180B1,145,111,34,0.03358661289689768,PASS
E4D06A185A9C29EFD1CB2F6C674AD76F7AA852D5BE61391D9D93B826C1ADB0F9,121,135,14,0.38157390570502125,PASS
99FB0054ADB6DD9C61B6CD6766889A45CCE79BE726EF0CE85F98A65562760D96,122,134,12,0.4532547047537365,PASS
56094697CD4807BBB49C473799715641CD1BCE90D5C12DAC2C0B7F57F63220D0,132,124,8,0.6170750774519738,PASS
E844DC69A5B6BE1AD4F15A59D003AC085814B9D9BA9A28B03E871EF29710D0CE,135,121,14,0.38157390570502125,PASS
A1176039EF85C3D94071B8CE826C68F663C52979DE487D29AF05F33015407824,136,120,16,0.31731050786291404,PASS
6D58F35C1EA2C623A4F83F554E07C20D35CC631FA6F7F66E16ED0EF893A4C3A3,122,134,12,0.4532547047537365,PASS
E7C75F43E52630CB78C9E4D44077C53F1EA10493055FB4D8CF50B67C7F8DC173,123,133,10,0.5319710580974012,PASS
AFD0C151DE8F71FEE85B7F3E09721885C545887DF16CA8966EDC1D8C3D08DB2C,124,132,8,0.6170750774519738,PASS
1E51EDFE0F311A6BF0729F8AA6E7FB2A39B42AAE43F417CE4250C0345DEEBC01,125,131,6,0.7076604666545525,PASS
83A0A948EA8E56C328DC31BDE9321C4E159444265E181E3AE8F84F33916EA80F,138,118,20,0.2112995473337106,PASS
C52AC925E2DE03346D3C9B0E56E48A2B8C711607B4D7A9AB74B866E8627EF24E,129,127,2,0.9005235503397743,PASS
F485C0F05DFCF306A843721F4F07913EFBAA6F905554582F99F258BEEC7499BF,120,136,16,0.31731050786291404,PASS
8E216C2C29BEB242D5113F6FC98266FFF106512B39BFABF18BAD35DB3D22F271,121,135,14,0.38157390570502125,PASS
5E06A5474F83B325D389625D36C908BB9C345C8E2C0784DB4C1040E338963C55,140,116,24,0.13361440253771617,PASS
E3AFFC961B6E19112375CB982CFB63E1D0AC6A4432BBD96D50AA946AD519FB95,123,133,10,0.5319710580974012,PASS
D23B75C33A6AD24E997231B1958A511A7B602E04E0F9A32819210784B9AF9560,139,117,22,0.16913144470267139,PASS
1D3E1D03B08D8EAE5B5B781864888E98D341A97DB183F82809A00B4BDA7038AD,139,117,22,0.16913144470267139,PASS
975592978254E86D36CD22DBD98DB85694FC8B3952CABEA79BB8E3BCED80D6AD,120,136,16,0.31731050786291404,PASS
6A79E9FB5D423D8F516656AC9A0AE4491467FECEEDAAE2D65A43EB1605A6D1C8,123,133,10,0.5319710580974012,PASS
C5E871577B7B301650F95355642FE005DE8EB639F08B6DA1D67772A6324E20CF,125,131,6,0.7076604666545525,PASS
9C2852F2D29022F5D6CA347745C5C26F06A3B517A675F0CAAB264C74732A69DA,130,126,4,0.8025873486341526,PASS
57F54DA190C53F94FE9C806295702347D55D9567727EBE7B42265DDDA03B6A7B,120,136,16,0.31731050786291404,PASS
F2508688D82AB4BA5751F1A33548DEA26434782DE41FCB865342BAA57ADA37BD,129,127,2,0.9005235503397743,PASS
551DA21D89785C080C0C3037DD2573FE851A8F52DBDBD84CEB7FBE8136225084,133,123,10,0.5319710580974012,PASS
49D37757097CF64B0FF314480E524533875A826CAF0A082B83ED75F1559EE2F2,129,127,2,0.9005235503397743,PASS
72F516088FDEBE46C619A54D0DB91B0CAF07D31640C894761944932524208093,144,112,32,0.04550026389635853,PASS
9740ACC9C9E6F080A5E42634B9632CADB416D201572AC4869969F7BC14741881,141,115,26,0.10416255883043901,PASS
7BB3AB5F150BFED9396E5630A6E8A98C77A925EC6C9B1227E360933DAA6222C6,124,132,8,0.6170750774519738,PASS
54572BACEC58065ABEADE6365A0FACE63754B2460483B1C206288045F91A5D9B,136,120,16,0.31731050786291404,PASS
CEFF3E7DC19DA838857736D423D7FB61ECD8DA15847783E4AC55DE1B6468F37C,115,141,26,0.10416255883043901,PASS
852471A88A0AE138B6B009CC22D9FA0F0483E79019616BFDDA498CFFF8BC90CD,135,121,14,0.38157390570502125,PASS
9A26E7FE972F40FC05ED60C502D038982E9274E853DB324CB0035E2B6904723C,137,119,18,0.2605890342736178,PASS
4D28BEF1CC79FF3676A16F99BAE368D09DD5F962ACFD67C25907ED53E3EDE11F,109,147,38,0.01754895019147673,PASS
832E2C538BF61137C51EFA987B26D4F063E2A5EF57F607C85C91C6E8530C2BFF,122,134,12,0.4532547047537365,PASS
9C241A2C632C15636DD92BB99F89A9970D9E0B8357D59F6B720821B1D96A7074,131,125,6,0.7076604666545525,PASS
D2949B7348E097469F97CA7E95B523D58E0ECCB497D6C2F8F4B1AB5FB0852A3E,121,135,14,0.38157390570502125,PASS
3A3B3A9B1CCA1C0E04B8A6087D58EF756A931D668639AF0F1AE24E94DCABE559,128,128,0,1.0,PASS
8935778E3948B8D8204EAEFE68E7F2E21B242E0683A14239CAC3D1A4ED35AFC4,132,124,8,0.6170750774519738,PASS
3DD1D22559FDE3FA5D4E815923673241C2AF8C2CF18BC898E07E9FB6D1DD2B74,122,134,12,0.4532547047537365,PASS
A2CDF489D847D23C7A17A427B10C290BE97785B4E39E0F660A0725D8CAA57972,131,125,6,0.7076604666545525,PASS
58A0F1975633823348C0C600DC77D27CA4C16C764C873042A5D8B92E3F281EB,141,115,26,0.10416255883043901,PASS
6A3C7C79A5EAA3F43B97131DAD452EC1667C38695B0F036137291375BA324BE0,127,129,2,0.9005235503397743,PASS
832D88795C5CC0A09E6F4CACA2E01F78333FD19DB2C0C206E730CDE98D6390C8,136,120,16,0.31731050786291404,PASS
2435E33F41A07CE7E8FC55CBF88A8A1FC4CA2B0901A3943894F10C7DFAA7E175,129,127,2,0.9005235503397743,PASS
205893BEABCA2652F6FB677BF41028FBC97A2008B0FB8CF6511B2CCB216738BE,127,129,2,0.9005235503397743,PASS
DD26F533E26F32F67F094896736FC6569218F03A4EEA578484FA0703774E3729,124,132,8,0.6170750774519738,PASS
A210E021D2FE14E347EC53449EBAE5ED641AD0A37528DB9B2E57939F5BB351F6,124,132,8,0.6170750774519738,PASS
21809384223F45E6DA823F00E64A306D12B7EE9FDBEC0560F4184C8D96B5E576,135,121,14,0.38157390570502125,PASS
8A6AF3ED332EA2F0E92F82EEABA6A163582822B7C59CADBD85BC4FAF519A8BAD,121,135,14,0.38157390570502125,PASS
FD761FC554677361789778B0627ED0B0B502676E4A6860BA196B70D45E7F2F58,124,132,8,0.6170750774519738,PASS
81187E2AA79E4097E6C3C532EE1DE690F97EC4F51C09A06347CC651D058DE060,135,121,14,0.38157390570502125,PASS
3FAA90F91AD0C7204DEB3C65B6C8F21FEE7ACFB87F6FAEF331A75A9223BD0F01,116,140,24,0.13361440253771617,PASS
2AE85686F1851B8D4FC3142114CC15F088A9A010A17F959A6394C832C24820E,151,105,46,0.0040402749798920095,FAIL
7905DA5F71E2D6C8BFCDAA847134BE984DF5F04C593A57737CF8040CED7CF85E,119,137,18,0.2605890342736178,PASS
DC4F5C37DEE0328887EB1DD60EB88F7AB9FD31F95AF88B514528B50F150A04BF,123,133,10,0.5319710580974012,PASS
25D63BAEB7B00FB647AEEEDBD05BA1D1E8CF7087831D48E1465737BE4F6069F1,119,137,18,0.2605890342736178,PASS
C8366A051D7477DBF9A9F1B72DD91C48A19D2F9E7BD4F9A66EC92AF95C115A23,119,137,18,0.2605890342736178,PASS
4BD47151F48EA808E8EA5034F28DC58E0FE1B733EA05CFDB612EBA786A740C29,131,125,6,0.7076604666545525,PASS
86331743F0176023431C73956939481841D6A42D6DE5EF31AA2083907D37F167,137,119,18,0.2605890342736178,PASS
881C7491E85EA2ED3263E4CCEB23C951F94AE0C9C2AD9BB7A34A1A185815CB56,133,123,10,0.5319710580974012,PASS
62A47B9EE75EBBC14606581B7F7266CFE4DE067829A21EA138069E1D000B95EB,130,126,4,0.8025873486341526,PASS
727573F8F2E3AA587FD784FBB8D968DDBBBCBE8259C6DBF1BB898AA538ACA3C4,112,144,32,0.04550026389635853,PASS
247CA2E8FE126B88DEDA6E8F7C75900AF3C99EC48004BC7A7397ACB8CD745C22,128,128,0,1.0,PASS
BE883F04CC73A7F5D9870E5EE59CB56BF89E202F314D269F586551DAA335974D,121,135,14,0.38157390570502125,PASS
15B1020E3F904F7C1B7E56D1220D19CE94131A313A9AD2258543354BAC259954,141,115,26,0.10416255883043901,PASS
FD1F9E115276BF99A3F1F09D4E3822B95319A1C1F03B02EFF7C50CC1C198DB58,125,131,6,0.7076604666545525,PASS
9B0346FF1351A7A8E5B26F7941FAC27C0F1712769BA849A3EA03F778C521173C,126,130,4,0.8025873486341526,PASS
ABF6595E94D3455A1746970B4FE6C5DABEE465431B7682A427DD7803B6A8276D,123,133,10,0.5319710580974012,PASS
D6BA83D7A81BAA9A9EB90CD85DE12908EE562FF00053092DCC6F67F5D05BE94D,126,130,4,0.8025873486341526,PASS
E01A96FFE4395BBC8132CB7EF8A2CDBE12B5D26C68C1289B6FB2B8AF1B7F052F,119,137,18,0.2605890342736178,PASS
BA55AE74B760E6F9171C06420253F6074CF5D41103722B739FF1BDBC159C34C3,128,128,0,1.0,PASS
6BE86D784ABE58D6724FF7475C83A9C723ABEDF844F2DF85570494F8EE755981,118,138,20,0.2112995473337106,PASS
5AA966E51589EBDF8276E79D220E4C13994B70EA6EA5E3D288BB890F627DEA39,124,132,8,0.6170750774519738,PASS
7CB0EDEC637058FEDFC7DC1BDF8AD764D52DEEDE1A8FAF880606FA681D7C30E8,115,141,26,0.10416255883043901,PASS
B811E24AC5E99A5C81434C3C4537329C709180B964F69E7E4F0CCA57683F4F2C,134,122,12,0.4532547047537365,PASS
9A66D2227F9DC8A16500FE3148122ED712A7D19C42F4AF49DF745CDB1DEF0EDC,125,131,6,0.7076604666545525,PASS
4AD28CA190F47739C8CCFC6DD8E484EC2D1ABDFF164116F8BC4222412B56A529,133,123,10,0.5319710580974012,PASS
2C6F4543459106CE7F1F373D6DB63CFB56A01EA34A753F0E2CBBFF30E065DC27,119,137,18,0.2605890342736178,PASS
3BAAF281B15F78525E97922A268A65DA417A81F05B34545E996AC275363383A6,132,124,8,0.6170750774519738,PASS
6B15FD1C137B73D981C27DD95D9D625C625BF2D8127FB5E6D41BF04BBE82F7D4,115,141,26,0.10416255883043901,PASS
56D09A2E25ADD082C74E736D0E376D46C3D4F526B41B95C0D433531A176CD12C,132,124,8,0.6170750774519738,PASS
7B8EA082FBEB6B9F7207770124753E4A5472F1BDFC2AA14B7150A1C66F3618C0,128,128,0,1.0,PASS
473D5FE08A984E24E890CB38409CE5358F1A17562AB47590961C1BC65C72E3E2,136,120,16,0.31731050786291404,PASS
278F8B97D958A4D1D6CCF12F20CE5B3A76715F7C74B4FA7F1FF312A96EDEA6EE,110,146,36,0.024448945310089426,PASS
24B34120E7033CF8D57230D9483E51A95751B0577E0D889C904A5FD66BD836D3,134,122,12,0.4532547047537365,PASS
1C9DB11987E5FF3B841318FE8F7B6C839F51274FD7F44C15494FA562DDFA0059,121,135,14,0.38157390570502125,PASS
18EA9154553F489678BDCC8D6461EC3DC077A617FD894ADCB17D6DBD4642E695,124,132,8,0.6170750774519738,PASS
F734BEDBF6496C696C4860B0D75125B08E93EA33BAC90E70B40692D0BF5012DB,130,126,4,0.8025873486341526,PASS
1E3913BA30FCF07429DCE0C8F1CCAFC2E93FD0991E9D7A9B51C646DB10626AC5,127,129,2,0.9005235503397743,PASS
2DE802AD9FD9A6606A6ED84845543B5DFA154515502F9156B1A2370C67AD2FBF,129,127,2,0.9005235503397743,PASS
213A763A9DA999655F93EE8E1D501E37FE091A87912077FBB6F48E5390BF13D3,121,135,14,0.38157390570502125,PASS
DB9BB7870543356B030DB18A7D3660DC452E96F69E4EAA9BA12B84D09F3D2BF4,125,131,6,0.7076604666545525,PASS
C68023B8E23DF7706645B444704E8F7F1850F3EF349F9F9F507C716B2C3D0B28,126,130,4,0.8025873486341526,PASS
D24B631179491493FD58B19EFC6E36240AEB805E30FED3D489E2737E73D2B02A,127,129,2,0.9005235503397743,PASS
46BC9DB8BB3664C9B7DFC35BE57B1DA6293B6C86AE07E8A459E726EC7D32562E,116,140,24,0.13361440253771617,PASS
EA5FADDA78CDD7F2AD9B78CE697CD338D77958A29A8C67A3CEF60E452BB2A7F5,110,146,36,0.024448945310089426,PASS
44259D1B0B16A1DB06B1FDE363EAB0F7F7BE5B562A3FDD31D99FE31F59290FFE,111,145,34,0.03358661289689768,PASS
D9FE7BC9EAB2D0AA3934E10B7215FF0F9EF5FA913DF8F4A469E921CFA7EA0D18,115,141,26,0.10416255883043901,PASS
D2F5E8629CDF4EEBDCC559CA901ADF0B724821717BF307A242EA32BD9532BCE3,123,133,10,0.5319710580974012,PASS
84CB58A7926B11BA1233D95083A808E45F5AD8DB19AF21B50B8DD317AF0F515E,132,124,8,0.6170750774519738,PASS
1BDC7E3795F11A774DFFC6FB868534CFD883ECEBD856A4067B755A9C78267CD,115,141,26,0.10416255883043901,PASS
9A4F6E1154A23357CD751C0F86E9ADEED6D140D5AFDD2BE2045D237CCF191190,127,129,2,0.9005235503397743,PASS
81A2210855076D5EFCE5F5D8163F9CF8393D7EB62AF5AC17D6B9B4A43669AA42,124,132,8,0.6170750774519738,PASS
59B29751D89B7DC0679C63D06C0D591A86687CF2B82A013DB4E5359347F53381,131,125,6,0.7076604666545525,PASS
7DE60B6A62DF1198B709BDC8EC11403B32B2A3926AD1F98D38E98193CE5533FB,127,129,2,0.9005235503397743,PASS
F96EE5ECA97986CE9FD3057CB8BF0426EB33722F9D5856C350F2867D65C31938,120,136,16,0.31731050786291404,PASS
7E1E5CF1D5CD63B46CE28D7FB487F40E5EA364934B655D1A5546D067BECCF458,119,137,18,0.2605890342736178,PASS
B1093003023933DA1CD4F37D58D438577920706B112D50CEDFD6DFC6BAF6CB68,129,127,2,0.9005235503397743,PASS
CF6BC7CF4F2E166FD67E4B44D01B45CF5A2477CFA0DD2C953DA6227F8B85F6C3,115,141,26,0.10416255883043901,PASS
F969F78932634DE46285F1AA586CD24BF0B64204B6D02934B35F81F0AB9F3E1E,128,128,0,1.0,PASS
B0F347F96C6E81FCBA08C96EEDC020E94174AB2822BA8E38A0AEFC50080253CE,138,118,20,0.2112995473337106,PASS
A8B24C57C07F339644A96C39F92342D0A9A187315E1B2C8C6584F8158948A72A,140,116,24,0.13361440253771617,PASS
AC1E0FCC93D330207966838E5114C16CF3833ACAA78784E801694EC68A996C72,140,116,24,0.13361440253771617,PASS
4EB386A14D8126B5A8CD39CF652559EB6841DDEC1126D944FCCCA239291F9E0C,132,124,8,0.6170750774519738,PASS
85B3726422CB8937DEF90BCE09F8B046350CDEE1EBFE0EAAACFE114B7B3F0643,123,133,10,0.5319710580974012,PASS
82F264D2EF0B19A907B6564F7B2178B5C81094FFDE08070148E0D04D565871DE,136,120,16,0.31731050786291404,PASS
E2AF896A654F7F299C00B1914AE15A18DFA01CD35B84E0DE43AFF85D016CDEEE,127,129,2,0.9005235503397743,PASS
1702596F1D395F0FD51A07A5678F87EE9A087794806B95370F604382F7D3E165,128,128,0,1.0,PASS
1EE753249D5A7504AB01BB3A4E6DEF6610F9AE8BAD407ACD09D64ECFEA9BEDB,121,135,14,0.38157390570502125,PASS
6B18A292277CA7524A5117A7A8B241F86703FE6C41EFDCA03C3E6563D3A755F1,127,129,2,0.9005235503397743,PASS
187DE434858576BA7ADE7378E476C236F547A01122E0E4E34F7131E87835FBC6,126,130,4,0.8025873486341526,PASS
69AB1F385778AEF48C538F862C2EF5CD0A0DE6CC4C3CEC8D077E5EE244EF0048,128,128,0,1.0,PASS
6B176E120C10A064B8C730365BF3F7DFDBEB50DE99956D10D65583B78360C40D,129,127,2,0.9005235503397743,PASS
887174B8BCA0C678918803244E5D84BFF460AC0ADB7EAB85763F79EBBDD13542,129,127,2,0.9005235503397743,PASS
409E4BB8AB14570DE10A227795602989F5715AA712DDC07FCB9436850B2DE97C,133,123,10,0.5319710580974012,PASS
476120C38F6F8FECD980317046336432DCC513B32BB74C8324B5A76E6AEC04C2,135,121,14,0.38157390570502125,PASS
275B6E081711E43D0690FB8EBE2F0E72ACA3CAF0EC6BC3A5D0790E0387CB32E1,130,126,4,0.8025873486341526,PASS
B6F1F68B7E750502CD612195FA546335D6BE74A712FA8B4BB0DECD79F93590E2,120,136,16,0.31731050786291404,PASS
15A663903D49AB898914356FD42B92C06E915EA25BA7F611800DAC62AA1B9461,140,116,24,0.13361440253771617,PASS
A7AD67B006AF3312DBA866CCE9323F6304704BDD10A3F4BC126563E85BB64B99,128,128,0,1.0,PASS
53609F4D883696ECE688DFD25C3DD9870B0FC9ACB4BB5DB198EDF551E006A07B,124,132,8,0.6170750774519738,PASS
4334C4DA5F64193A53F73DE9E65E61A057AF5DE09125696804A6DBB87DCF49B8,124,132,8,0.6170750774519738,PASS
14C45296CE039F2BDC2EC53F280B65B2E70AE5CDE870762B47516BEF3EDFD977,119,137,18,0.2605890342736178,PASS
B0A7994CF4A1606C5B2A26E2FC810E1E238D33A17E68DBE05476E08B993DF30,135,121,14,0.38157390570502125,PASS
B938927D0E818DCCE0A78120974EF06DA50451876C1DBEA0FCBECECB7F14991C,131,125,6,0.7076604666545525,PASS
67D04E9FEED13C33D7263E4A825C61A6A0157AC24F60468B98CB9E1516566779,130,126,4,0.8025873486341526,PASS
7204922B63B78B15467B3B75EC4085FE8B6172A1F17706E8F390ED1018BCD737,128,128,0,1.0,PASS
681DDFC39E4D8826C3CE36112A2A3A4059F893772E51583347A760A1E2FAA7F5,130,126,4,0.8025873486341526,PASS
98A6D8BDC0681280D8405108367242B0C7BBC3ABF37B7935F497E5195C612A65,136,120,16,0.31731050786291404,PASS
B618173CE4E02ED981D60E79AFAB72C69DDBF2D5E2A358D9A1C19DD914ABF699,121,135,14,0.38157390570502125,PASS
B33B5B5C8945103DA47E7D6A9FD9755BABA21E21385AC259A685424EA7DCD154,127,129,2,0.9005235503397743,PASS
3CD99900C090B8BCD72467D8FBC337054EA5D1F3F6FA69FFD4A0A944B9C4DE72,123,133,10,0.5319710580974012,PASS
AD828FA548ECAE51AF13A6063349E727940B9B50B44354153EF2ABDCF37D74FE,124,132,8,0.6170750774519738,PASS
7D7C9042CB2D452CCECA134538E729B7E6E1A1CE4AEE326C96A159EB22A102BF,130,126,4,0.8025873486341526,PASS
B6DEFF90FF42EA30ACAA091DCA65838F3C23504EF4A7C1CAF3280761D6108F61,130,126,4,0.8025873486341526,PASS
964A3D1C5C6DE8E4D91FE54122DEF0A5C2550AA77F8894C94A3DEA3057181BC0,133,123,10,0.5319710580974012,PASS
279078D34E8C91A15AD1856D83862C8A5C45A89E61083F10D4FBBA2F4DED6891,137,119,18,0.2605890342736178,PASS
1A8F937386CE1462D304FE4E186FCE7E7E4179DB93889978DCB48096F191940E,129,127,2,0.9005235503397743,PASS
5BF6EF90DE00B7683E85F1E52D8A675ED60FD63C997349F06E3CE30242F76524,122,134,12,0.4532547047537365,PASS
5E2084B0A117E49AAE2490506C8321A919D32290D0E4C55DBC3554BFAF9D5D89,140,116,24,0.13361440253771617,PASS
6169AACDAA094D41DA069FE6AA7927CC7A1672730D8F93DFA1E0E5E067961CE9,126,130,4,0.8025873486341526,PASS
AF43C5E1C800BC929A00D66551F9683BDF29328065AE01C01EEBFF1F800A7AE7,135,121,14,0.38157390570502125,PASS
8BAB4B9FD97A33222B5F89E0E67DA10119737CDD048C0500EFE460A3BD7398A4,131,125,6,0.7076604666545525,PASS
33E132877D552316AF9A6377224ED7B56421D46B161D03961848A5DCF80DB3A1,132,124,8,0.6170750774519738,PASS
5E9066DCDC717C08E2BF634C6B566C8C8F1AD1EAD3BE91380A7C5FEB45734D9,124,132,8,0.6170750774519738,PASS
7C8BC237523E07DE11F21C7C61D923E5287C745A35F0B64377E581C10E7C8CE3,128,128,0,1.0,PASS
4B7A695E4442C4225887D589D2B0B0397085CAA3780BC80004CA8AD97B19A85E,146,110,36,0.024448945310089426,PASS
6C9EB9B682D33865F9AA9293AB5E117BDCF79BEF58AD8F0F4C42160F983FFACB,115,141,26,0.10416255883043901,PASS
7384A17BF92604AC7A5DA5EEFAE43B2CF029A3289925E8C634402B64B5EEB089,132,124,8,0.6170750774519738,PASS
40BA33C0ED2D44A79D5E848354A89EDF30440A846EAB1562E0E69F7E6672754D,133,123,10,0.5319710580974012,PASS
EFDD140246EA2E0C03A4D40EE65AE7534AE618651B178B898BE465916047FAEE,133,123,10,0.5319710580974012,PASS
EF847832199D8BAA6854B1488E5202122E5DFDD2CCF161A1863481AAD4D9B534,138,118,20,0.2112995473337106,PASS
AD7EF76CEB274D789E00296C562DB8E1B2EADDF80A148049F853C541E3F2ECCD,125,131,6,0.7076604666545525,PASS
84D3710AFEA4ACA874DD36A59CE9C8FA1C73A3E42FA5DF6846BC33160FEA5696,123,133,10,0.5319710580974012,PASS
AA1AC4B8D1D8DA0487D9542795131C114AB3CCCCD221D89D41A036CC057E20AE,143,113,30,0.060792723530522785,PASS
AFFAD8E276041E362DFF6FA558956ABFE9B9C9EADEC942A4D46C930B2BE7B66A,114,142,28,0.08011831372763423,PASS
9D0857211C407B0D9368A69D629C7D3D31B541B42F7F03C79832ED405C750AE3,134,122,12,0.4532547047537365,PASS
1E8F1495D96492807ED70633F1C3A447249608281F1B546B376A714C43BD1FE4,135,121,14,0.38157390570502125,PASS
8622D52A17283B95220507932A3D0362614165C2D254D316C1035F02EBD39391,147,109,38,0.01754895019147673,PASS
F8AC2769F92FC3EA41C57ED509ADF512999FBAD0471647F996AC0653544BBD3F,119,137,18,0.2605890342736178,PASS
955378744F49B8DE8202BAB78F82697905376B3089D990EC281EC969C1BF7A4C,131,125,6,0.7076604666545525,PASS
4B16E8C346E7FBBF13A6D77CB4F95D0EFCD07496D91EC79A41F029C6FEFB334B,112,144,32,0.04550026389635853,PASS
271EFCE2218519721B5ECFA9E723584ACC1B6E1E00C5AE236047348D9469B9E4,134,122,12,0.4532547047537365,PASS
2350614EA551B2E2086678B3B81E31946D591A3B9203857C4AFD3759573A48F0,137,119,18,0.2605890342736178,PASS
FA9FCF3B90E5864F8CA7DC2A6FCDE522013859E968400D250F9A6A6891823257,133,123,10,0.5319710580974012,PASS
BC0FD0AAC7B036DD2E3271F941786237521538A958012DB846147D650FC5ECA8,135,121,14,0.38157390570502125,PASS
E897321D940BAB6ECAA47801B7A16BE6F72E7742D26E0DECBD22C3B68F39CDDD,120,136,16,0.31731050786291404,PASS
8124B857B387D838D72681609EDA7AD6BBC7C65561E44DD19DEB90BD091361FC,127,129,2,0.9005235503397743,PASS
BBB71F37A2D5F06978CCFF6655DAFDE8BF8EE127DE80CCF7CED4D215227D4855,111,145,34,0.03358661289689768,PASS
625B70D989394DB8F71BCA791D1F5F2C8D3F404BD602DD843AE06E7706AECAA0,127,129,2,0.9005235503397743,PASS
9686D831BD69D90B58CC9EADCC1FDA55D5A21F80269A8580472121DF7D08B748,134,122,12,0.4532547047537365,PASS
9EF2917944A50FD169A2BC648A67A17602C83485208864541B6259E0DAFFAD9E,137,119,18,0.2605890342736178,PASS
3F4EF5EE8F12654F4A6366E3F75FD35145541C17D23CA20BB121A188EA48954B,128,128,0,1.0,PASS
19D15EF4CA013E9142AD99B598E47AFB5F64BB44A2D027846310838A9678BCD5,133,123,10,0.5319710580974012,PASS
2B0215CFE5438919528F2C8B55D785E6DB76337201B9B123FB964526CDEC17A6,128,128,0,1.0,PASS
5A147953E4414518D68EE96996D66F5959CBF1ABFAEAF6949F14A5615472B175,123,133,10,0.5319710580974012,PASS
71F40449550D2A0F6D88F86F9E58EFE453BE5E739124230E23A177F92AEC1ADC,127,129,2,0.9005235503397743,PASS
4881819E89864B0DA0A9212E6F253D0506DD9EB4F5A3E91F920F889E78F3113D,136,120,16,0.31731050786291404,PASS
BA1E86FC962305067B3278D80A885B93D99D45B030E05BFD46784ABB31E96D8B,131,125,6,0.7076604666545525,PASS
63E1CC8860F59D348CF7330B8673B98A26BED3C1D476B88A5116630B0C214908,139,117,22,0.16913144470267139,PASS
BA804C5B0CB9E20C10C32F6D4AF4750E0FDE7A9F22089F16DCD4EE8F6C423168,133,123,10,0.5319710580974012,PASS
558881AE0303FFA28DD42DCCED99D276D5D035AFFF5E3386197718C510D28664,129,127,2,0.9005235503397743,PASS
E6ED0356837E7BE129FF25C07E6B171DC7D3218CC9D44F2B87F3EBD29570ED86,117,139,22,0.16913144470267139,PASS
2E01DEA532790B4F10C41B74542157E327D9436FA844B3024B3944F2450E24F7,139,117,22,0.16913144470267139,PASS
850F04983EF95452DABB01789F48040D8690CFE644FF06DB1BFE822B18406AF9,136,120,16,0.31731050786291404,PASS
FA6CA05AFA139E5F2E719FA2A1BDE26FC3F46CC30B01CC112E04AAF62727958F,125,131,6,0.7076604666545525,PASS
6DF857EED1D4CED4C1281BEF15E720CC7CE89579E270C84D424D4CF97FDA655D,120,136,16,0.31731050786291404,PASS
2711C54543AB4CF8005B12575489BC06E40880846C454C1819B591BCFFCA87C,148,108,40,0.0124193306515523,PASS
28FAB1E7D2D34C55AC70D0AF3B1606C7DB9ED8D3100679FF0A66D5DA152F665E,122,134,12,0.4532547047537365,PASS
273170D6EC3F40B2017E40C28AFB3F38BE023B1E7C676FA97E55D3E9EF5C2B8B,120,136,16,0.31731050786291404,PASS
485115185790EF4E370C5908BE7F51C664FFA384CAD6B1084C02AB1E2F6D3839,135,121,14,0.38157390570502125,PASS
BC98DC0AF70BAC12634E693D951685321B7C0197A151D0013464F6D6AB0B4C62,139,117,22,0.16913144470267139,PASS
F607F42D632D505F715BCF6E9622D06D655215510A95CBD2BEDDDE98F38D3781,122,134,12,0.4532547047537365,PASS
74FBFC78C286C0488052CB73968A9CCBD42DA1F53A20E1E7091ED451ED340D5,136,120,16,0.31731050786291404,PASS
25CE868D29A6939EA0D8F7A7D1B5145AA43463D300A37C488DD366C3A4175BFB,130,126,4,0.8025873486341526,PASS
4368850478B38215CC2082C156EE4B037205694DFF8A08FF504A82B570E65CA2,145,111,34,0.03358661289689768,PASS
BAE25AA09DC138255558DECCF577B41756EAF6BFE03356EAE67B2F3CDEAE5966,113,143,30,0.060792723530522785,PASS
3918F301E82976CA4F2EF86711114574C9F52A88729B27868CC6E6BC7B48274B,133,123,10,0.5319710580974012,PASS
52CB6F881B26461E37FD534A98C7DDA3874A5AF94E7B18A77A167FD1D0811C28,126,130,4,0.8025873486341526,PASS
502E7AC57700D5C431811E8F20F83D4DECD1722020C0B123CD51064A284EBBC5,145,111,34,0.03358661289689768,PASS
80C5842CE00642547436D1DEEE0F5338081D6B3F536ADF9551E7056B28F79F1D,131,125,6,0.7076604666545525,PASS
6ED3E448FF2321A641B1513F510C15A90838417EFDAD3BC51B220EBDD2EE9F4F,127,129,2,0.9005235503397743,PASS
592C229C5AA1EE397B0BC05AF3308D32AF506F4ECC012A865BD03C094CAA67C6,137,119,18,0.2605890342736178,PASS
DC3D609FE0F1D21201387E1A3D7E18640E03D101F0DDA904AF428D5941A139BC,140,116,24,0.13361440253771617,PASS
9C60AF60FBEF6AC8280FB77E062D22192A799FADCB3666131474FDAC9964834B,126,130,4,0.8025873486341526,PASS
208A16DDC442A79DE8F94708AD07FB5FC211161B24BBC569AE0B62D06418F494,137,119,18,0.2605890342736178,PASS
9E14781C290C3A1DDF5C179FB62AA0F342AB75CDAC4FF770516EBA1ED7CD8CE3,120,136,16,0.31731050786291404,PASS
3233FF3A6207F6D05751BDDC6EF494CFE72A07CA5C67D9B02D14E0DA58EE4909,123,133,10,0.5319710580974012,PASS
CEBE51CAE9620808FD83FBAD7A81BE458F2FB7B5FB6DFF019C5DAD9FFFE7128D,108,148,40,0.0124193306515523,PASS
43022D266F96364AC8375DEB791FD55D37E2D451DC605870C74F7382F96A37E0,125,131,6,0.7076604666545525,PASS
7502EA5588B4BAF1A9469A260915633365477926E84C347DEC869E352A75B48A,134,122,12,0.4532547047537365,PASS
E2AE8D68A3820B37D8DBD5D577B1FDF6A8C51EEBB3E242AD866C6FC70C58A275,119,137,18,0.2605890342736178,PASS
5461D7E86D0C1A753B8634A377D588D5E5CBA721187C8B98423B704AA8DD5B05,132,124,8,0.6170750774519738,PASS
472C57AAD5DCE4C3A2497D222A7CBBC56A5F5C73BBA22F76F994BBD0A0FC3981,120,136,16,0.31731050786291404,PASS
50A2F66E6CAD0BF96497F329BA0860C0E559A618833720099EB5CFB1ABBE3704,132,124,8,0.6170750774519738,PASS
85EDBB8496EC215C56E579F7B56618B729E08191C158EB30B2EDCE267000EC4,134,122,12,0.4532547047537365,PASS
FB4CDFB32049113C2ED0E00465C1B1C3EA14D3ED2FC7C9B8024CDEED26F83090,134,122,12,0.4532547047537365,PASS
146CBB8A479CEC612925767DB8635C922CCD726E332AD0E589C50EAD2382BFE6,129,127,2,0.9005235503397743,PASS
B0314EC429D148C6711D8707B4A8A887650673390F8954E672BC91244544A274,145,111,34,0.03358661289689768,PASS
AC8272B4558F9EB0C26F810050B6948A9F750987BCE2E3C3A6FD28D5DDED9957,127,129,2,0.9005235503397743,PASS
BF32E98ACE05E65E28967A93C9B07829F6904DECD944EDDF38C790FBE93EB339,119,137,18,0.2605890342736178,PASS
EF36F730E18A363B1DE65FB80B00B3F3110896E411F3482A4FC9198ADDAFE4F3,126,130,4,0.8025873486341526,PASS
F5A6AA39F4EA1FE538233EB2A6954DF537B53D021BE99A7F8A78F63CA7815B1,119,137,18,0.2605890342736178,PASS
DE47F84B7E07DF9E21EF51E92C2D3727BA64499A0114A3218A57682DBA5F0671,127,129,2,0.9005235503397743,PASS
3C055F4FCEAAF0E1830E59550D8067DA236913D847D8B387DC09A819F88055CA,136,120,16,0.31731050786291404,PASS
37F3977ACC4DEAE956D01FECF86ED9303CCB16954DC0CDD27067937F88E55CC3,118,138,20,0.2112995473337106,PASS
AA921DF694769477573147B27D28F2DA054DF22DAB34BB55A017AD4E853FCA94,124,132,8,0.6170750774519738,PASS
DC0866976E1B51FD4AE3381E9D0B479AB6D98B9C89FB33DFE6293195DE44B923,121,135,14,0.38157390570502125,PASS
2D0E0E9F4B71BFD6A8811EAB900F35422731B3BADE63A9361A5D83031A4FE39A,129,127,2,0.9005235503397743,PASS
6B65C9FFDD32BF5AE2BB2688153E2DB61EC45F557BA8FCB9C6DD62131D754DFA,111,145,34,0.03358661289689768,PASS
B229BCF6629ECA5A65A82F1EA73DB315B1D38B1D932B491086D661DEE7E3DD83,122,134,12,0.4532547047537365,PASS
798F4C8BAA33959BA3A211A3F148CFA9363FF49049AFBA53FF8E592376D46793,120,136,16,0.31731050786291404,PASS
12E0C0CF5AE08E061E735473C8A0E4206FD47C1E134EE1FABEBF01A81F0895DF,133,123,10,0.5319710580974012,PASS
914B496C331E25EC8B13EFC65A1A53D00404C62089482856BEA5B1C85BF3907C,141,115,26,0.10416255883043901,PASS
A27DA13987829D7DCCCC3D587535472B3881D39FDB3E76A21C45E88FFE1F3E31,120,136,16,0.31731050786291404,PASS
4110B21CA02D95D104F089DDF92434064FB58C9B489C960AE9D8EE513C7E518C,141,115,26,0.10416255883043901,PASS
CD4013D550BD5A32608E89D11AA4899490B54B56BE8AE1E0AE84D0C4BC98806B,144,112,32,0.04550026389635853,PASS
4D7B99353BB30F1932D8F85695A7F792EDCAC06273432A02BF8BC097F35E84AB,123,133,10,0.5319710580974012,PASS
2453DA66ABD2A57D8012AF11630C6FFED1C99E8CE1A8E528AB365DA519636BBB,126,130,4,0.8025873486341526,PASS
32F400AABDBF096B780497D03538310E148F03DDBA02CE2D2FFF82B9E8EA28D5,132,124,8,0.6170750774519738,PASS
BA3C764306928B65FABE7870F3A1E7BD06D59BE7F95DA79A5E11C35E4B189D06,119,137,18,0.2605890342736178,PASS
A2129CBB8C7C234279CCF05784657D9E4CA92653C1336CC80C9791264B8FC0EC,136,120,16,0.31731050786291404,PASS
56288EFF73061504D89BA491CA0FDE10AD8C8E1B2312340378CE24C667DEB18B,137,119,18,0.2605890342736178,PASS
D0EBDCF0B0E23C08A261E4B17E43196F5A78419752818DB866B625E287767BF5,129,127,2,0.9005235503397743,PASS
AE24D5C43BDB7E287D6D90D337362BF6832628A87209FA5C83E9B0CBAC610864,131,125,6,0.7076604666545525,PASS
42E06A7569A415486398BB1E9457B76C01C788FB8372C06FE90A40C8C53D4DD6,136,120,16,0.31731050786291404,PASS
9F9346D60514A885FB136D6498E2CFFEF7B17691E84DA33F22E14D1AD0D4D167,124,132,8,0.6170750774519738,PASS
C808100F2A5606692DC42F03676A118B860B582BFCC05AEAAE26747357436C30,144,112,32,0.04550026389635853,PASS
1CE0AD2ECEECA8FC57F390F2203EA8ECC032BA4F62C8D09B5846C59DDCC566B5,128,128,0,1.0,PASS
DDEEA3496FA1D53A5288C97794699B2B64E0DD7B8898F15BC459A4D4A94BD589,125,131,6,0.7076604666545525,PASS
56516C879FF01D8AD4FDBAE483163748453A97FE73BB883452A82EF79C32DB6D,121,135,14,0.38157390570502125,PASS
9427F8A23BB4B4A23895AB93C5708ABEFE5537F72B9B1593DB509B2C45D1C139,124,132,8,0.6170750774519738,PASS
A319FB502FA409CAAF692958F88D5FCF5BA9854F6B6B94A138F096DA7D3FCA25,121,135,14,0.38157390570502125,PASS
45D15354C39ACE1CFEB99FC8CB6D46C484129EBFC9E9CD28FBDD053A20445828,130,126,4,0.8025873486341526,PASS
961411E9FE17CBED214BFD02633982D43BA7BD61075620441C9E9E51A2F0E653,132,124,8,0.6170750774519738,PASS
4250AF767E7596F85EBB6694C3FEA69100061326532F4E8BF2DB843F0E832116,130,126,4,0.8025873486341526,PASS
D183C2C1897036F9EB54C407E44047C747A5CE59F00ED7751FB300824DD4157E,134,122,12,0.4532547047537365,PASS
87CE0AC6B41F90AE040D84F73E927B23FA78ECB32E35BB3A2C36A8E7B4991E20,128,128,0,1.0,PASS
E0CDCBA0F4E671923AA446B844A864B66CF50C4ADDA2E011668098C6A5802AE2,144,112,32,0.04550026389635853,PASS
6FFD6D6DF0D9E897D27E2122AB2AF5DD4B89F6463B968D631C27F79BE346885A,115,141,26,0.10416255883043901,PASS
2CC2DE5AC058BA6C595D9EBD3B2CE7D64C07C40694AD453C5D82C2A3C258FFEF,126,130,4,0.8025873486341526,PASS
E6AC5B8142413C6199557D8EAC7693BBB81D1FF48FC9C752397093B0630A84D1,131,125,6,0.7076604666545525,PASS
DF54D489C9C3472C17EB0E78C6DAFF243C8CBF2C3A44C0F6AE1ACFB692ED83E5,121,135,14,0.38157390570502125,PASS
30844D99B2A0412CDC2AB5E4368FE81E34D40BDAF9F9BB655782164334AA825E,135,121,14,0.38157390570502125,PASS
EC8E2E390B3C6D4D0DDD8E708098C2907B954A85AB04B8CB7234F2F2D151CCCC,135,121,14,0.38157390570502125,PASS
E99090CE30C4444F660E5DC91F65C345CEDEFE2FECFC7960530F44F0D1D2D4B8,127,129,2,0.9005235503397743,PASS
F8D99276B7FB43114AD2D730C5259D35474357522B6BC4B8BFEB637688824B9D,123,133,10,0.5319710580974012,PASS
1116105BA6536BDE35372E767B8AF7DDEFC530357829CF1CE78CCB36E92F158B,118,138,20,0.2112995473337106,PASS
6E70D5CA2B53D2E48EC4F0FEFCE381592CE9AA964445D02D90FE077B7337ECC5,123,133,10,0.5319710580974012,PASS
6B269B5AAFA1B5309261AF98773A021A6D2539EDD9157952D4959BB2497F6D8,127,129,2,0.9005235503397743,PASS
417509D5DC0F7C0AE4B8F9C7CA48C0D6462608726FA96864A7DFE287DE0251BC,132,124,8,0.6170750774519738,PASS
520AD7490F718CD1EF92CD9FFD164E185C2C5E878FBAADB879A23CBD95B8E0E8,122,134,12,0.4532547047537365,PASS
3D10052C3DF934AE1E7801465738F6B7696682790F11DBF8E8489F3A182188DC,135,121,14,0.38157390570502125,PASS
EADAFF78FA5A109903606A9E5E2211A09BBB91AFE287BA43A66B5A97A4B75056,126,130,4,0.8025873486341526,PASS
D4A4CF56AF4930E9114840875B0B6C5BCC0B7156B2C01CD7DCDA177ABF266B44,131,125,6,0.7076604666545525,PASS
E3718FFFC6ACA0DAC3D6F45FE8A4A49243DF79DC7BBAFBFA4BABB4B4BFC61213,109,147,38,0.01754895019147673,PASS
EB006BF2728B484633258FA93A293829439B3DEBA5E3DBCED1FC74474BD6096A,126,130,4,0.8025873486341526,PASS
B3DE900A679A2FC70A1EACD0FB9C6816D28FD7F3751155446C2214873CC8B6CC,130,126,4,0.8025873486341526,PASS
C7122B3F98265CDDAFC9435FAE4C90C5D3BD72456707CC273BB4F1688776A3F0,122,134,12,0.4532547047537365,PASS
80BB8BDC4DB76F73D287E28773A26AAD460F59ED5C43D02185E10B71C777703A,125,131,6,0.7076604666545525,PASS
E8AFDEB285EB6C7245DBC65E19453AF3488707EDD7E78D2F5AFC7449643C0AEF,116,140,24,0.13361440253771617,PASS
41585082A250B42457F1061AD7A0CA54A86B52A50F557C8EF6E0E394C29C8AD9,142,114,28,0.08011831372763423,PASS
C385A76AC80C24DA58BF454DD1662DBB73172B21433654E74629D373314A335C,132,124,8,0.6170750774519738,PASS
65D136D6874F9C56521D15D0D501892A1DA52EEA5A0E94328DF7E19558E103DC,134,122,12,0.4532547047537365,PASS
6837A2A73E23C0A061CE34558EAE1E13672AC558EABBE09DAE6DB7F0A6AF77DE,121,135,14,0.38157390570502125,PASS
89F13A37BEBB479C010972F53799551256C5C30BEDA939A96C9DD38A8919FFE5,122,134,12,0.4532547047537365,PASS
63BED6E6BC11D7BCC3DB8CC33D9AC49EBD82B728479F76866399AB32D30F55BF,114,142,28,0.08011831372763423,PASS
1192DFB61DA60D45BBBCDE0D75273D917260161DDBBCB96E06AA3D5CF119D327,122,134,12,0.4532547047537365,PASS
95093794E2414D2EA04E329F59BEC4CD1A829644EB5A2221580434034A7C17A1,146,110,36,0.024448945310089426,PASS
C81E987A9FB338F834640E9DF01779B230C1A6240B074DD6D4B3FD27DFDCDB33,123,133,10,0.5319710580974012,PASS
519371C20B88B4D0FE255A8CBD9DC3DA9C8A9B91CC0D19F819B60710248C2D3F,136,120,16,0.31731050786291404,PASS
66B13CF0DD5154BEEE16A8A72B20A724D94A1CF0E35881853FD38779652BC516,130,126,4,0.8025873486341526,PASS
D9BFFB69831FCC747E2BC7AD28A27FD1FBD861466FD36E9554DFCB6F4311099E,111,145,34,0.03358661289689768,PASS
4CC0EEEF896DD11630B4664C725ED389F30828DBB9D6C6FC33D83A9E933D820A,128,128,0,1.0,PASS
EA70A822933A2E966374CAFF49521E17808A25DF130A439C23D4548258F6243,142,114,28,0.08011831372763423,PASS
1240190A783475431CE2A6620FC4DEC013DD3E81D820AD25C20E6DADE944F46C,143,113,30,0.060792723530522785,PASS
763558EE6384C063D612D120C8C173CF0A5EEC82CE1D8438CB976C5A5A77360F,133,123,10,0.5319710580974012,PASS
50AFC085A8026BD4B6F9A8202E657EAFA589BF8DD9AF70E78EE82A220CCE9835,130,126,4,0.8025873486341526,PASS
51343A3EAD69B9F26065F956F88715ABA057ACACB0252CF2D282D6FEC2DAA4F7,124,132,8,0.6170750774519738,PASS
568E3679F04629620F15DFC3DD842FB853A1AC6B98FF7DDA861D57C7D6461EDD,118,138,20,0.2112995473337106,PASS
BDE8C4082690A7E0F42211C2F3FB47A1F4328B107E5DE2AC840446119C806A25,145,111,34,0.03358661289689768,PASS
FD45F64E52DE24B4EB74DA811B29AC2ADD0748F3797B1EAFFA942997D3016446,123,133,10,0.5319710580974012,PASS
A4D74B575FF154748C15539D06E95CA755625DAF37DA4FCF964D088E17186C45,124,132,8,0.6170750774519738,PASS
4A466BCE62DB166D97C258FDF51D14996022F5BDA0C8B39DD59BB3F50D79CD9,122,134,12,0.4532547047537365,PASS
6A2B6B13F5B32DF74B67CDD6109313C593F134DE2AF2242BEB6F38B01123FC5D,121,135,14,0.38157390570502125,PASS
A476CD35D44C21908C02639EB884D23CEB558384D731117748373B0F97B68285,138,118,20,0.2112995473337106,PASS
6B31F58478A2A95DD47010F601AAD7418537D1672D644B2F78CE471491EC8B05,135,121,14,0.38157390570502125,PASS
EEFA551573A281F3627B2E701FE1136A1363A499538F8D742AAF61D0ACE8E5AB,125,131,6,0.7076604666545525,PASS
A8825BD08CB1E0D9BDE0D1C6A042822EF35240894E34DDA262C64C84AD6CF3B,142,114,28,0.08011831372763423,PASS
50FDE9DBA361780CC9B35F5EF84CE99EB35564F561233A93A04DAC810AB1B3D2,126,130,4,0.8025873486341526,PASS
3A233704C11F2DDABEA64C86335DB78BA6205A82A4CEA7016841EE070685F73B,135,121,14,0.38157390570502125,PASS
8144AC099A51269B738DA754302DF287EF0EDADBBD4D38E77959DF783AED3773,119,137,18,0.2605890342736178,PASS
886AA79E0659173E58F5F229BE26C65E6BACAE4BE4CDD49B44C9FE7F6830533E,120,136,16,0.31731050786291404,PASS
1DF0F639DA78CA94FAD44065BBC6A5F73B4962B19B8C12FBD906F78F2205C549,124,132,8,0.6170750774519738,PASS
61F16BC62AB4DEEB60936D4C4124B249CFDDC74E2B5727975447CEA5571AAD93,123,133,10,0.5319710580974012,PASS
6630BFB58858C019A3024A16B653A931E15304144AE8E92D70327AB68DBBD820,143,113,30,0.060792723530522785,PASS
2B2E11D12A81C1F982799D36DA842B83956C5B032A45EC7EE60BF3E2611DFF37,128,128,0,1.0,PASS
2CDBD4736F5AF5962327A8D2D8B554580C0F419DC3B32FBEAC5D433BDE6D9304,123,133,10,0.5319710580974012,PASS
D7A7F1ADC50BACBF0428BF39BB32C58EB6B1E79226604352280F9D4F071B1688,129,127,2,0.9005235503397743,PASS
FFACD9D14BC04EB72A69B48E92DC13B8E5DF0A0A9988ED0CFC832F634CFE1B79,122,134,12,0.4532547047537365,PASS
6664139FA7618A2FEDEF10ED127B6E810EF13B5979BF72FC81FA74F59F5453BC,114,142,28,0.08011831372763423,PASS
49E2BAEF5CC1B9102962082FE833B4DF513E1B4B8AA3C064EAAB4B036C6D1CE8,133,123,10,0.5319710580974012,PASS
79C791D9B8A811330E6578A80C6A460FF8CF590B3D5C732727D7DBC259E75C78,125,131,6,0.7076604666545525,PASS
7BF2A3AB017A81896D9D474AC62F18BC5908AC4B7A68E024D22B8870E034F85E,137,119,18,0.2605890342736178,PASS
5003FF877044287D26A0484302C48E78371ACB4063479159B069F1373A400423,150,106,44,0.005959526470109114,FAIL
15AED3F1212D588A52F52EA889994A3D09FDD77BBA2E0E5EA91A8F6E1D81EA1E,125,131,6,0.7076604666545525,PASS
DD2DFA20C116500F49D39FC54891BBAE7CCA37C14BC33B5C98D794420294F384,133,123,10,0.5319710580974012,PASS
25D3267401A5EBDDABF47BD6398CDC380DEAB1D9CDA03DC3597A2F489186AF71,123,133,10,0.5319710580974012,PASS
4438D42D9AAD1BC0574EC8530C49CD3E4D3E1A8B50BC4AE70BBE500D2B85ADA8,136,120,16,0.31731050786291404,PASS
86858BAB70C9F54D39CCCB5C001491BC1EEE81E79A1229401AAC02A917840F19,144,112,32,0.04550026389635853,PASS
3FFA8CA3E14DC3A4F4ACEA4D17026AE9108F6B10A6C8D6A88BE6DD3CE8E85D9D,126,130,4,0.8025873486341526,PASS
E6195DBC032B378224D0540A0732264015A49D09875EC5FD2A231E2934940FA,147,109,38,0.01754895019147673,PASS
B3711C3A6B9D9FEC7428C219D0C6BFF1F7BC0B8C2D18C6BEC18F23E785B88105,126,130,4,0.8025873486341526,PASS
6951586950C05CC030EE0F4557C73563E7548109C3D240CE383D6E4125E91A6F,140,116,24,0.13361440253771617,PASS
75563239B174524BEF4A995AD19BE97F80223A58B715A959F4FF7025476C6C12,126,130,4,0.8025873486341526,PASS
E0E3B0F01857C48149205C1BE8269D890A452623160B425E2A0FE1355BCAC216,148,108,40,0.0124193306515523,PASS
C09F6DE79F71516D452B01A69FC1CE9270260A1D37B7E2B2B341DB0E56F678D0,126,130,4,0.8025873486341526,PASS
6333959477486066B0EF6A03F969C82214BF96279432E6D22103EF5468E3B898,135,121,14,0.38157390570502125,PASS
EA5605D0426932732A2105C0E492A285CD6E7CDF96945B257537D8F32B04B1A7,135,121,14,0.38157390570502125,PASS
B2DFF85BA93A6562EC05A2A2E196DBA4A0AFB0225C5035DCE476D781E72EDFF0,124,132,8,0.6170750774519738,PASS
30E5A0104E5AD8FBEAE5AA64DF5765C28596D4937BA6C68F77045C4605B117D7,127,129,2,0.9005235503397743,PASS
F9C88AC9BE9B47A9EC81620B4DEF6E6ACB73C30B0DB56BE46F1E2AB78B75F4CA,117,139,22,0.16913144470267139,PASS
5747580988189BC2100A6EC2A156673CC4237446134C691FBA32C71C41F1A6E3,143,113,30,0.060792723530522785,PASS
C49691738994C45B61DE8803F146A9552D43E812CA2D02C612BBA544535C46AC,143,113,30,0.060792723530522785,PASS
E91CE089072324DE8D61295C91E06436FEC44E22C661B5041479A5F290B9C411,144,112,32,0.04550026389635853,PASS
CF6AEBD56970083C8592FF17C3B3690D614A681F1D95DD4738D167D3303EF297,123,133,10,0.5319710580974012,PASS
733C58BDB22CFE5C2A5EC77F94136331AE22A66A3565FBFAC0A6D5779BBCC875,116,140,24,0.13361440253771617,PASS
58E6A332AB448ACB4257EE7A7D7157BEED1FE1B7BD522F6D89BF7BEB3F2A4C8,112,144,32,0.04550026389635853,PASS
BD311E68CD8C9B3CD7F43E4F5B1E0F1DBCC80CA639A2CD203E7F13CEB640984A,126,130,4,0.8025873486341526,PASS
C4087ED0BF75E55E6EAD13E8913145CCA7F86220B0FF1928538C6C57A4318AFA,130,126,4,0.8025873486341526,PASS
992FA1612468640882E848CE8ABD283DC34163AA4C1835D017946B5DAF607BEC,141,115,26,0.10416255883043901,PASS
BF8105984998755BFE3B3C9792C011EAB513A2A6F9827EFDB303DFE59CCA329E,122,134,12,0.4532547047537365,PASS
43CA30EB3337AEF209C530447044502A374DDB89FCD2844C2266B1EEE922709D,138,118,20,0.2112995473337106,PASS
D2C455B1122E24DAD53444903CF50259545E4DA0DCCCCB6E87FE590E23581B3F,134,122,12,0.4532547047537365,PASS
791FB709C3ABD5A0A55699E7E7360D49DDB72961F3B3A2F9EF832A431947CDC1,119,137,18,0.2605890342736178,PASS
82E068A98F3B7524A6F76D7D899B6640EE60D885D0AFC8962E7EC3C8D8A481DA,130,126,4,0.8025873486341526,PASS
5D1D0A83889B1ABB3D86CE55158661B4AA14E0D4B5DD78731174AE047CF93C6D,131,125,6,0.7076604666545525,PASS
3DD51405DEA3C6E8D674BBB1C6BC9F2683209267BF9C2ABB716AA7EC0CA29A22,126,130,4,0.8025873486341526,PASS
EF9C5381A0969120A1DDCBBD3A3BBAB90EFC399D83069D8F4A9EEF608483E92C,127,129,2,0.9005235503397743,PASS
50F5C627938EE3D922F93974DA8728F23405E5E26E4F9794E1A00ABB8A470577,129,127,2,0.9005235503397743,PASS
16340ABF38E611F49F1CB763309483A588BD5707D586D2421D7B8D1E585D595F,129,127,2,0.9005235503397743,PASS
E01392918446398F19FD53303699AD462F177A045ECCCC99871F55FD7564C7D3,128,128,0,1.0,PASS
12024F51A1979097929E8433069FC269EEE214C4B5486CA59E25769DE8032630,142,114,28,0.08011831372763423,PASS
5402DB2535E0F431E97284F687DA1879A8FAB3D8984BE8880B03169120328EBD,139,117,22,0.16913144470267139,PASS
498E8324782E43B179309840B856382F95859A49DA98848961F606A422EADA66,145,111,34,0.03358661289689768,PASS
7338CD8278D5E3CBD6FC2FED8A8B95322D3E106AF4E18B340C4383633B38D303,129,127,2,0.9005235503397743,PASS
FF58DF6BF9622BA01D42AE9D513F551D7247AA63B3CE1755504740D56A5617C7,122,134,12,0.4532547047537365,PASS
4BA59FB97B40BE7F549A9DC3C57B64520EBE1B35229FDCDC36F7BF7CD185002E,116,140,24,0.13361440253771617,PASS
37FC59B58DD013CC0A2D0D0AB572545C1B8E5238425A5DC8807A225D9E703EF2,136,120,16,0.31731050786291404,PASS
B8875A29C771F32CC4AF161EF9E1B2C374E3BC8A3B77A07F554B494E5C0E5E40,124,132,8,0.6170750774519738,PASS
FC57920B46297CCEBF8E5F16643E62243099D65BC35F4942805E09A5F2042E85,134,122,12,0.4532547047537365,PASS
52E8746D03FEF4BA442880E8420623748C9490376C00B98EDAA205054C8032,156,100,56,0.0004652581580710493,FAIL
44CB1972A30A7D2F65B6E43309FFAE9EBADFF8FA402EDF1E1433265651779F0B,118,138,20,0.2112995473337106,PASS
3EF5709DF74E9258588F9F1E36B25E33308D6814A33CD3D53272374B4400B25D,129,127,2,0.9005235503397743,PASS
C3C235945A4A718462324578D77D425B013A724A7B81A7399B58602AF6C3B112,139,117,22,0.16913144470267139,PASS
74B58476111897DC91DDEE68D38E1A514CB5CB89C044E1D42056C81CF473AFAC,134,122,12,0.4532547047537365,PASS
1703BA7F943959D979450AFEB54E3D1F599BAB30E050A683234F24668081D400,137,119,18,0.2605890342736178,PASS
B0501A0C442636BB36EE9B46C70E671728A60169A2441CEF5839581A3DAA08E1,143,113,30,0.060792723530522785,PASS
18DE60785F318A61A5BF449F4EAFF533FB37ADB58E4E8CBC8C3228BEF5EA8D6E,116,140,24,0.13361440253771617,PASS
86A0BDDBFBF61587DDB81C378B9DE9417C99E20ABEBCEAD2F3E043435F7FAC72,114,142,28,0.08011831372763423,PASS
83E9CB2346BB75F69C8E3D0B79E6AB6565B37A59FE9ADD0198D49709465F55F7,115,141,26,0.10416255883043901,PASS
3EBFAB7E988A80AF9E91DC1776378CEB084797276B417DA2E46E8DE37A3232FE,118,138,20,0.2112995473337106,PASS
ABABB987D004DED697B8C93F2D346DA845AE1291AF1E9911C11FAB1498838869,132,124,8,0.6170750774519738,PASS
487082CAEA1A14EEF5B5F91A35D6EAE91184035119C5B1B137DA116AF39DB205,133,123,10,0.5319710580974012,PASS
E8D8CF166F6CE87B9776A62264D2F5C7876AE3AFFEA35F86D1A744E9F32C92C9,114,142,28,0.08011831372763423,PASS
809FB36A1D688C87B88ABEF293330BE88AF01272FDA90B0341497FB142FCFE49,130,126,4,0.8025873486341526,PASS
D0EBBCC5D5493000B3793EBE1F577204678D8B924ACB968848B523FE2963213F,130,126,4,0.8025873486341526,PASS
56FEA6BC0E17A503C0DDAFFFC1BA0D4176BE3C925213CC71A09706E2DA335B1,128,128,0,1.0,PASS
79514A266928336F37B6B088208B1EFD18AAF1D1491C0CB0897D1EF422C8183A,140,116,24,0.13361440253771617,PASS
,256,0,256,1.2777508801076536e-57,FAIL
61D2744FC2A9B7CA0D95813D042FD2366EECA24DA568489FCA879B2BF4482743,132,124,8,0.6170750774519738,PASS
DA82D71D62467463CF1EB6541A693A5EC12A4D0F05C73A5784E0BE19CC634E1A,132,124,8,0.6170750774519738,PASS
46F08375A89C4802DA15B3D1A3039CFB838AED2589FB4279DC22CFDEACB71A0D,130,126,4,0.8025873486341526,PASS
2770A9FCBE08F09DB327B59B757DBB4B48CA5C1AABDA955F6206FF3A1BC9261E,118,138,20,0.2112995473337106,PASS
79D18B0C84A0DFB9FE52AE640FAD6814937953A1FA884264F5582183899D9DAC,133,123,10,0.5319710580974012,PASS
53FF57790AB1FC580F150BE106F5B9FDA4875E05808A15F810B11E29DB9B0A9A,130,126,4,0.8025873486341526,PASS
9713ED5A7F69355A3B58A88E1E3A8F10A4FECC6125E1FBD4E9A5DFCE46421E1,124,132,8,0.6170750774519738,PASS
4BDEE3EF5B03408343F5A77AF6474A8A3F20617D542C4D9F28AE6468F9C963B9,124,132,8,0.6170750774519738,PASS
3922BAAAE8C230F61BB77E7A1BCC1827F43479DC55FF122C2B6FD1ADFCB1592A,120,136,16,0.31731050786291404,PASS
540D6CFC78307FA36848C4FA854460EFF92DFFABA22152952DAA3520C64B776D,128,128,0,1.0,PASS
DB100A51A4D31A99FC79DDCA02806ECFEBFB9BE5C087EC818E573C87912BFFF6,121,135,14,0.38157390570502125,PASS
7B74D83AEF570D319B777959313F3A1A7924730221909E211CC09D1E186392ED,131,125,6,0.7076604666545525,PASS
5B57A601CFC6E6719A029BF45BC6CD1D14BD377A39A208CEE79C0497354529D2,128,128,0,1.0,PASS
6F95CFDED4F8CCF55F34423BF9892E29044AF31CB6852E02558559FA04301892,132,124,8,0.6170750774519738,PASS
B92CDFC8D4FDE94D7EA30A09797794EFAE3074D7C410DFDFB4E30EA91114A2CB,120,136,16,0.31731050786291404,PASS
3A186D36ED2712CEE4C6BD40CF77558881A01B0C60ADD96D90AA15C4E5A5A50F,135,121,14,0.38157390570502125,PASS
731C953849CE11B9BBAEFA3C080CDDD73A55EA2A8103B3B12EDFEE38516F2D4D,124,132,8,0.6170750774519738,PASS
578F06AF246D6AAE9F6FC1F5CA62C7B0DA61FA0BBD8668C66CEF5D881E5E9D90,119,137,18,0.2605890342736178,PASS
359D5D1826A525DF1FB0E18BB453103585F6EB9DC9BC545A67332978E1517E40,128,128,0,1.0,PASS
D67B7916AB75D6D0171B0B66368BA89E7B91A59EB6259C85797C4724E91C2215,126,130,4,0.8025873486341526,PASS
17C160FF624B1644069235EE00D994802AB7E16E38F116342450C1718C2C907E,146,110,36,0.024448945310089426,PASS
80D8FD8F830B88B4FD6DE39391FA149927A2C4F010B41642C8D55170F7FD5C20,134,122,12,0.4532547047537365,PASS
8674D3800C32134C91E49887A5305DA7E26FDD358BEB7F3F0F3148CE11B12132,134,122,12,0.4532547047537365,PASS
45D3186661AF51C6631A12C15ACDEA85827601B4E9F5D741B45C8694B26FE220,137,119,18,0.2605890342736178,PASS
C19A4EA31FFF9E27323433B75BCD8AEAE2B1459DBE7D2D69259AB32AFBAE6000,120,136,16,0.31731050786291404,PASS
BB11D8653DD784905579A75AC5A535A24E9C232379220CBD5FE723379880A35B,130,126,4,0.8025873486341526,PASS
9D855CA3694E1929062FDAC297AAFC5BF5C53131AC3CA957232483B6194D2766,130,126,4,0.8025873486341526,PASS
A38611E6A32315FE681E1DE6AF24EBB09F49FABFE0537BAA45EEC27CBA9C2BF3,117,139,22,0.16913144470267139,PASS
DEADC62AD26C972DDFBDB157760592CFEB152679AB18FECA6D2021B9D54A56D5,118,138,20,0.2112995473337106,PASS
93923AE6736B3A215389C4A42980B480F4F91A8EC1EFB66AB30320309EE715B,138,118,20,0.2112995473337106,PASS
4AB4C0660655A0467D6F3AC04D1E23F4AA87503865BF184AE263BA10AFFFF2AD,131,125,6,0.7076604666545525,PASS
94A57807A24296E8A52FCF535461647A81CC1518C16FB2387F8F4190482FCD16,138,118,20,0.2112995473337106,PASS
13D72B89F27C075544516C14597FA3BA0F1C1DDD71A19DCBC68443F7ACA57372,125,131,6,0.7076604666545525,PASS
9F4880FA24DDCB2F903FB121CB3015532AABD2EDE3E120EA1D4075CE623F9F5F,126,130,4,0.8025873486341526,PASS
BEF938FC50BF9AB64C0024F1AD3BBFE2F1FF7DD1626F8BA952DEDBF9E6197D65,107,149,42,0.008664896726025117,FAIL
F0F98B3F080C169E466F2AFD33AC5EAB4AF3AE551A6A8E463613C4083C56E6D2,128,128,0,1.0,PASS
649ACEA4A18B71A8761E921FFC153AB9466DE01DA1279CC02C3E55EC92E48C93,133,123,10,0.5319710580974012,PASS
ED74FE21A96042A75157677EA73316B2E661A8B239C1798ABAC61FDDBA61056E,124,132,8,0.6170750774519738,PASS
DAAD754A95A2F3A5454F7AE29ABBEFD45D078829CC6CFD904DDB2F9D75D151BD,115,141,26,0.10416255883043901,PASS
34EC210BCBD095A4488D2B24B137E659FA1ED1873E943031EF81FACA0119E16D,135,121,14,0.38157390570502125,PASS
6A5F9DB8EBE0C645AD6ED0D8355E01A644892A4E50F579B59EB2E22B7DE8F75A,122,134,12,0.4532547047537365,PASS
,256,0,256,1.2777508801076536e-57,FAIL
9C7CB6EAAEC1526ECC50C6A2EAC20D890F506C91C4A61A48EBD55082AF86951,140,116,24,0.13361440253771617,PASS
3578E9C51779E0C9DF83BF5BEA7A0E0962D752E23F254CC650DC6B93A7D9438C,122,134,12,0.4532547047537365,PASS
A683ACFD31127A260F1D0ED6B2314FB47CD82930A613F263DB2E25142268A7CC,134,122,12,0.4532547047537365,PASS
F88844D7079EB3578DD1F59CDE10455C2ED8368C87AADBBB23B80F54790BB030,129,127,2,0.9005235503397743,PASS
D262C095A492F2C5F0F98B05DCAA061B6991052800CDFFF8EDF59FF21C9D4DE1,129,127,2,0.9005235503397743,PASS
E77A0CE56B0D43A59A0B898261E177FDD43F3D0A9C9668608A6EE96939E4CF70,127,129,2,0.9005235503397743,PASS
E2EFF271B74EEFE3844C75FCE0A146C48176EC1CF56D78A32D2F9D3798806224,124,132,8,0.6170750774519738,PASS
38F35F26E8210B83166810BC5FFE1903AC30677552284AC3E4614D164D090128,145,111,34,0.03358661289689768,PASS
DD84043CC0BA58DD031B86F8236916DAC8743B02E4428630A0BA8CEE4BF96B75,138,118,20,0.2112995473337106,PASS
6466FA123E9F301373251D0BD53B4027F9D216A96320ECB3725E2211C4376976,133,123,10,0.5319710580974012,PASS
5D2F44185BF11C641DB0DA8BA31E5E156498DDD19085E63D0DD30683562EFAC0,134,122,12,0.4532547047537365,PASS
3EFCB5043AB9A61BDBAAE208093F675C3242A8638E21A42608A0BDA5C4547A4D,138,118,20,0.2112995473337106,PASS
B87271C8734DB046A9E385AC15AB45935EE687C2E01401B55C52D5AFD766B30D,131,125,6,0.7076604666545525,PASS
25CE6FD74CE428245FA98EF6442A0D6F849E384EB29363F173F702CE053A9B41,129,127,2,0.9005235503397743,PASS
B3F1555A4B891232C526ED73F0EF88D59AF3EF2216C00AACB4144C44505E48AA,136,120,16,0.31731050786291404,PASS
C25C5059662357DFF51E8C4F17B3BA841E96C5ADD4926212C65B9F09D6E567E,126,130,4,0.8025873486341526,PASS
F2FEE41C59E7AC6A40722FBC369D093D54B5F814D571FF980788AC088D2F788,129,127,2,0.9005235503397743,PASS
75A99F92A4C4A07C198DC8393E65FF52CDBF0893A3B0763167B5BCD46BEEFAD5,118,138,20,0.2112995473337106,PASS
12C083E47F3C3A3DD38A47BE207B1C3A17E6EE5C2782C892F6859186802CCFA5,133,123,10,0.5319710580974012,PASS
CAC912F243AD13DAE95BBD965337E4CE89D897B7FF603A1A72E35E0755E9054C,121,135,14,0.38157390570502125,PASS
FB8C7AC70D4E4B672D593F645E74F064565DFCBA612D1B765C5A296DEF7A9A9D,114,142,28,0.08011831372763423,PASS
B06C5EFB2E74F7708D3A805FDEDB2F0C0DEB01EC36083589E4AAE4319823A08C,132,124,8,0.6170750774519738,PASS
67F52BA8BCD1C6E218836DAAF962AAC0C0AEF1E6BEE43450CA333C8D73C072B7,127,129,2,0.9005235503397743,PASS
E7CF363AC33426D6FD44AEFBA1A397AEC136C9477D7C4CC5404B75BE2D1FB4E,118,138,20,0.2112995473337106,PASS
3CBB81A54043FBD608127059E2AA00652C5FA03DADD28EDF8EDC4CC5619534E9,135,121,14,0.38157390570502125,PASS
3BD54DF2ECEEFD1E5A3710FDBD827E5FBF105BE0C7AABC63C167A6F77B631D05,109,147,38,0.01754895019147673,PASS
FE5263650CD5E4E32DACBD86BD4CD07EE9B2F52DE608A57994E3865B676491AC,122,134,12,0.4532547047537365,PASS
4B1DEAD0A871B417371383EC9DE166A7EAE8061FB30287780F068875AF0BA5CE,130,126,4,0.8025873486341526,PASS
77229C1E2F87EA052862E588B52FD02BED107B86A8055EC6B34C01FFB5219D76,131,125,6,0.7076604666545525,PASS
E70348AB3140DE14DFACAEF0A4B139778D8AB7947A40302968F06A6883666C6D,135,121,14,0.38157390570502125,PASS
2B64100C502231867E22E2DE10CF92DFFFC612E330BD42B0632A38818A364196,144,112,32,0.04550026389635853,PASS
A6E2B568CC0BFB1E4C5F4211F6875C2710868FC35D89D46787B77664E42C6483,130,126,4,0.8025873486341526,PASS
1D101CE5BB92EACE166EA9BACA343DD2A5DC113A92EF78B0F997D4232D42CB24,128,128,0,1.0,PASS
1ABDBCA0598B6FB7BA69B75701BAEFA830EF2F2898DD863E91CABCB7E6B76A95,114,142,28,0.08011831372763423,PASS
5E62C35534A790EBA2D653A0BB5E928BA65C6F7580D6D83934AA552EF526DE5F,123,133,10,0.5319710580974012,PASS
D82E1235845270E8D585CFCE71124D03622C65C65E15426E074B2DBB5BD38106,139,117,22,0.16913144470267139,PASS
5558B9457BD4EB78CBA496FCF026463C5276EEF01796F2E00B0105F73D5ED9E4,123,133,10,0.5319710580974012,PASS
DB14F1C712AB3C88A0016B2CC5BBF3239F31B8E146C5A40CD93156FCE52DB5E3,129,127,2,0.9005235503397743,PASS
27DC3756C813DEDD7B45C5872CFE08E42895FF46F4EA726B4D579F7F4751D1F8,114,142,28,0.08011831372763423,PASS
894B422CC4A6E72055DF169DC630A7F29385E047F9DF2F546083C5ED9A5E7612,129,127,2,0.9005235503397743,PASS
FB208D09EA152B75E01B539676C6DCDCD871F309EED2C4218EAEDF42B647E0AC,126,130,4,0.8025873486341526,PASS
28E71F4C2F80D45A7E8197E7C9D990753DFE5CCFEAAB8A0B4DFB1710AFB74A87,118,138,20,0.2112995473337106,PASS
C5CE40001F2663024C1717866DCD19B1258B38899EA056441246C8F746C4390B,148,108,40,0.0124193306515523,PASS
8E7894384A1D6B1F986F4DB744AF4AAF16B98D9E634CCEF6FE03E6CB6008A612,126,130,4,0.8025873486341526,PASS
270D6CA48A96040444F4DEC105502C8869778F61E9A161DA04577B3A4404980B,149,107,42,0.008664896726025117,FAIL
B5E6DAF239B9B1A9204E5D7A8B7EC8DA479DE7F6627A3401F4BCD98829ABADEF,116,140,24,0.13361440253771617,PASS
9A0359EE6CE64416CCA1AC872CD83847CE1AB0F0FFB90CCA80E6DB86477F539A,129,127,2,0.9005235503397743,PASS
1F800881E0D812C8959D17792911FA48FF35F93498BE4F05C60C73F315F0C7A4,135,121,14,0.38157390570502125,PASS
FB6EE794C37949BBD692952883BE361A057676BD7445AB80CF318B2444464363,129,127,2,0.9005235503397743,PASS
B2E799C459CC08C6ADA30DF6FCB2FC373A02D7D924B9EC5B01C1DC0761FB2862,127,129,2,0.9005235503397743,PASS
8255F1E5102F6D374F685AA22BAD0AB008EFBDF659CD259966E992BD68CC2928,129,127,2,0.9005235503397743,PASS
C53BACA37F62896D000441C7667B68E9BC5B70F092B4B9DF1BCAAEFA1EE53A6C,123,133,10,0.5319710580974012,PASS
5B45BA9807FE5FF692C0E605046E7659D4E5ECB79105AFC4A1A790A2F393E96F,123,133,10,0.5319710580974012,PASS
EBA133CF65CAFAB875FCF5FB0E73A0795A0E66FB3420E590934544F4637769A4,120,136,16,0.31731050786291404,PASS
23C5EC0617BD39183ED97C9F2C47D6D7F8C74A14D8AC4AC4152428A7ADFD97AB,124,132,8,0.6170750774519738,PASS
5955D91CB8EFC6C2789F1D7EF29C5D26D882BA2CE143CDF15F094666BF041396,124,132,8,0.6170750774519738,PASS
BA5E122C00E16D28152B5009B31EF3FCF8614D968EC7071D89B4B31E6F60E7A,134,122,12,0.4532547047537365,PASS
1EC006B118F23E028DAF82E355113D05F76362EA938F8A59C9FAAB0F8997C624,133,123,10,0.5319710580974012,PASS
16F900A542BF3E059836EA7E9B85590FEE466B48406C3487B75C4B4106B3E4A9,134,122,12,0.4532547047537365,PASS
BF8449447E7F7E8E02591F552DE556FCD895E01268E4FE5F6657C1CDE54B37E4,118,138,20,0.2112995473337106,PASS
31AC459CDBFAE611DD97D0CBA45CD20CF0F6E9D9FE97B716DBBD80B88AF34F77,113,143,30,0.060792723530522785,PASS
35D8C835596272295EA5E91EC7BF550FC1F6B760D935F478D985195310AC9DEB,123,133,10,0.5319710580974012,PASS
5F56E6398E5313D776E2C5BB4457C0AECC9B7EA13D87319742544F827AEBE09B,121,135,14,0.38157390570502125,PASS
7FC5550BE3FBD5758D680F3A0796CC5B3254C92B5BE2CDED5F3046597D4C7EBA,116,140,24,0.13361440253771617,PASS
EDA4CADFE1E8AACE4D0CEC9279F69C8AC78FB3E016CA4888A70BB92A50FFD1E7,122,134,12,0.4532547047537365,PASS
D400B682E15503A7CD720973FB860DB8387AA83D85093490A1D7F53341C9B190,140,116,24,0.13361440253771617,PASS
5EEF7CF958712CA67676C954150984777BF3C457CCC026A1F3F09534E1246733,125,131,6,0.7076604666545525,PASS
82BB116B972549FB2E1673CE4ADCF6DA0F133276622CAE86FE1536203016DE56,128,128,0,1.0,PASS
AF55DCF150985996F24E31467E85BA64D7A5C199235C7203632569409F14A815,135,121,14,0.38157390570502125,PASS
684305BF01C77671BA67D5BDA7F4DA9E132D21A8C31AF3E06E8C9D43F668F0E0,125,131,6,0.7076604666545525,PASS
7EBAC74490123591253D91A647D74E5887B5826DB5804A5A05EDE429AE390724,137,119,18,0.2605890342736178,PASS
68ACA4880CEB00A3F4DB95CB5BEC28F8E7178334E7B74765C976337424360E16,130,126,4,0.8025873486341526,PASS
10A067DAFE5BC57FBC58596E337510185475601886126D52BC1E3007D76685FF,131,125,6,0.7076604666545525,PASS
29DEDBA2B66943A1D2D50AC57AC34E6C1155DD592E4A08ADD5E3841CBD7CF1AE,126,130,4,0.8025873486341526,PASS
EE89A55ADC54DF37BA83CE59276285D8F48FDB455E6DE510BD7A2028FC9F5099,121,135,14,0.38157390570502125,PASS
54DBEDCFB2C5E040E8AF1D235BB004EC5A48884F53F4D43E83CDE5E80304ED,135,121,14,0.38157390570502125,PASS
9C12C61E90D0217AB40165F20C656240AFCD69D2A4CA0D1E0F18D97EBC1DC092,142,114,28,0.08011831372763423,PASS
9043554F71E51C349A833B87A6D7B7070B89494371775081A383268B1D670167,137,119,18,0.2605890342736178,PASS
279F36BC116F9E7FED8D8909102F9BE4061E97BBAEB6CA8342BE362B801B1437,125,131,6,0.7076604666545525,PASS
4BCDEB5BEC60E3F3B717F3983D0E29E02D023F2C8021C6CF0CDC2A988664A429,133,123,10,0.5319710580974012,PASS
E0C4B60B06D9DA3E212819FFC1B2D511D0804EE8F7535F7820256716E544F7EF,130,126,4,0.8025873486341526,PASS
C7F25E186A0BBEDABFDAACC49A9118A25DF4B5ECD4F8D31653AFC9A878799EA2,119,137,18,0.2605890342736178,PASS
BBBBCEF0B70D8EC288B2EF39ECA971170A55F20684D1BB8DDD55C3B69C568092,125,131,6,0.7076604666545525,PASS
FC4E55696969A1C78A852567D231D0408EAAC620CDC2E259C777CF175C7F49FF,125,131,6,0.7076604666545525,PASS
5C814380DE28276AB27448E69086613354B17C4F99F0627A5E555C23C716661F,137,119,18,0.2605890342736178,PASS
D2312191C0F96EE9E5F8D8EB4D8E56A6A2D99C7356C267FEB01F1B6A404E13A5,126,130,4,0.8025873486341526,PASS
F363A17192A0BC44AE09FFE64F573FC318A5F09C0D3DCA97377839492C7AF68F,121,135,14,0.38157390570502125,PASS
A7B01CB929335B379119018EC2A0A4D474A0A8CB319BB970D06BFADA78AD9BA9,133,123,10,0.5319710580974012,PASS
A2CBF940A4520BEA44D0DBF7E0D42A865AE0C184F7C5D673408BEE8624C3BD02,136,120,16,0.31731050786291404,PASS
B44053A5CA3C22D52D5E38BAA026A76CD93407647BEBAA8BD24BE1DCDFC8755B,126,130,4,0.8025873486341526,PASS
574708784A7FEC39D0381623D9F7444C39DD7738C2F11C76D2E208C6FD1833F9,127,129,2,0.9005235503397743,PASS
9396E8E52C94BC5408D1611D2ED18A33D575AD6782C4884BB42A930D1E4587F6,136,120,16,0.31731050786291404,PASS
150A92FA43215A13BE8FC6390246B4E4C081D2B3488EAD1CD55F0E86C9EE404C,141,115,26,0.10416255883043901,PASS
200A473FA916E483A7E872A56172617C68A6BA79C6E244A7C4F44FC712E6C51E,132,124,8,0.6170750774519738,PASS
BF0BA52F9E32CA9EEDEC036B5B2A9C6D0153808C7A2C1F85028F5ED4718D678,131,125,6,0.7076604666545525,PASS
72D959F121CF48F065E8CD6734EBCB5516A4E4D2AA78753F2264C8FB870BA26A,126,130,4,0.8025873486341526,PASS
F3A78967F779997D00CAAA002B9FFB1189130ACEFA88FCF77B7F37F58A93B2A7,114,142,28,0.08011831372763423,PASS
17D11E43DCD67CC505CB5474E826D5CBE40874E9EE9CE48C93694983787B75DA,126,130,4,0.8025873486341526,PASS
2A8CBF19716B28D17BB04FE078B376B84666C241522D115768278ED3D8A191E3,133,123,10,0.5319710580974012,PASS
3EEC571982B32B7B3349C7AD527AB2B9518B38AE274EADACCDE7A619C5F69DC3,118,138,20,0.2112995473337106,PASS
1B053627D65864D565BC1208839F09DC3EEC6ADB815B921501216CB7163AA69F,135,121,14,0.38157390570502125,PASS
4C9B163ECB6F04A8C69CE0451B392826A161111F2420FBF17F61708757F866C3,135,121,14,0.38157390570502125,PASS
64DF2FF407BF9CE890FDF3FFED61BE93B0DD591677FCEF01B533C1AEEE831E93,106,150,44,0.005959526470109114,FAIL
DC5BD38249EBCE727D765682B8EE3680C13502424E35F57FB380CD8F522B1730,129,127,2,0.9005235503397743,PASS
CA41D959AD5140FFF4E8BA3B446BC075015AC09F4032D049848DE149B4CB1936,139,117,22,0.16913144470267139,PASS
51B1A764FA2002F5593F0B2CBC6A36A2640B012817AAFF8388424FDDD71B1C70,136,120,16,0.31731050786291404,PASS
B03F385B70ADB4C374EB22E2A82ADC85E277211F32B9F86B7CF1CADE28D19CB0,125,131,6,0.7076604666545525,PASS
AF96B3A4631D02900D56A04885C7AF4788086C9CC6899A1EAC085BFF7DB45518,138,118,20,0.2112995473337106,PASS
9189D8DD98275EA4BBE1F1A581BF8E143758124A186B04B7EA7A7AED91A01F58,130,126,4,0.8025873486341526,PASS
F5B7B8F964DF10FDC6FD03929B3A80C0898F071A1BFFD9C461EBAD79058B7C61,121,135,14,0.38157390570502125,PASS
EBF9176B7FB1941096775513F859D890364A721394C92625339C645A6E031407,134,122,12,0.4532547047537365,PASS
7F34F78378422369506FE528D2689D8CE78F4F213C95423A2831C235A7FEC5D1,129,127,2,0.9005235503397743,PASS
2448B85CBBC8AF8EE2EA70A6D5E3FB01632249F208226672141F21840D44174E,142,114,28,0.08011831372763423,PASS
B238B11ED795A848EEE8043CE2E67C12EB4817A07A4976765F538D24A956002B,135,121,14,0.38157390570502125,PASS
D576EA82D43B146513708F976BBB22304CC0D52CC30249BF491FB053FC1E47B4,132,124,8,0.6170750774519738,PASS
80E47749D007859CF7D81E79D5F712545AA5D21C12E09FD913B1B578211979BC,130,126,4,0.8025873486341526,PASS
FC3D3E81B02510608C5CD2F97DCB95A56B6CDB484BFEAC70761C14B5050D735D,128,128,0,1.0,PASS
6520A422E6A92E6511C6C8A8DFA5A40E06B689A23EF6941C31A2F554AB78CBDE,135,121,14,0.38157390570502125,PASS
5EA498A7B51F3D0BA58398A55B840EBCFCE37255A3075489BF357795C621058,131,125,6,0.7076604666545525,PASS
DF61C1A5970EA124D55331F6DE086C29A060BCD2962993B0283D65BD5EC779B6,130,126,4,0.8025873486341526,PASS
4B6C4C7FE4BA890162C673A1D120A69C3B660490537DBF8EFE64CC69C8F80E5F,129,127,2,0.9005235503397743,PASS
C941B1A339F6B845D96DE9B3D1058F3BF97F0026C3E8DB02533A9C3D6B6D7051,125,131,6,0.7076604666545525,PASS
F63FA8A95B31FD85EAF7F792CAC10812B7E7B9B0A8FE5322B0B3C6BD7183D06,121,135,14,0.38157390570502125,PASS
166C8CEF75F945FE5CB5AE0311D6C22D27BA83755114DB3087075F3E3AAEDA23,123,133,10,0.5319710580974012,PASS
EEB82AD36E4CD52B6561EE4E061EC936F4D0C709248E8C552A6397FA3C69FD20,128,128,0,1.0,PASS
43489F0FC6C77FAE9E03C191D0F5DCB2914921A4599C114574B185F20BCA88C9,136,120,16,0.31731050786291404,PASS
F9FF7678A6AB7A87F6E9517D753487AF2250D714CDD9BEC9924AB27CD39B4D31,113,143,30,0.060792723530522785,PASS
4FA8CD2777A3C48FECCDA637F243DF4CF7D0CA608A042B848168A80ACDC697CE,129,127,2,0.9005235503397743,PASS
305AD073C037388324B9463C431167A2AEEC512586B4728E08F81D82F61243F5,142,114,28,0.08011831372763423,PASS
2716954BF0952D8BBF9FF42B0CC38713DC8CCC22CBE1939351D4616D396A8486,131,125,6,0.7076604666545525,PASS
11FA3571B1DED5C9F4C657385B635EBFD82991588C145CCE9DA002F35550A2C,131,125,6,0.7076604666545525,PASS
EC5B5EDE89375CC9412B9C2C79F7F2A9531F5CB44DA03ED8610864DC2226DE54,127,129,2,0.9005235503397743,PASS
DD107B775400117527064667BFC3536C8923D70D23816488B296861F1563E68A,138,118,20,0.2112995473337106,PASS
3C3F004A73086E9135F4E99DD56805E077F001617505F78780C0AE43DF40410A,142,114,28,0.08011831372763423,PASS
7E1866F1D11A68418F6AAB345802A3C261A04DB73A09C1721A0D5C6A48B28A98,145,111,34,0.03358661289689768,PASS
7A5A8DB15EFD9FF40F300D826CB90D00DE7CC7F796B2AE1A7A0FFC04BC0ACD87,122,134,12,0.4532547047537365,PASS
1E0CF51111D74C89202FC63CE0D97340B7F864C1CAA36C2D9C6B32B78578254E,135,121,14,0.38157390570502125,PASS
402C293C94CD0321ED36CE2ACD55F17A619DE3ED8C3145948A823C3200EBC83D,139,117,22,0.16913144470267139,PASS
86A3140F83ABD28C85F4F560287FDA6C33424B1002E1D87935F432EC60969EEF,134,122,12,0.4532547047537365,PASS
B749B17D0012CD2FFAEF37A2626DF8E402F81BFEC52BD43DF0FC1212CCC72C84,125,131,6,0.7076604666545525,PASS
18D334D0C799419BD9E6FDB4A2EEE3F0148607AC5050F24CD57DFA6EDBC4DA5,126,130,4,0.8025873486341526,PASS
8093E186AC1164B8F91F3E1784CB4AEEAAF78265CA38C7BC74D5A3BE63182BBC,127,129,2,0.9005235503397743,PASS
7C94FC6F1E4442E24A96E1B87410C94C6DF7D23382AD8CE0F14BB368D5A8CF9D,128,128,0,1.0,PASS
FE676CBA42D1ACF5C0B0343F5D69425A554E0034F9B9712CF7F917A6E83B2F20,125,131,6,0.7076604666545525,PASS
56B4AE9EF45A0384FC44614DF091D68B5326F35EB57DB1A104B53C306F5989FF,125,131,6,0.7076604666545525,PASS
96DA68F2724ECB0210092C839796A27AD18DC3A102884B3A42EE489127DE6284,145,111,34,0.03358661289689768,PASS
9ACE10C877FB46493C83106F30AE8596A0498061213C0409013A973F032096AC,151,105,46,0.0040402749798920095,FAIL
4942BC2391399F0D3671527A9231F805407376C5E8750488082F0541C55B41C6,146,110,36,0.024448945310089426,PASS
AC377AF82B7BAC1EBAC145F3982D2E5501E6D0E3EB1167D1B6DBA96C87334F5F,118,138,20,0.2112995473337106,PASS
C4DEA1969DBDA49725F37833312F7AE8ED12723E85DC51802DCB4ECB74EDDE7D,118,138,20,0.2112995473337106,PASS
C143CCC2BCA677A30167657F4DEEE1AE4AA7547AAECD5BE33C60AEE6CCB6F871,118,138,20,0.2112995473337106,PASS
4008782AA36D27A1A63633748A3759FC0EC6BF92F43EAC60D8D850782FFF3419,131,125,6,0.7076604666545525,PASS
E13DE75191C0FA622F02DE27E4ED132949CE992388ECBABDE7A663394C291B52,128,128,0,1.0,PASS
95254805DDB39265B43F40041943097102D039A3BC74D4A5202C3B465E85A771,145,111,34,0.03358661289689768,PASS
B934B756D3397698BC7EC9D576725EC30A02789027F1679FA471B1C00ECF9E83,124,132,8,0.6170750774519738,PASS
353FACA58C42C13A6AE0F0D8B9245824E5A6637C37E79D3DE012DA320E9BEFFE,125,131,6,0.7076604666545525,PASS
F9B1C83D3385F5C8F855C5F35BFF425AF8D3F643810719018A72080A791362F8,130,126,4,0.8025873486341526,PASS
2D0C946693AA36CB36CDAF36E974ADEF71EC8F3B63AC2C4EAC8450D7A1024F47,125,131,6,0.7076604666545525,PASS
42BECC5AACFA8B6BBA40D60254A15E87E3E5D8F261C8A1BC79AD9B0109C8B447,132,124,8,0.6170750774519738,PASS
9FF16DB9351C23ADCB26FEB79C93899FF8E3F065DD8465894E0B9D2953FC68EE,115,141,26,0.10416255883043901,PASS
7586DF9A26522C46658119CF153B520335E25DE59B4DD56D71E42CB1FA041953,131,125,6,0.7076604666545525,PASS
2BDAD3FD12D7D533F63A17A3D17E3FA2898D5AED806CEFCCC1EBA5158496499F,117,139,22,0.16913144470267139,PASS
461AAFC1681785A113476DB03C92B69FD346DE6AB294201F392E84F2E3E0B950,134,122,12,0.4532547047537365,PASS
4D593AB515764D67A9886B27B43ED7D2CAFAAA14B2E228CBDBA46B18BF8A61C1,125,131,6,0.7076604666545525,PASS
D71D5B2ED186C1B5FCDA0039E63172E83B7C7939EAE2B37072E6D8054B964C13,126,130,4,0.8025873486341526,PASS
D34BC923A38782C5F1384F4A2FA8BB33AAA35E80D17E52B856C7A94A27FCC68D,127,129,2,0.9005235503397743,PASS
CFD76C40F9006BA20BD0287DC3A60EC93FFE645117B7E2B57C03AC834515DACE,128,128,0,1.0,PASS
EB1E47C1BFC4BF5EE30E2FFA9B038D6BB8F191F8FF043707754C39DCDEBF391A,111,145,34,0.03358661289689768,PASS
D01FEB5ECDE4031BC8F4934294BEBF476602881149CE00EFCD9CFA77EA687B1C,126,130,4,0.8025873486341526,PASS
2B151CF5D3BB7836F42711383F9745E6B3C9D8D17217DCDA9A2DA235ADF4B993,119,137,18,0.2605890342736178,PASS
4B4EC7DFF2C85182957B6452BB7F8D90127511232297F6BD15352F9B2B31A444,128,128,0,1.0,PASS
16CF5B8B89266EC94E3040F7B8FBEA920BF594F9183AC60F6DE49F9B5457BB97,119,137,18,0.2605890342736178,PASS
1C1444A6C21AAED353A5A1CDE469B6D8C6D2EB9ED19841B0D5677FD6340568CA,131,125,6,0.7076604666545525,PASS
AB55B5BBDE95EBFE491B754AE954B5444DB40D23F513018D7F1532BE62229FB4,121,135,14,0.38157390570502125,PASS
B9D63F6583CC1E4377310B4BA364DAA8BDD8B32B090D6FFD0E7E50D38904C865,127,129,2,0.9005235503397743,PASS
104A447806F2912E27B33C074F61160DE5EE01076710DF3182BDECA21D004897,144,112,32,0.04550026389635853,PASS
1EBA4AB3163BFF9AA6995BDD9BA80F37E8609A08525D90C99C1D32026ED01664,132,124,8,0.6170750774519738,PASS
D4D3BDDD3ABFD517D168967278D807244F65F39FE84BA06EAD57E191701BEC44,120,136,16,0.31731050786291404,PASS
C6977B8359A0744D6B6425D0FCF538E6FAE9DAFB5592ADF6E435ACD97ABF0572,114,142,28,0.08011831372763423,PASS
78CF05D016BFE4E3CDF7CEB505794B1EAA8FAA7FB37BAA649989109A78068D1E,121,135,14,0.38157390570502125,PASS
5B56C209EE1448282150623BAC5F715005A1A81303FA2EFA4F6876448DE5A8EB,140,116,24,0.13361440253771617,PASS
B11E313AF3657063DFF117596A74931640BCFA97EFD553518FD7B7DCFE75B304,113,143,30,0.060792723530522785,PASS
12F833392CBFAD63112685E57EC9883509E28904627D9A61E4369642DCCABAC9,135,121,14,0.38157390570502125,PASS
EC3F661C53E99FB58EE7DD8EA759C707C101DF66592E329E3942B7FB23B894A4,118,138,20,0.2112995473337106,PASS
78AF0F42ABF762F12B046B82C5F570F9BE6983E71393B85F8D4BB3E50F94D950,121,135,14,0.38157390570502125,PASS
296578B2FF68C19B92EF1C3340BA8769B3CA13E1CA161D486ED3D34B2BAC964D,127,129,2,0.9005235503397743,PASS
BFAB6084DAA36D96D84883114E63C120B5F7935D4AAB65074C45CD9EDBF741FB,125,131,6,0.7076604666545525,PASS
FF04E5F7FC20B990708C19BB2BEF8B284E911E762CF6B5A8EAAFD9F1F2D84592,120,136,16,0.31731050786291404,PASS
802535381824681DEA9808A991AF1CB5B8A86BBC155BFCF0CD8C6570593C8F5F,135,121,14,0.38157390570502125,PASS
183E3B3609CBC638EDD76E00E8A427CE6718710045F2683CF8FA0305EB86E008,139,117,22,0.16913144470267139,PASS
97836D089792D211C6A8EAB1749A9E7EAC1B46C6197ADE0B05A75637894E6562,131,125,6,0.7076604666545525,PASS
E085D77974A87F105C37AFDAF0ED243D51E291412A236F684A1B4BC1C8A0ADDD,130,126,4,0.8025873486341526,PASS
A132513B726A6FBE5992BD75B1EEE1FD89BAC6149C989515464CB1E47A932A40,128,128,0,1.0,PASS
B18EB8B10FDDDBEF1935C4D71A2FB1E59913F1F448E4497B5CD89C4CADE30BF6,118,138,20,0.2112995473337106,PASS
5372D8044E81C7A26C7A1925F79BDAE92DBF69DB118ABFD85FFDEFA902720076,121,135,14,0.38157390570502125,PASS
E1F8D5859EEC731E025D2E460C045F2BB0D5D3B2E672B4709B9E09EF5B594706,127,129,2,0.9005235503397743,PASS
970DE0F4DA1C5A36EAEA5915D470DF7CAE442AF75D132C2DE51B74FCC5B01531,124,132,8,0.6170750774519738,PASS
B649670DD9DBDD022421A402A8BB0DA3590B2F05C48DA5469FE5D3F5B3522C03,135,121,14,0.38157390570502125,PASS
DFDBCB6AFB863E37864660ABF5B5A91F420919F6279782C2F24C123F58FCA1C9,122,134,12,0.4532547047537365,PASS
385F5BB266D1ECF324DBBD7F88D5D53B00EA8DDAA81016FE0F7AA803F9691760,123,133,10,0.5319710580974012,PASS
3F8DFA92D812A51E25A7242298F3E129B2229F1C03E2F5AFAF678BE99F43C107,127,129,2,0.9005235503397743,PASS
80C3C7BAE0ADEB0A20D8F22AB010AA92883E412CA690A43F8521B900ACC54D57,147,109,38,0.01754895019147673,PASS
56B57FC97D99C152DF108A8BD76CFD74E45E5226D7457AE64AA2B0822FB4C5CE,121,135,14,0.38157390570502125,PASS
F4DC2046CB311DEE4C69BB16DEB3060A15B1AB97F9A4F6DD02FAFD11CB6F8E76,119,137,18,0.2605890342736178,PASS
36EEC15CF7189AC0736587EE0966E99C21A80AA73373A1546B958368958C6C22,135,121,14,0.38157390570502125,PASS
F28B5C86F252BCC8D825396A93E1F4C523A519D757FA30CBE178DDA40C3A880E,130,126,4,0.8025873486341526,PASS
31D208D6233643BF9AA3EFF452AAB04574CA6956A19ED1B9522F768E9972B831,128,128,0,1.0,PASS
F4B4E02E565A516339DEEF1877B2E0110198AAAB942F494F82E732343267A32F,131,125,6,0.7076604666545525,PASS
21866DD69B2C9F17D5659FDDC21541B5354C04618AF1C7B1D3BB9C08548FB9F3,126,130,4,0.8025873486341526,PASS
10DE9BC1E2FF486EC0B72508A7D36D1EDB5D0224A8FB916CF4700EEDBA453BF2,125,131,6,0.7076604666545525,PASS
6519FF3D5886D7FACC7706E001986FD1815843F1272C51F277B8AC155471AA33,129,127,2,0.9005235503397743,PASS
40090F43CDCE6DCB9D689197117648D97ACA3B68520A52E47E6D7FD389303C31,132,124,8,0.6170750774519738,PASS
A03AAD82D1D0251C4004B6DAA387A3371F5A000C9CDF295ED019131CD5E0DF30,142,114,28,0.08011831372763423,PASS
8DA26EFEE89103A2CD37F314284C13ABBCABB3B770F2A05B3AE171D69339A922,127,129,2,0.9005235503397743,PASS
6012A164E89A303873AFC0A33761E1AC8E4446CDA9AE7FC13BED57DB30873E80,133,123,10,0.5319710580974012,PASS
D3BC0E1EA6C9F34456ADEC55C7A6A2B3FEBA1BBE3D792AE987AA4D1A87127E23,118,138,20,0.2112995473337106,PASS
D2D6046D9BFFB4B950525E287E9F249E13BE4EDD572713ACE5190528F499E099,125,131,6,0.7076604666545525,PASS
60DAC5BFFD5F1A4DBE7CAADEC08D717A6C7E2C898278C7BF734F35B8386BEBAD,111,145,34,0.03358661289689768,PASS
5C10BDA7DF26D944BE9FE03F823AAF51E52370FAF07E09492272C3E2AFE61CE4,123,133,10,0.5319710580974012,PASS
583F2BAF04822CD41653ECB91D8C8BDE7AA8CE1ED82A5EF30CC51B8A1C6115B2,132,124,8,0.6170750774519738,PASS
27BCD9326B00AFC776F242C2D620D860FA9571F8B3B42D23E71C22A13A3E8FCC,129,127,2,0.9005235503397743,PASS
E449867856B588E8067CDACF9F67EBBD301DC784D7FC73E355CC8239FEBF18A0,119,137,18,0.2605890342736178,PASS
A1B6F0BC4B42C190C664F8D9B555EEE73847309381741C62DB93EC5DF7C5B9BA,124,132,8,0.6170750774519738,PASS
6C3A0D9029C93AF57A8ABC9A9DA472ADD67DB38BD5283FCA8502E8DCCFCAF054,125,131,6,0.7076604666545525,PASS
A3C5ADE96E3B936BF5F0F1BA4EF1166898CC97A55162C7329EFA0A285691F30E,123,133,10,0.5319710580974012,PASS
9CFEB5DA9BCB56614EBFB0875DFF483FF2A7768FB380B4948D7FB8D89643BA5B,110,146,36,0.024448945310089426,PASS
5CB886F0F78AA12FA43894DE0796E5759B784FB83E5DDA980BD98C348699FC2,127,129,2,0.9005235503397743,PASS
346635F75A7E910E3D194FB9D5B7D15B1D264065B4224DE2ECC4A2F452CDC626,127,129,2,0.9005235503397743,PASS
8C868D598941B7D678AE0599B9D1456DF1ADFD6ADCA2B20E1EB14FE4A92A2ABE,125,131,6,0.7076604666545525,PASS
71322AD94575C08AD8E80166B5C1ABA6C06F44B27FF7266C8D477FC58D363015,131,125,6,0.7076604666545525,PASS
46FFBF36BDBE568463BB786DA1BE018C49C71E5AD3309D60B6F079D7937F1AA,118,138,20,0.2112995473337106,PASS
391D464D9ED2F0DA4862A58F18580BAB815312B0CB946D357C353D5816A08346,140,116,24,0.13361440253771617,PASS
9642630B0AA1A88ABD8527818AED804C42659E1B9D2BDAA08421D5E783EE37F4,139,117,22,0.16913144470267139,PASS
51B85E37AFBAF2D94A465270E3790313E560F9967C1DD4B4EE68503587B092C6,128,128,0,1.0,PASS
58E4733D72EA8F5E60C76F650D728FB97FEBD9C890BC2E099A0F6E00A081AFCD,124,132,8,0.6170750774519738,PASS
A0D85980F8BE5A8DF54A28E00793F3FB21700F82E0A5450641FDEDC6D0ABEEFC,130,126,4,0.8025873486341526,PASS
575065C543FCD3056F8D18534175974164F5D1C3A0AC0484EFD460C0B6CB5FEE,132,124,8,0.6170750774519738,PASS
4B0187EAC54EF1B9603B194E77D68B3F39B65BBAEF781B6ACBD34E12574C8317,120,136,16,0.31731050786291404,PASS
A9BD2E8624E331A40534FDF64B7B085E01F950138B036FA9A73CED23BA10AA3,134,122,12,0.4532547047537365,PASS
2EF8AAA4E111CB221A6E131F2D14EA3E958CE18BE44314E124606AA4D0BDABC6,138,118,20,0.2112995473337106,PASS
8AC9AD745734EE7D23E16E61D0C6CA690EE0E1799EE27EE32B0BFB0F3558C5F1,121,135,14,0.38157390570502125,PASS
A7D276A11280A65CB172850DE42406C2D5F769F9FCE2182D9C163E2AAE033A7F,132,124,8,0.6170750774519738,PASS
C1535D36E0D5D85BA07CFFF9238ED9EC93D8DB5E14A1BD6503FA57DF660217A4,119,137,18,0.2605890342736178,PASS
245F301E94416DCDA7B637545D5A03D2B218515061DA12C7D4C5F5D9CDF57F7B,125,131,6,0.7076604666545525,PASS
B5B3ABEC117A3AEA61D8AE226A75FD4A86EB964620F63768B4DACC1BFC7D8F97,117,139,22,0.16913144470267139,PASS
37A24B2C13943CE75EC9A708CBF6D49A6796233808C0B71A0D5FDB6831247CF5,130,126,4,0.8025873486341526,PASS
7E35B371249E44C28249BC4955B345C86B4C474CD9905FEDFB1C1C8E95819612,134,122,12,0.4532547047537365,PASS
E13CF7423AE0E38D6C5B130D4A093F6E4BEDFCA90B49BEED2782E511FE9A93CC,122,134,12,0.4532547047537365,PASS
DA27B1E6048B1B6FE642AF11627C2358731A7BB17A8A655E25F5ED33922574D6,125,131,6,0.7076604666545525,PASS
270750A1874B8EE06124CB153EDCD065AF21F1B51B1A8CFE858409A6DBD56987,134,122,12,0.4532547047537365,PASS
1599BB98FA0F03B4A26D16112D78E23B963C08D144547045270D1AA3DD81CCFC,138,118,20,0.2112995473337106,PASS
286D21DDFE2C7ECB4087EA7565C24E09F17EA0C75301C521CF97A7B816FFBCE9,122,134,12,0.4532547047537365,PASS
1929D8F5D9C44B2BFBB56FCBAA1D00E124249BC4BB94893EB1CD4289A376568A,130,126,4,0.8025873486341526,PASS
80B2F2FD58C4F3DC04E930EB833F364B9B6F74DC53BBAD13AAD31B80C299F0CF,122,134,12,0.4532547047537365,PASS
91FBA30DAE11C8C65AABB72AA4E5C4C62064FB09E0C3ED96D5B0EA4BD015ABF8,129,127,2,0.9005235503397743,PASS
62633DF32993443D0A6C4694D2FC83583CCF66B0A87771330616F5693682AA2F,132,124,8,0.6170750774519738,PASS
9E8607790AE8FD5FB8EEE1ABC179508CF773950CD9AAC7580D9CD2222C17F555,124,132,8,0.6170750774519738,PASS
B54B6E6F1E812D5923FFD9A9B6BA6EBE97E18C2AAF2EEB81E39F5FF8ADC404F7,110,146,36,0.024448945310089426,PASS
1520DEFE58BC9B9DF7161C5155A6910BF423F24AF24BBD21D619C70E4450240B,133,123,10,0.5319710580974012,PASS
8E68E6ACE47B834E34AA2EEE6CAF2D1584A51CD0F313D26862A74AF263584A81,133,123,10,0.5319710580974012,PASS
E251031CBCAA33E9734C42CDBC95AC23BC9F33419BC7E0F284C3946E15915A13,133,123,10,0.5319710580974012,PASS
7DE1512DE4374EE88FC27CBDA155B03ED30BD55DE9ED8982BD0D622A1A2608A,130,126,4,0.8025873486341526,PASS
27459FCA4490F488E4FF90B886449733314037B7BE8F53ACDAF0B0313BA9B8FD,127,129,2,0.9005235503397743,PASS
658F94234CAD93652BF9661E902584467CA54B8628F2CBC751A0B07E43D1B9E8,134,122,12,0.4532547047537365,PASS
7C97E0717135090DD85EA8DB367ABB850A5A71EF74EF2B1B193314F34E7E3FB0,120,136,16,0.31731050786291404,PASS
C428D202B003631A0254D36437ACEC099BDF492012523E408AB30620D8A47722,153,103,50,0.0017780505982168669,FAIL
B157FC2D225444FF866346260C3F988D6B1598644FFE0F1C39131E9A7BBE006A,130,126,4,0.8025873486341526,PASS
9F4728FD18AED849F0EC67C909C1804A531E2B56192A5E57E19132761D510E4C,136,120,16,0.31731050786291404,PASS
107A64F6DA8601EABE7C13F44F292608BECC712718D380C67AD2402A795A2899,138,118,20,0.2112995473337106,PASS
962ED8A21D532285FC92C19CB2F371C9C37F39D533C9E4D8D7ACEB7008FEAAD5,122,134,12,0.4532547047537365,PASS
A0B9B6559A1C2DD00F725DEE9E495C06ACC548D7D785AFD652BC7CE977195054,125,131,6,0.7076604666545525,PASS
E13788CAA2877CCD5B669B00623601BCF1EC43E90D7D6D5E4EE73B87C460978A,128,128,0,1.0,PASS
67F5EE322F1EDDCE1672C3EE5D4DB44F9FCFA0F87CF769CA21E5C2FE7CD0C090,113,143,30,0.060792723530522785,PASS
E283A2787B934EDA05991350DEE5416A88EFE9C7A84E51C36AFEAEB5473566E0,126,130,4,0.8025873486341526,PASS
51DAAC52E5F3F8CC0C7B217ED7238A66C10CD853E448D48C0FB94044483DA958,137,119,18,0.2605890342736178,PASS
3834462B4BC0E57F88FC50B365D62531880AA00241E3365DE94E09974B37D60E,139,117,22,0.16913144470267139,PASS
375CE9315A39862DF72DBD1F52E3A30179C1087F850BEF66A3EA6E565E93C6CC,121,135,14,0.38157390570502125,PASS
4B4AC8001617D448CD03B864ADFEA01F20853A8EEED9AAE66A1DE429C22A7176,138,118,20,0.2112995473337106,PASS
DE092118ECDCF1C43EFF594781592495096B4184D39F8076E7DE24BD3DBD716E,125,131,6,0.7076604666545525,PASS
78BBE7551651291B7D122FD138DC1DFBA7EBDBA70AE6CCBFB844A43FF805F8A2,117,139,22,0.16913144470267139,PASS
7D7BB9E90E65830E77780121EB49C6F9A80B361B7CB6771AE5C6111163BCEB06,126,130,4,0.8025873486341526,PASS
12C31C423F523F953AB35C9758E961582E804C9ECFEADCA021E8E1ECAC476276,132,124,8,0.6170750774519738,PASS
BB75A88110E6B1D99198B5E98D1DACB884E71EE58F9EA249B8D7BEE5D846032,129,127,2,0.9005235503397743,PASS
BC8B046032265E10D3C10E8416EB8BCD1687C4D6F28F6264D868273D5DEB9051,138,118,20,0.2112995473337106,PASS
EF3C77276E859BE4300102EF5761DE0FC13B474DE639C54453A34100248C1B98,136,120,16,0.31731050786291404,PASS
940DF33286197BA04C6C5DF192214A57E31834D270AE97EC53390E0CD166E007,138,118,20,0.2112995473337106,PASS
43443BD9702FE9DD0E102BECC462B254AD6C19EC7385EF9085BB1822AA249373,134,122,12,0.4532547047537365,PASS
6AE5A3B8F55E9504338F732AC6E1FBA7845C3A577A6D1A2A39B40E7471847F06,125,131,6,0.7076604666545525,PASS
1E4098BD4B0A11FDCCA1906B28DA67D8F330A2E1CB98006AA1D7376647C59E5B,134,122,12,0.4532547047537365,PASS
4EFA74397AAFEB43027D372657E00A5D5B8BDAE7317A63EC7177D05CF69D3A08,118,138,20,0.2112995473337106,PASS
DF1C16AB1857967C0EC12856CF9551D83A800677186C3F958726C90B5AF049,139,117,22,0.16913144470267139,PASS
CBF1379C769F1AC44E5557EBB32347B1D3BF7E7CCFD2DDCDD1BBBFCBFB27B0A5,101,155,54,0.0007381569085501356,FAIL
E7E57AD9F4E48A76BBA6A79C42238DF6303AA2A0B48D40E2748137F74657ABA4,126,130,4,0.8025873486341526,PASS
51948962E62F17B213F4B27C5FE5BC3D2065C9B14B25D92E60A9B51B5F93FBD1,123,133,10,0.5319710580974012,PASS
EC721E9E4B376ED91EC0024EB26274A79CF7FD6C300CB54337F5D226BF3CB114,123,133,10,0.5319710580974012,PASS
8320239563315C6D82BFA50570C0ED61605EE9EA737B8E013D275DF7ED514964,131,125,6,0.7076604666545525,PASS
95D199E2E20D776FDD518FA9EA1CF104A764C0120A252A064C78411F0D479B1A,138,118,20,0.2112995473337106,PASS
ADE037D34C7A75499F708DF2C92AA23AE4821A55CCA04FF01008C6E40A9F8869,138,118,20,0.2112995473337106,PASS
2A2206702FD685D9A7884BCEB6677A4822BE45502681177FBB868D973A407C3C,134,122,12,0.4532547047537365,PASS
4917BA67B9A513A4270C632EA13FB9E0C37E55CC2C729610303751508D79B88F,133,123,10,0.5319710580974012,PASS
3D51698055D700E2EB14F6235174EFBD09AD34B448FAB04F70C0A36EA130C3DF,132,124,8,0.6170750774519738,PASS
BEF7BA1C7910F7F0E1CC4AA1D2239F97EFFB1BDD2EA2F73AA40498AA9AFD6380,117,139,22,0.16913144470267139,PASS
AEFAC83CCF2271F1A79CB397512805A96820F033E18F2F1550DA8ECFA195028C,134,122,12,0.4532547047537365,PASS
8B06BCB7337DE62FE501FB957D52F447EC674430AFC85A942130E0F16E80E396,127,129,2,0.9005235503397743,PASS
9028578C82BF8D368F11238CD3D8BE43FCDD10F30E8EA918AE5808AD3B87C8FE,131,125,6,0.7076604666545525,PASS
1E171DAAD2B2B2ECB5F3F6D64E5AE439D5AAC27D6907FD61F11EDE49E1A1AC74,117,139,22,0.16913144470267139,PASS
2B88D838731F54709E9255644EBA9CEC4BA642C17E74914E50C5B0BB21CA192,139,117,22,0.16913144470267139,PASS
E54AB0FA7FFC9A7E442F170CFDBD8B579111B49268975057D81163A95E40BA58,126,130,4,0.8025873486341526,PASS
4ACBFC2320B4E5EDB6D596627D03B3523F754AFD0504C95B59288DC6CEA153C0,129,127,2,0.9005235503397743,PASS
2C173FBAECC7E6F8A558D71F5DE354F690D83C999AD26E58226F436292486BAA,123,133,10,0.5319710580974012,PASS
EB541F406E514FC438B40BA20DB0718C49AA0589A59F58A222B9A9655B7B08B8,140,116,24,0.13361440253771617,PASS
AB9DA500DF70E733EA849CD9376EE5FC868575CAF9489DF75094A93DFD7FAB71,113,143,30,0.060792723530522785,PASS
461E9FC41AA0931E79F58F032EB31C04672AC63F84016D836F19CBC79715128A,135,121,14,0.38157390570502125,PASS
31BFA38D4838BAC1AFB6A4417FC5D2F81D9F390B33CCF52EA8C075ED470A8995,125,131,6,0.7076604666545525,PASS
A1E603728063434817D50C3CA10DCDDD2B5C66F2A6B2FB7E49AD292B01429C75,135,121,14,0.38157390570502125,PASS
ECDB91B82B9A1DC168EDEAFFC7988AF1FA2D163A82D82C59BBDD4F637A75198C,118,138,20,0.2112995473337106,PASS
FC867C3436E27618E2CC79192043477E3C0974ED1BC1C601B9CD66829B0BA41B,135,121,14,0.38157390570502125,PASS
17B1B45781FFA40DB69F87931270D6F1C36CDCCCF8AF73F09B11640349FBFB7D,117,139,22,0.16913144470267139,PASS
AABA3188B1FADDD95170809F24BEB10BDF482B6C825C0A345AF7E7F4D6507D76,125,131,6,0.7076604666545525,PASS
1A4122C45882CF02E926FFB7CF008DA595BDD1D6CB6BE484E8319C5DF750896F,129,127,2,0.9005235503397743,PASS
5585242B411A16AFEC94CEE5F213C40D80E65B3A017F4CF6C78DE7A71D31DDF4,127,129,2,0.9005235503397743,PASS
54ECBBC0B1FC85CD66C01F3F54F104E2D08B29D38BE55ACE1CBC5D9F9AF4F5E9,120,136,16,0.31731050786291404,PASS
FAB05B3A83DA5D7A3602709DA7BEC60E13E7624D46ADFE0B2227A3FBC5BE443E,121,135,14,0.38157390570502125,PASS
1EA75FD1362C3E6BF2A1AB1F7EE05914271336D9D4C5311F49E9FE95AF159692,120,136,16,0.31731050786291404,PASS
29EFE36B46DD74343FBE6853EE8FCB20171AD2D0804567D62822D03656E663D9,127,129,2,0.9005235503397743,PASS
6F1ACE55D6D38DF302F41891712CB57B5EE774D2ADBA78266B4FC1D38646D5D1,120,136,16,0.31731050786291404,PASS
39B5FDA9826056653A50F6726EB9F63CB288DD2416C200E3DAA4D92CB717F51D,127,129,2,0.9005235503397743,PASS
ACBC9E0DA99615EBBEBC6922544BF3C2F867396E7B46D8FB90BC4DF5734B8987,117,139,22,0.16913144470267139,PASS
7BD9EC5D782B510C1B232E2518BDD26EFFBF1B6D75ECCCCC49259E0049FEA0D4,122,134,12,0.4532547047537365,PASS
9F6F8F11A48A6384391C546B9F25BC400D9412D7C50B54693725488D23482C2A,142,114,28,0.08011831372763423,PASS
BDA8A8E593F9C83345ABFA50BF8B6277134522AF634577634B3A200AC1D3C79E,126,130,4,0.8025873486341526,PASS
CCFDAE55F6167AE784E20476B5F7D03488CF6CEF2ADF8E4819BCC75B9C383462,120,136,16,0.31731050786291404,PASS
CD7EFC8EDC158D1E9C952353B50FFB214AE38DF13959774CD9106D725F537DE8,117,139,22,0.16913144470267139,PASS
170D2B4D96D22718C0FE7D7BB3A3A10F39BA962C9039A33ABBAC639666A4FD13,125,131,6,0.7076604666545525,PASS
7BD15F381D7858910255AFA35B8F06A359274BE60195CDBBC9DCCF4DA779674B,121,135,14,0.38157390570502125,PASS
E13CB3C96EE7A059B890804BF5E54BD3034857D705187EEB8BD6754E08ECBCA9,127,129,2,0.9005235503397743,PASS
6C00A95562526DC296B2185DFF68F837763FF0776D0D34A4D99A4FDAA8DD0AB4,125,131,6,0.7076604666545525,PASS
7658D5DDAE1C75DE27B9BFD8AFA4248CA9128C21D55DFF248FBA8612E4ADBEB5,118,138,20,0.2112995473337106,PASS
F0372AA055A38936832F2F7FE1BD403D0FEE48B3328E95D0E6630F2F7DBE42F8,123,133,10,0.5319710580974012,PASS
1392BAD28795BDF3A5060D10FBAD57D40CE6EE8D6AEFD39E35397B5653EBE05E,116,140,24,0.13361440253771617,PASS
F2AC53C71F07E2E83ABA8247F3F06B0E07E7CC57A1229CA621C7C65101AAB2B1,131,125,6,0.7076604666545525,PASS
8F958999277761BBCA717F3A815080049C2FEAB858C5F7EA4B0710D7AF3202DF,128,128,0,1.0,PASS
D9D32B1C2B42F5B0C325B03FA7DE76317BEE305BEDD86E401EB251B87E4B5D39,120,136,16,0.31731050786291404,PASS
2CD957170982A6B552BBF59AAF587404B16CECDA62EC08F210C0225AFB43F3D6,131,125,6,0.7076604666545525,PASS
585BA147BD36F5D7DF6D3BE37F50881C62D3BC47BD485503FF9A06E4895AF8F7,115,141,26,0.10416255883043901,PASS
F32AE2A0AA3CD6DA4FC1EDBE62347B64E5BF1C0DE3BB5114A7C13CFE2E629EFD,116,140,24,0.13361440253771617,PASS
F042204F76BA7FDE640F94E81C68C2F5C21DC867E02EE6DA69A1D64431C0718C,134,122,12,0.4532547047537365,PASS
8533CF8072238291DACD9913280DB3C9E45559188A3270FFA2686B2ED4F7DEB0,133,123,10,0.5319710580974012,PASS
E1AF0A7DF7039C2605E5D6655039F6506617B0C5E904751C6D566EB0D97B5F8D,125,131,6,0.7076604666545525,PASS
6AA406F0770C23F80DC9B0719F8EFE48E9D64878765F3E349CE19078D7D2E45C,127,129,2,0.9005235503397743,PASS
560830E8964F4E5F6BEA893B4213905600A30134CA294780956DA46E8D03E612,147,109,38,0.01754895019147673,PASS
58E05C6F0D7253FF53BBE3EC7EB16D6C6014A523DBAEA18F13CEFEB16DF56707,114,142,28,0.08011831372763423,PASS
5F578C2A8445D00061FC79CD5F8B80CCFFFA1F870531AF65E63175933EF1FC7F,119,137,18,0.2605890342736178,PASS
7ADF859301163D000F81959FC57D8A3E8F5CA3F5C693230EF75A3FC00E81377D,126,130,4,0.8025873486341526,PASS
68945B604309C3486CFB39E7070AAEA5A6826B0859C02E2D9EA5524232C68216,145,111,34,0.03358661289689768,PASS
9034132DAD079349107874C6E29BBB33C44B35C95D689C6185726B21C40E2EA5,139,117,22,0.16913144470267139,PASS
9F23B8D263ECA2B241DF05E45B3D75062AE662FACBFD04E4E76758E5F696182,125,131,6,0.7076604666545525,PASS
51D855ED5EC650DE5860870FBBB94F2D0E28BC7506AB9F819CC561ED567E6E42,125,131,6,0.7076604666545525,PASS
F5A8BBF1ADAF9DC1B2F464D52BF0B775CCEE219B1AC417280A1A0D2E76AB6B86,122,134,12,0.4532547047537365,PASS
F275BF28C51F1EEC962259C35A4710E499CBB1A042855CE1EB9522648CBCF127,132,124,8,0.6170750774519738,PASS
2E56438CA430FA6539754CF7ADCB21DF83CF150A9E757CEFF120271BD943EF54,121,135,14,0.38157390570502125,PASS
329E9841DF48E41351731CBF4397B677D02BF98C1729CE7F289A46139A4615AA,129,127,2,0.9005235503397743,PASS
C7987C8E444B7384DC05B8161745F6B47BBA37D55E6DCCD7E7A5025F525085A,127,129,2,0.9005235503397743,PASS
DC4A647DE67D0BA7419D56AB91059D7BA56264FE1E4D365D0BCC7E034E198B82,126,130,4,0.8025873486341526,PASS
AECA3A9FF57F10AAAC1111E0D2AE72FB244F0A331E4991D41F71EEDCB9636F65,122,134,12,0.4532547047537365,PASS
16633BF380170A86398CBBC661FA0638C6B98641C19A1021CF80F047989F29D8,142,114,28,0.08011831372763423,PASS
6E7D86DD8E061FBDE78DAC6847CE36CA7BFDBD6D958EBF54EE8B6AF2EF12B8E3,106,150,44,0.005959526470109114,FAIL
6B072745EBF5784DA5C71411D6D4C3733797A45396E9AD05EC97ED5B3D3AB511,120,136,16,0.31731050786291404,PASS
57CEC34C3D361679BBC02BA3ABF635829DE08985AF8909447104D605822CC0F1,138,118,20,0.2112995473337106,PASS
B08320B7E52D136D0F921760377879905C97DE6C24F473BF85A5D57802EF35E5,126,130,4,0.8025873486341526,PASS
36345E044D1FAAD18CF5859B230CA29455F1AE91F72D259695FD152876829A92,133,123,10,0.5319710580974012,PASS
10343DD62DD8B8AA0BB8DB5FBA9B50D4E54F6D7DA2365680B1A04ABB8BF12802,131,125,6,0.7076604666545525,PASS
F42B045A0E9FDF3A8F5933B35CAEAEBAC239F047269586E5B614738DF0C36A16,124,132,8,0.6170750774519738,PASS
B2D95E8EE570A70380C4F2E73133C6E2729EB74E77D4DCED6C4C7BEFEF2936C1,116,140,24,0.13361440253771617,PASS
C5A3A5FE467B9755F1A29808D6F08A135D4395ABED9D01CB75710DFD696F60ED,121,135,14,0.38157390570502125,PASS
916934D1FC6434785A82F9A2AEB50FD7FF007AC1E3BC54216152D09B11001E41,138,118,20,0.2112995473337106,PASS
1DAA5F055C12840A09055599F478D3DB126120A50BAF2EA91D25B1FC42E5C174,140,116,24,0.13361440253771617,PASS
8248C2190446B29C502CB7C748969936EBA6B3DFC9015133B99B304FBAB00D53,138,118,20,0.2112995473337106,PASS
634A8A92F94DDEA0596BB7F266C5A908FD865A2A72B5674A4BE3140F35638230,131,125,6,0.7076604666545525,PASS
4532388E54F200BA9F6D13D1C4FD2BC88B02EC902640E999278B450FBAE1E9DB,135,121,14,0.38157390570502125,PASS
78E8687955AA1758CE2264B20C85BEF52201E019413C2A7CE398F6C1D80DEA1C,139,117,22,0.16913144470267139,PASS
D81BFE9CED2BA723233A9A920703A05A8A5097442158D71C4139CB590D914085,143,113,30,0.060792723530522785,PASS
8909269767464A0A36478488C5BD8CA6C44215E11C721EA159A087C3EB466FD1,142,114,28,0.08011831372763423,PASS
795223F3300B1B8E173E9E1E86EBFCC8BA4247E470E95C665394500465A26372,134,122,12,0.4532547047537365,PASS
80BF66CAE561C74B048E6FE78244AC3F77055078DCB2079763E76F7254C2FD91,125,131,6,0.7076604666545525,PASS
BDFDA772F07643F28E33514CFAEC998F9080C798E45D9A678F705A70328306DD,125,131,6,0.7076604666545525,PASS
D3CFE24A1F97494D762A3031CCF287DD01CEF8B932C0F7B028A7A6DD8238F75F,123,133,10,0.5319710580974012,PASS
426D2DA0B3D146867284D93958870DF14435AB2DB8CB55093574578BA163D7CB,133,123,10,0.5319710580974012,PASS
D44C2C8FF95949741A8699866029D9A4A914A8473C298DFD8B2F5A633086227D,137,119,18,0.2605890342736178,PASS
184F767A211E46B6C6C5E72FC271527AF30DFE9CDBEEFAC2DC9FC790BB1747D9,113,143,30,0.060792723530522785,PASS
20521A7E25726B2C0D22C5696BB4B664AB44D521E828EC545214149B37D7D8D7,137,119,18,0.2605890342736178,PASS
90BCA3C5A93A8F06298AE108F7E8B92B31D132DD87332FA99C6FB7C0A4F42741,130,126,4,0.8025873486341526,PASS
F285DDECD4EEA000F0CF5B230F2EA170CFB0CC73D87318D91CDE4F17A814CD78,127,129,2,0.9005235503397743,PASS
7A5BDA5A44C8D59037DE6671FEE5B76AACF4938E0D3B5D200B677BF83DA67F29,115,141,26,0.10416255883043901,PASS
C5C192ADCF429DB26FA18C1E7F7FB7BF7814A321AEA9E1C3B524915308AD5697,123,133,10,0.5319710580974012,PASS
1EF8B87381BE1DEABB87219271B18A32B6E518838AE7A5CC7C155846A516DE50,131,125,6,0.7076604666545525,PASS
22199E248D22DC2B518D247C5D621DC0032E3AEE20BEAFEDF983D874C3AC025,138,118,20,0.2112995473337106,PASS
2F3CF1B2CC901935B7A11F4BD729D382881644AA3F6294758B2A16BCA303D489,135,121,14,0.38157390570502125,PASS
CC8F386BE53E82F5F27582EE6AB7EDC90907A04F4F30930A6ED9F5E2851A973E,122,134,12,0.4532547047537365,PASS
8AAB8F77BDF1B51CD106624B7CDD082EB0064AD6B4B624CC93672B443BCC76A0,130,126,4,0.8025873486341526,PASS
EFF6F7E2759B485102C69632A53C1418BCEEDCFD4FE2F4215884D9EAA6691E23,124,132,8,0.6170750774519738,PASS
4A06D076EEA497F2A2C9815D864580ED864D98F6C071517CC58C85688B7E65E2,136,120,16,0.31731050786291404,PASS
4F439677498FC39F5C5F41946B3834E6798DD8D94E9057353B7946784D74FA5F,119,137,18,0.2605890342736178,PASS
850EF6F139EF4E0C552E15311182394C0D0B74425684B2BB4E7E2FAB5622D662,135,121,14,0.38157390570502125,PASS
F1980E8E3AC20679AAE659D96B9F862D31A70CC0DA3E65632AF4686992109984,136,120,16,0.31731050786291404,PASS
FB6C0EB7695201BFC67794DB1D256D752CF4D88B31FEC599DE2378910566A1A1,123,133,10,0.5319710580974012,PASS
5C0CC4EE6A8686434A7388249EFC4F767897DF348ED0A0ACB86F30ABD7121A20,134,122,12,0.4532547047537365,PASS
297B551841EE4BEF5A7394961464D3A9FC14218F96BC48035EE4C4768CDBA0CE,131,125,6,0.7076604666545525,PASS
C17F547CED16E45034082D8BFE6AA72567B063BC0E66B74DE5B5BCD121F9DE7F,118,138,20,0.2112995473337106,PASS
2F3D7AF730A884705717F13458A31BC33DB26EA7E864DB916DFB32B9B9E004EF,121,135,14,0.38157390570502125,PASS
3907BE3933D79F65271CD822F00011516834840E39FF78D7C2C0AD0ED69B6AD2,133,123,10,0.5319710580974012,PASS
3AAEC00900A048A56AEDBA9F1C975D99AE9DA969525BDBF8CA6C90371E060E91,133,123,10,0.5319710580974012,PASS
4137E0D6D1B851D66AE16A25DCD711FE6CB30B878FBCC74AFEF035763B26A56C,120,136,16,0.31731050786291404,PASS
FCE451DCD052476E04DBEA47116DEAA2764C3A393D90748D498CF2C88ABD1761,131,125,6,0.7076604666545525,PASS
AA67873F9944B882642144CAAECDF870260B413CBDE5A2DA8399140180B370A,144,112,32,0.04550026389635853,PASS
3F691455869B553A5197718FAA776F9BFB20E8654CDCE5DCEE57CB3F86EA64E2,115,141,26,0.10416255883043901,PASS
7782598E58FBFB3203541D7AAE98B3DCCDF07329B494E488C9D54F47CB8EC92,126,130,4,0.8025873486341526,PASS
3F75E3B9655516AB24BA529BFFA1DFA74E5A506D2C2A0BB6866E5C0220E309D,128,128,0,1.0,PASS
6F51A04D6049745F3B982E13151D71939F92446F20B41071B577A924FA86CFCA,133,123,10,0.5319710580974012,PASS
A22FBE3F28F392009F624D978ED9AD32B2D131F598BC6478BCAA80751AB43BF,127,129,2,0.9005235503397743,PASS
B20E46F63F7E24BFACDEEF983EC4B2D0490B0D51F10D587F787ABF2D5B429631,120,136,16,0.31731050786291404,PASS
A9AFF7FF779CB890C622B42CEB3116CC6A46AB269EDAFCC590DAF1654743CBD6,118,138,20,0.2112995473337106,PASS
C59ED846680E2EC4022F615DFD04318070C37D6A4B862CE05E050C2F39D414FB,140,116,24,0.13361440253771617,PASS
2C6323DA64882DCA1F1D72AEEED3A719BB7C7D72B5234C6B7F26C4E804C2EF67,121,135,14,0.38157390570502125,PASS
ADA0BF996B31BA050D58FF78E5FE1400006666BEB59F0787AC62D466C959A592,129,127,2,0.9005235503397743,PASS
F172290548B5517E3E85350E01AA9395E0D8FA0C86116DE63939B8635987F3DC,133,123,10,0.5319710580974012,PASS
5075CCAB0F9C7FFC5BE0F79D255BDEF1188F74DC3610C10401E1DB903AF587DA,123,133,10,0.5319710580974012,PASS
E7CE701FB8EEBFC5A8002B2E090CF27B1FCCA366F9DF24F3E37A332F9F8E8812,119,137,18,0.2605890342736178,PASS
5BF5F8496BEBDFF33A870414C58B0A574AAE374703E79466CF49B29FF5A9252A,120,136,16,0.31731050786291404,PASS
657AB8AD7D1DFE53B1047DC489D13B812962570CDD5EDC44B3B368BB510E7B5,125,131,6,0.7076604666545525,PASS
494CED244D439FDE58290B23CC344256EC9634197F6A254A24C4F444F843BC0C,139,117,22,0.16913144470267139,PASS
32851174594626BA02802D82F79CAA9A4BCAD056D6EAE8C0F360D4B80326D4A0,144,112,32,0.04550026389635853,PASS
8007F52C653938DA3E83B8D21C4EFDA336772A064346D34A5478C24CA76C3680,137,119,18,0.2605890342736178,PASS
449866A7B70820E2A930F20654EA5625E62A94327442201D2A8474B3E76B679B,142,114,28,0.08011831372763423,PASS
2DE8E42D22B399AF317BC159BC9AB2BF086735F60897594CCAE30207CDF9AAD9,125,131,6,0.7076604666545525,PASS
A23725E1C43D5B0CE682065205C22BD333765616D8E1DAA6A8434F57B2472C38,137,119,18,0.2605890342736178,PASS
DE5D51762EDC70EB5C1C0222D783776D45D097558F51CBDA8FFDB88AE1A9BBA3,119,137,18,0.2605890342736178,PASS
B7A103AECA5325EADE1F0419E3C560AD2A25AAD1057D38A11E5DC57A8DF5DAF0,128,128,0,1.0,PASS
6AE8742623BAF4E18154BFEFBE43CFEDBAE25BCDF16848EEF3D16F598920A3E8,117,139,22,0.16913144470267139,PASS
3041CA638002AE90BE32D839EF3C004705F2E2D5B1E2893ADB86CEE3AD9E8D3F,133,123,10,0.5319710580974012,PASS
3C4A4DA4DE3E0DF54D1F7FF58C90FD3064388D813FC518AA13E7420EBC8A9C70,129,127,2,0.9005235503397743,PASS
303755386527635F8D148737F8BDB887176896B407D24CF26F47E414EDD6AE8A,125,131,6,0.7076604666545525,PASS
813241E13E6B39AF15289496E7A5C3672D9285526242C712F7AA7B6F6D393FF8,126,130,4,0.8025873486341526,PASS
8881536BB33D4AC79C4B98D74D26BD40F8B249ABF0E2353E28941FD940F4DB86,130,126,4,0.8025873486341526,PASS
9FA9EA1947B439E098CD3A059A31D59D65536875AD3D728FF1BA74AED20E56F4,122,134,12,0.4532547047537365,PASS
2CC696202B4AEC039CACF0EB626B2EAEF8C9F2B1143D4B2C22C9342C3629FB7B,131,125,6,0.7076604666545525,PASS
D7F6915F8E31AE022BE9559EFEC539BFFC7DE81503F726C3AC92F8B437ADFDE3,109,147,38,0.01754895019147673,PASS
353541E0E914F61A0353F3715B8F896881CE2C663A509A8F56D76EB15F31EDB1,128,128,0,1.0,PASS
5A8F92322090A61FEC60B08F433B48C79B606D3E1B726D2F35FFA2F21DEDA668,127,129,2,0.9005235503397743,PASS
AB04BE40AAE805B9547370F99CB8FB21E3FC6F879F130BBC911AC38A975E9732,125,131,6,0.7076604666545525,PASS
5A8471D702764C31F52A2335B736351544F77B425689FB2BE58C1EE2D83D3F10,128,128,0,1.0,PASS
BDC10169AB2DF46149ADF72D2C0439B5E0D7AE6DE820D3BBBC1B89DC002D0423,133,123,10,0.5319710580974012,PASS
62EB3FBC17B66C0D6C99BC28409A0D54D445B32B6E2DBFC7CAA62C6B534B8172,127,129,2,0.9005235503397743,PASS
5FABB13A405BB09ADCDAC162E27DCAEC79F871EE36A9EB0A3D31440C3A9A3596,125,131,6,0.7076604666545525,PASS
E47A02982170D74FC7397AF999BAEE6EF7697C9D53DA9C925F64FFA887B0E397,113,143,30,0.060792723530522785,PASS
C1CC4C04DF96D29EA5D140F31DF17FCED8827AC96643D0996143CE433B3C4103,133,123,10,0.5319710580974012,PASS
4F97292729A494273F7533E44AE2C657207F92D22EB19B2296C1BC6EB0C83EBA,128,128,0,1.0,PASS
12D4D91051F0527557F8C77FA9E03276A4EF610303D22A40767CB239C839506D,135,121,14,0.38157390570502125,PASS
ECD06681A1AEC785B8463879A67C4425C095101AE903790636E7445C8A2E8FA,143,113,30,0.060792723530522785,PASS
6C867B21E1DF418125972F61A8415FC9211A444E27E8B89A0E431859F647B87F,135,121,14,0.38157390570502125,PASS
3B341CF14DA35F9AECF2CE0ED701C0144983EDD0D523ECBA7D7215B552EB51A7,125,131,6,0.7076604666545525,PASS
EE5430462B1C46AC08A02554CAF9116EECAFF3727DE40D517F5E1DCC2A1B1F82,131,125,6,0.7076604666545525,PASS
502A703B6D3E12A2E348CA4B0042EBD0825B5BAE5A47FF211F661A99E8D8E9EC,133,123,10,0.5319710580974012,PASS
FFA68251D882B0D9925E902E98A0B8115EE173DDC31ABCC4E4CFC30E5F30C545,133,123,10,0.5319710580974012,PASS
D96576FEB5F50BC835D5A1DA6107107F37A13356DAC8EF79CD134A2EC7B20E54,121,135,14,0.38157390570502125,PASS
6AA1081BEBFAAEEBFA666FA2825577A703F6403746BA55CEAC12F8B3E6E1BA51,121,135,14,0.38157390570502125,PASS
126B51DC63E2A5292CB39FC24787A3A7108CDC45CE30B01AF536D39B30BEA690,133,123,10,0.5319710580974012,PASS
C806B23EE3934C4A54EC062572A2DA05B3024BBA2000AECEFAAA86CC4C8234A2,146,110,36,0.024448945310089426,PASS
973C193DC6BE0A5484A10122FC88F653281EA9816A8BE0665B7FB51C12106D6F,137,119,18,0.2605890342736178,PASS
749B3D67A010B390D33B8F5DD93CDD4D990AE854AA4B710EB47B5762329D4BD8,126,130,4,0.8025873486341526,PASS
F8C881DB5AC2EEFBF90DF9B2027040374AFABB5665B0A86217F456479F51543E,125,131,6,0.7076604666545525,PASS
BEB6C1948DFB3E4AD3403D26E7765F6D332CBA4C061E38222FDB37DB757734C2,119,137,18,0.2605890342736178,PASS
1D16393939119CC74A0F42903977034D12286B69133913D20AB93D2EF0224FF5,139,117,22,0.16913144470267139,PASS
A251A0B0DB20F7B8411EAD00DB6CD38586B674BECE043914774FE3FDF07C94AB,128,128,0,1.0,PASS
C0F4366FFEA09895198E1A9FE9959BBFC760D1371E910BAE3438791EF39AC8E5,122,134,12,0.4532547047537365,PASS
6A6B6244CD70B06854F37037D6EF01C9BB35B7333C220F2479A76946BC25E71,130,126,4,0.8025873486341526,PASS
F6E709A7AF119551B8D0C53128855C22F0E9C9B29D9B0BD3596656E01C95B3BE,129,127,2,0.9005235503397743,PASS
5CFC140B94B536028B3611D72446F4D19E11EDFFA38A603E7CB004CC85AC0A0A,139,117,22,0.16913144470267139,PASS
FD252B80C100F0518C641DAE0198F3D166565041DA90CE2FBDF915659E8C2F33,137,119,18,0.2605890342736178,PASS
77FEFF2D76A4AD151AA16A0313CC1BB8B07A5511F329CA9834412C4DDAA6C214,132,124,8,0.6170750774519738,PASS
BF6243A4D9A64D4B04F717D969D870C1B369B8BA9D9B49F480CC02148CF0C13C,134,122,12,0.4532547047537365,PASS
78D1BC2F5583A97EE7E8B2EE63961D310EC39ADE5E47BE3C7526F1E8808AE2E,122,134,12,0.4532547047537365,PASS
CE89C8FF24857E1E1EBE4E8B5B21F22E6CF73F05497607060F2352FE7B243EE3,121,135,14,0.38157390570502125,PASS
CB56CF9B0F84A55BF6CB2D8E104B13AABE54645EDD91E2C069F7B93D4FE03856,122,134,12,0.4532547047537365,PASS
F81B4C62A3C25C560B3164A780A941B980038BABD8C68F4117B514D250CEE687,142,114,28,0.08011831372763423,PASS
F7CC2557AE2101F9993D40E23AF45DCDDBF2CA73424A635B0FE566A3F05B37E3,120,136,16,0.31731050786291404,PASS
CA6C7712DA28DDA57D7ADFCCFFA56B48E1CFCB13692814DBD4840CB69F1F894A,120,136,16,0.31731050786291404,PASS
532D2DC2BDADEFDE5FE7ECAB760032EEB24FF0E7A6E645A647266E885174D75,117,139,22,0.16913144470267139,PASS
4DC050A42765EAA75AA709EC15FC594BB361CA74FC18EE00B766B661714F79FC,126,130,4,0.8025873486341526,PASS
6B0F2624F0154EC4C632FC3282785376D174AA056DCBA680C889289C2777FE8A,136,120,16,0.31731050786291404,PASS
35D231416B3882CF5DDA64061D665DF420AD915B36A4A2634B90C77C979F7DC3,129,127,2,0.9005235503397743,PASS
D216F21F4006899C075EC50A6EA5FFF1B2870D78092500ACAAD4D31ED3D4F195,134,122,12,0.4532547047537365,PASS
751CEF0A5342A301936877D8B02151DECADA23EC8AA03C79114F07CB3044A483,141,115,26,0.10416255883043901,PASS
2D87B0291690705AEFC52F853692E9030511596DB17CF9AEE44FE4D574D6BA8B,128,128,0,1.0,PASS
46129B31B7D6EA905C8114150CD3D5CBC4E031F8FD00FB33BCB21DDBCDC4901B,132,124,8,0.6170750774519738,PASS
7F7794F00B64AE35744EA6BC54BE7AB76EA3AA232309BC0386AF3CE91B6BCCA3,121,135,14,0.38157390570502125,PASS
F50D73ECBD94CE8F5C20BA228ED22792806CF38B285A1268AC298EFD83AC8425,135,121,14,0.38157390570502125,PASS
387E460538D7DD39272498AD6A0AA175029FB72F5E0F23CB28B74E79801B5D9C,129,127,2,0.9005235503397743,PASS
895626800695B97CFB8156541BAEBCF4B2FA5AB1D68BCC94A6C0C8D8A15DBBCB,128,128,0,1.0,PASS
A3A80B18E6D03B2905F41FFA99C1280E71526E5D08C48E0AB3DB16A553B9589C,137,119,18,0.2605890342736178,PASS
77A03B85DE75DE595BA059E1A2A3FFCB5EB216D6521D048C315740EBD2342277,126,130,4,0.8025873486341526,PASS
7528711CEB8603EEED6545ADE617C8F489C35D7D6ABA364C188D3ABD1BF7C9A1,122,134,12,0.4532547047537365,PASS
3A16E99BDAAD227149D3261FDCEBB7FE95C00500E10B311B9E06C7E695EB0B1D,127,129,2,0.9005235503397743,PASS
FDCC3E43001C0817D5E2B789A732007FEC05D852DFA2232BDE699B5A98ECF70D,128,128,0,1.0,PASS
B95B15FD91E97DF45EBC6F44D692042238B867BE2D482A16678A8D0F4F499F68,125,131,6,0.7076604666545525,PASS
9D93C558B5A95D1ED0CDDD7258E1585D7179D951771094F0F686656777119425,126,130,4,0.8025873486341526,PASS
E35C9C94A6390AF9AFC26422B26CDE986A517233E1EF83DD8D93FE7206A9846A,127,129,2,0.9005235503397743,PASS
5E326F30E28E4370C16AAACBA5BBF71B97BF0B1DF5A3937F69E131383E191271,121,135,14,0.38157390570502125,PASS
14EC9CF3BE8C4682D05627FE76E548E2B097E68D64FDB9D9F72F48686D541ACC,122,134,12,0.4532547047537365,PASS
32E87535DEBB1F2C8E328B1627C6CC84C32F37114EE9B07AA08441EB2BB505FA,130,126,4,0.8025873486341526,PASS
1825E2B44B7107AF2B2FFD0B93AD0D21E27EF32662841F1A219AE95BB9B8E793,126,130,4,0.8025873486341526,PASS
1AF82EEA295F0018E4795BFB233EAA1E97DF81FE14BA4150251FF575D2093A7D,124,132,8,0.6170750774519738,PASS
B8AA46887F6444D4264BA5E5EE8FE1703A85BD39D6358471B542063CB296320D,134,122,12,0.4532547047537365,PASS
E7A7335D9EB47A27FF33302BD431C65D2B6A588B9FBD3AB39BE08E9463D9632,119,137,18,0.2605890342736178,PASS
803F1156528E7D1419D55742413E4D0F79061593BB4BB57119D14A6DC60A7EB,135,121,14,0.38157390570502125,PASS
C12BE50942CEDB56075D0EA4B9FA4E6A15D52CCAB5C9B1734B1A6ADF523ED8CA,125,131,6,0.7076604666545525,PASS
D35CC1BAD438346CE5BD4D7A5A9A92DC1FCDDEE52F9BE3BA48C263FC17C68F40,119,137,18,0.2605890342736178,PASS
A86712B4FDB941EC5CD09CDD93714F717B4CEE265BEF625D3746F87D026421AB,121,135,14,0.38157390570502125,PASS
47B7B08B1E7278E366AA8542537962943DDD49584516643E3F99F2BE51A8C816,130,126,4,0.8025873486341526,PASS
67AA120D023E914CE6419F08C3BB9CF4FCC70F98C47EA5689D092673A6A063E9,133,123,10,0.5319710580974012,PASS
95D211DD1C8AA085F8E74E8AE476399DDDF0D57F46F82CFDD42DC2A1421FE1A4,125,131,6,0.7076604666545525,PASS
60BAA923FFE80438866A59408A3BEE2074179AEC5977EF9B681CFAAB80EB8944,131,125,6,0.7076604666545525,PASS
77E11808E3D4A0A9446C3D190A567E002CBD959B5AE8CBBBB4BC3D5909DBF439,130,126,4,0.8025873486341526,PASS
F06FDBDF355BEF2CCB949E539F9DA34DFDE1D46CB652B995EA90D03760EB04A9,114,142,28,0.08011831372763423,PASS
C19C79305B1B4BEB15E359935BC6B2B3B2CEC50F9C5532F262018793B9AB8E23,127,129,2,0.9005235503397743,PASS
6D9F798D7E26D2E948958675EFF0ED53EC122BC4E1665A8630ACF42901B1DA7F,123,133,10,0.5319710580974012,PASS
BC04022BB84A826217F9F54FD74E40C045593DB60260EDE9E2DF9FCE4808D802,138,118,20,0.2112995473337106,PASS
DFB7A6E26148AC973F0F5ADB04E9377B7F35FA2B99EF4C351F26FF2E680F133E,110,146,36,0.024448945310089426,PASS
EA5E0C9AB50630496A8E01D76EFE2904983A94F4AAD4EC6C16C9E8DE28A6283,138,118,20,0.2112995473337106,PASS
FB9444F8318F72B5E0447E5634518019F069222E7D422AC35BCEA25450FFE0A4,136,120,16,0.31731050786291404,PASS
76B6ED471B025992487973CE470D4C25624877926B36F45DCC50F66047EF77FA,124,132,8,0.6170750774519738,PASS
399169189AC280262007EEC2CAF128C3E3923618DB46EBE26AF25B6220030417,146,110,36,0.024448945310089426,PASS
A920C89916A71CDA3F0ECE7B5768C92D45847BD6FC8321C5867510C938E2034D,135,121,14,0.38157390570502125,PASS
C38B4F17E820903A090C5BB2A451BABFD4C4AAD5246FB358C4DB1F36AB11DC70,132,124,8,0.6170750774519738,PASS
8180983AF8009F79BE6BB793F53A74E355CD5D27C6AA6E1E6838497FC2CFFC77,118,138,20,0.2112995473337106,PASS
DCEBB4B51A5E47341C37A2476B71CB04C6DF76887DA54D6ADA06E70328732C4C,127,129,2,0.9005235503397743,PASS
59871189A5DD2935BFDE99648D05323EBF735EDAD35E934D963A34181EB5A473,122,134,12,0.4532547047537365,PASS
72E5D43C5788D2C2E008DD313F92B0A016A4DD68A43E6D2DCC57380C15984393,139,117,22,0.16913144470267139,PASS
C440D8695418DA8175BDC9B5B3ED5A256C680CC722CB3D05F3A4D9DACFEC8FF0,127,129,2,0.9005235503397743,PASS
36928A7228FFBA4A3D4B8D5A8C6A1A41CD82BBC30F2B700262D2A4CF586133A6,136,120,16,0.31731050786291404,PASS
CB81C18E43C841F72A0A08261DF7433A31B591C41B6CE8758B88A3D9F99E9116,137,119,18,0.2605890342736178,PASS
92D0EDBC115ACDB13809CD326AE2E4FEBE3290471F4871FA6AE8F45789A3C845,129,127,2,0.9005235503397743,PASS
2115DBA1BF30580FAEA1749BFF2157A422F03CE95033BC4CB5D816AD9EFD8C83,127,129,2,0.9005235503397743,PASS
D893EB521752ADBC7205EBE77CB1582FEDD646B013ABA9BF5A490DA680ADB3FF,118,138,20,0.2112995473337106,PASS
2A15F178D10F9547268981E46111288BED18656053F38019A35E09528F7FC9EC,139,117,22,0.16913144470267139,PASS
FD30E0311C63A09FBC4165786314605F9DE9436B0C196AF9CC2F4EB5D34BEB7D,125,131,6,0.7076604666545525,PASS
5C3DB397B4DDECED3C79AD327D71EB24C18584F4D5576D39D4BB4C816059DBE7,116,140,24,0.13361440253771617,PASS
3003D154014DFCFDCC8085D4121159D2F6C03F613797423F747A8B3BC9C4E70E,134,122,12,0.4532547047537365,PASS
C56FC041990EF0DC8A61E5F53FB213BA5B79D0C2F6E41E939C098293826A3241,134,122,12,0.4532547047537365,PASS
29A4176B1365EC018CCA3171FE59231B4306401C153F3A595D610D4DDE877903,138,118,20,0.2112995473337106,PASS
81E89BF72521A986A0FB9681927BB3B9BC1398DC51535D15CFCADF30D58BD515,125,131,6,0.7076604666545525,PASS
B0084AFD60634213F5212A3115E0D6D1E99944C24DF9F2E306467C97F23D8204,140,116,24,0.13361440253771617,PASS
1AAA645D2536EB64E643DFFF02A2D53970F2F30032EDB01C6F1CB81253E136F0,129,127,2,0.9005235503397743,PASS
1183CDC6876B4AF48D99E1838E59689B48AA1D7BA6134A4C4D96FDB96937E368,128,128,0,1.0,PASS
CF2DDF4D0DCF10E00F66F09318271D9EBDBFEBFD19764433D08CB22D04878566,125,131,6,0.7076604666545525,PASS
D6A99885F5635C2E3A535B81ED591881DC2FFF5B9CECD3C693E1768C42430ED8,125,131,6,0.7076604666545525,PASS
7513CC93721AD66FC59A6C2DAF43EE6B88410425B91A7EB417E0566A1D8CD8AF,128,128,0,1.0,PASS
CF3A3C5495FEDAC7F994A05230464268A397F2FAA4A1402162131B7E55D320AE,134,122,12,0.4532547047537365,PASS
8F00D8019CC369F4347F745A3FEDD48BBC4E9C5C1EF749DC4F8A88595CF27F7,122,134,12,0.4532547047537365,PASS
7B81177A23B5A7592C7DEB7694A20CA7FAFBAF53629F6C26AEB66AD757DFAA63,110,146,36,0.024448945310089426,PASS
4D09179662015C497E9E5A7ADF04785EC5BFCC67D4BE3833F0C4FCDB104BF142,126,130,4,0.8025873486341526,PASS
5246EBAA09699C34C2B42B1BB62323B9E34F34F744D69883002F7F5B7CDE6CD3,126,130,4,0.8025873486341526,PASS
97306EC4159BB80CBF4E8F423D212F73C2855C9D6D0722286CB83D9DC0E21658,135,121,14,0.38157390570502125,PASS
BF3135D14BF8104BD547DA875C2A0661A0BE0273ECD553AB8A22BF37409CC51E,131,125,6,0.7076604666545525,PASS
1A24AE8DF0874975572E22E06133F1D38115F258D55E96CDC278CFE28E786F27,128,128,0,1.0,PASS
85FD0A33CE46A6591E5720063D5F24AA9316F6CE2C15BF780E2E700E2AD8EA35,131,125,6,0.7076604666545525,PASS
92A03837E77E8D6B7F90AD9166E1C7121BA1794890A71805168B214C14D31425,141,115,26,0.10416255883043901,PASS
56D4C46EBB47A903DBB31C3421B04EA8E215E18501B4747A1D92E2C3D3B9A720,136,120,16,0.31731050786291404,PASS
9125D10362E33B15F6E8C884652E5DD77185F6088235D743A49D6C7D51C9F987,130,126,4,0.8025873486341526,PASS
BD563A1081C3D403DBBBDE70532B73B3B31AEF12C41B3806DF827A879D65F207,126,130,4,0.8025873486341526,PASS
8D9B0516D1839AC40601D3EB2B01C2588234D329AB4213C72FB69DFCC3C06D29,140,116,24,0.13361440253771617,PASS
B3D99E01423D195039DBE723EA53969572446763737E1DB77AFE6F9C61080439,125,131,6,0.7076604666545525,PASS
2A7DB90CB1B4490BE494A810786D7931D23C1DC920C0C3F61443CAF84AD9C23C,140,116,24,0.13361440253771617,PASS
33BCEE1C73B32B5A240CC6EEB7F2E93A6E613CF3AA08509F6AF1B1675873EB9D,118,138,20,0.2112995473337106,PASS
240652B4FF87AD079A16168957709A12D4AB9A4FAF548BBD0598427D188EB220,137,119,18,0.2605890342736178,PASS
81A92FFE25818B6BFA2911D434C550122945D93FBD0D46E300FAF03952F0A8B2,136,120,16,0.31731050786291404,PASS
DEFF31EEAE475ABD0A7FCED51867480087F6E47C73034E5383E20C2926975455,125,131,6,0.7076604666545525,PASS
C1FD4CC596912A74D6CFB95E779DBEE9BCF6DE1B15EF3EC65F5EF89F4DA42C46,107,149,42,0.008664896726025117,FAIL
BEC4382191C5596F3F9745E8C0D9B81352DE85D943D4988A20E93F062525C255,136,120,16,0.31731050786291404,PASS
4C3105226E31D394E9291D62341B3347EBEB8BBE080980EAF265C2AA2F7CE665,134,122,12,0.4532547047537365,PASS
CF0432A98C5B0E4340103A05794DD71771B9BD18C2EDF41C2F3A2772322C33A3,136,120,16,0.31731050786291404,PASS
5D261A28C260B9C1F1CA3812B2001272DC4FFC2672EC44E5F90D551AC5D82E89,140,116,24,0.13361440253771617,PASS
78C8B3901345143317D2861949CAA276EDD7ACDB85DB4275C851B75514941B1A,135,121,14,0.38157390570502125,PASS
AFB9F372FB0A96A5CD33C40F31EFBA19496D1096C1CC0FE5932D44B1565CA9B8,125,131,6,0.7076604666545525,PASS
8A16FF5FC555B812F876B8507B607D82119E6D0FA87684F1145AC781A7AF8383,129,127,2,0.9005235503397743,PASS
E516037DF003CCDFE27413432306ED3BFE98017108B859C2E8B456D8AE0AAAF0,135,121,14,0.38157390570502125,PASS
1BCFD2C7855A0C080CBD79A2470D03DE86D6FB46604E70D2348BBCF2882F747F,130,126,4,0.8025873486341526,PASS
62B16771EBE01AF46FAA7F220A8F93B1937CAB14C55BF5108BED32B1009EAD7C,125,131,6,0.7076604666545525,PASS
90C5F8A4A9D36DBD46544C6585E8FE9FC450D673E77D61196BB618AF32B271C8,124,132,8,0.6170750774519738,PASS
309293BED2EB431EDBE601F4094B18206C3742EDDB0062457B9047D0C4C5254D,140,116,24,0.13361440253771617,PASS
879FFACD93F99BD742727367EB8A25246614E37EEA7BA965F22A61A7BA6D834C,116,140,24,0.13361440253771617,PASS
,256,0,256,1.2777508801076536e-57,FAIL
9237285951A5ABE7D5DC43CD1FF70F8A7438110BC4990A2347B8906814242A6C,139,117,22,0.16913144470267139,PASS
1A78DAD0AD74055FDA77D159645D57FA3864D057C1EA2C7131B1A50C46AB14B5,129,127,2,0.9005235503397743,PASS
900A63C7028CB0321B9F8AF50ECBBFF55AC667857546AE6802496181B79E3E31,133,123,10,0.5319710580974012,PASS
200C85E1DC744762F68EE310507E086225FDA6538D1FEBFDA6727957B1175C8A,129,127,2,0.9005235503397743,PASS
470E0FC0FEDE2708AACC5CF3FA29AFE4F0AA765B7D10D2B4BD99890A1C185BD5,125,131,6,0.7076604666545525,PASS
C576B8AE7B6AB6ADDD431E51ED56FB305ACF19217E5F40D15BB14ABF3B2BF90D,114,142,28,0.08011831372763423,PASS
A6A51B9F447DB02DA7C2433EDCB2B4F0D2B28F85F32B19904669566E3718D457,127,129,2,0.9005235503397743,PASS
F215F2A4521852E4758E7731519194494435FDE0B64C5D23A5492C8B9A7413CD,136,120,16,0.31731050786291404,PASS
46B5AF21F32100EE30C61C960BD0E418B0F29D0BA4733E3293095EA1F098A263,141,115,26,0.10416255883043901,PASS
53264ACE8A134E52DDE1A55CEAD5CF714C0F0DA33360EE78F604B11C10A91542,136,120,16,0.31731050786291404,PASS
48E18A23118A69A4CA5809D1C16F418DCADF037C8D7FB8F170BABC35810696F3,135,121,14,0.38157390570502125,PASS
11142890638164697ECF5F769D8D4990A5827ECEA55EB24D7DC5AFE97FFA3A1F,121,135,14,0.38157390570502125,PASS
4B0C47EDC36B7C737B52E5F747B91E20783328C1E57B7B5C088F404E66853A5,128,128,0,1.0,PASS
846673DA5FA1D82F1A7C7EAD2D50917D91B0DC09F193A3D7F3CBD3B26EC94582,122,134,12,0.4532547047537365,PASS
DCD9426DFBC02F5269F2922A50088FEAE8C14E746D9C7EE5B105DC6E95D17BF2,124,132,8,0.6170750774519738,PASS
934957E8B8EC39B534D34F4FBDCCDFC123CE9D25340E0AB2F4317CC9C740DFA3,122,134,12,0.4532547047537365,PASS
2C6F52472034DD20A784304B6193A8F0F43C8E8044F4FD3BD34D8B96D4F1B077,134,122,12,0.4532547047537365,PASS
AB817597D0712E2129CDD05207CAE6CBFD927D7E874A343C9F038104E45AF177,129,127,2,0.9005235503397743,PASS
64B0586D03336F751F402A58558A6450F58BDE02DA1D1C60E0E2F15E84074FA1,140,116,24,0.13361440253771617,PASS
FF619F87D29521A2470C9827EF21FA60EC78FD86CC76C7AA0C6236CCC574335,128,128,0,1.0,PASS
6B230D816CB0F48B72660267763A6A2C2207508EC573EFA29963E8DB2D50C2F2,135,121,14,0.38157390570502125,PASS
450119B38541E61133FF0B403784DE371759EAEDB71D8F9921C42B1D1257814F,133,123,10,0.5319710580974012,PASS
4E4BF334525D3DA3E606907F062095BFEE812F6AB08702536EEA947DD6BDF96B,122,134,12,0.4532547047537365,PASS
797CDCCDBA5EFA1AE9BD47882AF7453A8032C03184AAF3504676B070324BC118,134,122,12,0.4532547047537365,PASS
D2272FEB3A9F3DDFCA86B090D62CF50CEE1771B2F0D9AE91370D37CA0CA69417,122,134,12,0.4532547047537365,PASS
C80BD507D67C0A47BACA3D1A67C81F1978593A8D6681B32FA9757B316D328112,131,125,6,0.7076604666545525,PASS
EB3E247610AF16E670D54879DBBA1752CC5354A1C6F59D6E03CBBCC1635D8591,126,130,4,0.8025873486341526,PASS
5EE90BBC7EDE778884E603DC51456899AD119EE3FA5E2492EA0172B575AD5B72,124,132,8,0.6170750774519738,PASS
3C1BD52182CD02E374FAFDFBF47E9BA3ABE57F05E9740A7E9B688A57450D3142,121,135,14,0.38157390570502125,PASS
26748631ED8CB185227B14EAF53E2FAA4947AAA60B78604891FDBF90833C09BD,132,124,8,0.6170750774519738,PASS
FDEF03469DCE456C657DAF75735E1D80F19950B22B8FCA96832B4E33E3A430D4,123,133,10,0.5319710580974012,PASS
7C00B242AA63E2C5BC9223DB93AA836D3E55FE3FBC6B24AD0377665B2954AE23,126,130,4,0.8025873486341526,PASS
D2684BB9DC32B014024031FF9C4DF24FAECA5097AEA5BD4DC4B967E781796FD,126,130,4,0.8025873486341526,PASS
C9A13B38C2612518DC3F267FE8D59DC3DDF758AF2CC260A9E9D0D5C97AB8C658,124,132,8,0.6170750774519738,PASS
3536974BAA9E2E09C24ACE78E147CD589E6B48C2C64A4B28D515341CA7D5AFDD,129,127,2,0.9005235503397743,PASS
F65CD2EF9A4EC12576DAF87363DC75ACBD2C3495701918FD4E4643B76088C260,127,129,2,0.9005235503397743,PASS
97D69F3069942C01D513F4025FBC547D48594F3E832141D8D868693462E65A76,135,121,14,0.38157390570502125,PASS
82A897001A95B17C1B3CBBE410C576F1C8F10D4C23AF5016CB903F7917D63991,135,121,14,0.38157390570502125,PASS
65237C738C32C2629428298B2CC36C6A3F44735553DF92426799235D28A4425C,139,117,22,0.16913144470267139,PASS
593500FE0FB8AB34C727E74A9F57B5CD6597F9AB0FB5AF7FD4A77D2DA16D2D2D,109,147,38,0.01754895019147673,PASS
AA3C4B1AE980BBE9357575907CA3B220F3B5AFE4B40BFEA370C121A787F3F569,122,134,12,0.4532547047537365,PASS
353FECBFFF1E86AD9D34ACE143F049A453172529769652856889803880FCBC96,130,126,4,0.8025873486341526,PASS
790E9C005EE7A271AC80EFDB7550005EF4247DFC99A154D6BCF961B6595BD7C5,124,132,8,0.6170750774519738,PASS
82081D81E19EAD0DB6F745E2DB0D44E122B04A7BAF5C73DFCFC2FAE95581FCD8,124,132,8,0.6170750774519738,PASS
552C0A4349FECB8D79EE23F5B85B91C84EBDF7B11B125E20014F42B6369CDC9B,126,130,4,0.8025873486341526,PASS
B35ABA144F3EB1B9A13DFB48E68E517D6B8E22CFA6F6197303CAF1DF3EF77DE2,111,145,34,0.03358661289689768,PASS
16CA7670A4F0C49C57DA4CBC2AB0A13F91ABE7BAED75E0AE3FAC97AA75FCAA1F,117,139,22,0.16913144470267139,PASS
AF74B3C82A7753BBE296BAF9F27566B982967CF6CFFAA44AA6AE9F739EDFD759,104,152,48,0.0026997960632601987,FAIL
B203CB9BEFE0EBD111D619D7F333367D4FF33FBA94E9A9E9A913210DC826A369,119,137,18,0.2605890342736178,PASS
B6919576538CF924FBE159047B02299346839D60C91850AE844882665E0E3671,142,114,28,0.08011831372763423,PASS
316B86CAC67ED87E67C4BF23E2259D10B99C5E6EAFF6FB44C8FEDDF3E41085DA,115,141,26,0.10416255883043901,PASS
9FF0B708706091B2004D9CA30634B4908665712FDEA7C1CF3AE2F976C9B3327A,132,124,8,0.6170750774519738,PASS
F4C3E0E3ACD141B1DD5BC8D800B995B4C1E106C7C5A7C333ADD7D5C21635FD95,126,130,4,0.8025873486341526,PASS
8B001194EDA67DC0FC340F2528B1A15DBC2540181E9B967F6FA449B6F03D5D79,132,124,8,0.6170750774519738,PASS
F8DEEF0E081895DDF080D8C6B191D5BC7691164A1D41E5E840471C070A40EAD,141,115,26,0.10416255883043901,PASS
26FE467AEB2E444D5CCBA431775C31D58066C222BC7C7EA3B950573B6B843841,130,126,4,0.8025873486341526,PASS
916373D27BA1544CE73275049F15613DF8686E156852D8549255901C467ADFD2,133,123,10,0.5319710580974012,PASS
9E1033C9014CDE3E055CE9FFC12B99684227183CB3ADDC540A586F65868DC573,133,123,10,0.5319710580974012,PASS
66A231B2001057638C7C40B266A8DFD9AC4F85248037FEF99E92E129F7DD28A5,133,123,10,0.5319710580974012,PASS
74F5A5DB28D1088ACAF744D24F523791E33CEC3B188D8C78E9C78DE7F723A8E8,124,132,8,0.6170750774519738,PASS
11AA12527E72F56AEC61AE1FCBB7942E534259855AB375E00FD98287A142B8BC,130,126,4,0.8025873486341526,PASS
10E6B5EDD1697D5BF3FDD57776ED586214F02D6A23F5DB678955B6AEFF57B3FB,103,153,50,0.0017780505982168669,FAIL
1657CFC9C08A5EEF2F8E40502AAB8CAE6A9EE310717595711FF1A0A1251F405D,132,124,8,0.6170750774519738,PASS
FD2429D47B93756EC7E2F81BD27FC46581AEF4D206B6392B5775CBA2062BC654,122,134,12,0.4532547047537365,PASS
3201B2DD57CC3A6F9282CCC5BC64DF52D8398D4EF1A4A9282CCD66E4AF8DA94,131,125,6,0.7076604666545525,PASS
4E1D543FDD0B29961D3A1C6B5B6DDEA4A2907920EEDC001D75F06D841E34D0DD,130,126,4,0.8025873486341526,PASS
48452893FC9162F2D81A5D1793CEB01CCF876CFE4E7EDB5EE12E90F76B095DEE,120,136,16,0.31731050786291404,PASS
2145EC0CD648009EA8DEF0786D300A7174E167BDFF47ECCE503D436A1FEF6E4E,126,130,4,0.8025873486341526,PASS
161B9A74798C6D3EE22FCA3F4C87D31A3885FA97DB14288E1ECF317287FAE845,124,132,8,0.6170750774519738,PASS
94AE0F666DD7D8543E6A79622BB165E17E2C30C17A794395631747C149E83BD8,127,129,2,0.9005235503397743,PASS
7F1CD2101F02804C189995A496F233DC1BA57EA27049B36C6D557274B04CFAA5,135,121,14,0.38157390570502125,PASS
768D67B1DF03B4DA69A1254BA284A1E4FE306279AE0764D369C5BD13411E46CD,130,126,4,0.8025873486341526,PASS
353B4B22A702F0B388A115CABCE3ECE109CDFAF3ED5C775160EA64D6C254C40,133,123,10,0.5319710580974012,PASS
3AEA54C62525D5A73F0AF61B24599005C45D128845C15A8B09E036012D76E06,146,110,36,0.024448945310089426,PASS
B6ED485905E3C2884DB0ECFB0B787CFDFE9727140A13DCEBD43A37EA24EE5A91,122,134,12,0.4532547047537365,PASS
8C219551BF885A55C5D3B046B55CE8B028233660F071BDAD801046C7732564DF,138,118,20,0.2112995473337106,PASS
5600A6C70CFFDAD9261353886A2137E753755C3EC31B4083427DFB05190D3A29,134,122,12,0.4532547047537365,PASS
4809E65C5ACEBF9A4F53B094FD951BC7302C91D2F823BC883E5EF92C92D61C8A,128,128,0,1.0,PASS
6CDC424ED38EF60BDDA8E9E3D5401D6E8F4D26ED72C5E050FDF174CA7D660272,123,133,10,0.5319710580974012,PASS
56AE326E1CDB02F385BB280D728646E8546C5B8D32E5E277AFB4B0E5A0CAE479,128,128,0,1.0,PASS
6D75AA807BD6A210ECC1C2660323A42055D5D785617D27744805B34A6828510C,145,111,34,0.03358661289689768,PASS
60ACBC4CAEA38C5DF5F3CD201AB020CCD6F5472E0C75D9D543D960C886B6E96F,128,128,0,1.0,PASS
9D5F24337B75D6F532D8B7A98DA00C7FDFEC757CE73C124BAE5BF4C541027D28,117,139,22,0.16913144470267139,PASS
69AD3297896766E087F2ADAFECCD6203A969054961BD1F1E21C69ECE82BC80A6,130,126,4,0.8025873486341526,PASS
2FBBC5CB5B599EC70D75E9332F31A75684BC4C81C033B33C320B56A0E47D44B8,128,128,0,1.0,PASS
384B73F1B53A6617B9CA3E996C19F81CEB5FA1A857433E41E716F8958824C601,129,127,2,0.9005235503397743,PASS
AE1ECE38687FEFF5F501F7A27B1D040AF551AE46A583309CCFC363CDEEE1A249,121,135,14,0.38157390570502125,PASS
7E809DDD8A6409BF9F0BC6C38D3D16819C6F39545CA6640687DF419BB3EEAC25,126,130,4,0.8025873486341526,PASS
695C246F4B18A3EED8BEA7274A96F4D4F21F0D43F9169B8B371C1D88E5222E4F,125,131,6,0.7076604666545525,PASS
1433F67D7C27AE6EAAA0565416EA0809D0122F7ED6DB7BF65543238BAF2B7A35,123,133,10,0.5319710580974012,PASS
1416216B690158A888508D2BCBB2EEF983EBF6E73ADBC3BC58F4EED1AE32DD7C,123,133,10,0.5319710580974012,PASS
205699FE01A0BEE87995A0697335BAC4559B14C1F15DFE0936F8EDC1083FF96,129,127,2,0.9005235503397743,PASS
880D945F80C51854A6BF2AEF3F4BC66AA3A76AC51F876D9D938A0AC50CD142E4,132,124,8,0.6170750774519738,PASS
66509FF9D4090CC80897340D5030CB0ED03DBCBA929E7F011BFC4868644663B,141,115,26,0.10416255883043901,PASS
DD04B932CE5A2D40F838D11D649FC3A0A79A2190AC25F17EBF809C96B3CD9BCD,129,127,2,0.9005235503397743,PASS
ED0A7C3F11728AEB761E24413471E1B19F281CDEFA8DA2798F57313F3F0EF037,122,134,12,0.4532547047537365,PASS
71FDB54D27C624E15D3D2215C93A8E42DEB71FDAB0DEBE970364C2F003A393C9,125,131,6,0.7076604666545525,PASS
7EFC95623C04C151325E19F77F2FEF2FE01DDDF7465B8129FC410BFCD24349E1,120,136,16,0.31731050786291404,PASS
F8761A570C4A7459EBBA9729B22C64B277F0DB22835E52672605DF1FB277672,125,131,6,0.7076604666545525,PASS
45C45066CD5968B022E7A216A856DAD67FC701FAAFD26F4E6D718FDDCB00DA4,128,128,0,1.0,PASS
2FDB38F504C4B63D8B1E46C5474B1538693F42817F39266E71E6068B15647618,132,124,8,0.6170750774519738,PASS
D2FF8E49AED464B4F7350946761F20B5790F9C8B6D5B5B16668783FE227CED6F,117,139,22,0.16913144470267139,PASS
E0D1FB2180410FF0A20AF9EAA3A0EDDFA4BA3912904EF1A8E966A41402CE4809,142,114,28,0.08011831372763423,PASS
4ED84AA90AA09D1A0BF2B4BD963D5C22B0B3B3CD4C28C476039FF4D8A2684E64,135,121,14,0.38157390570502125,PASS
9A918E31E506174D7CBB488081E1E845066C611D5E23F119C0BE8A5FC45AC769,138,118,20,0.2112995473337106,PASS
8BF8D6A5C706453F5551CE55CC65C1B69D095A0D2C83C21364C996D8680830A,141,115,26,0.10416255883043901,PASS
41C96D33688D7160DF7F7635B4918F20478DACA4A75F060A1D0A34D2ADDC3BF8,129,127,2,0.9005235503397743,PASS
E79043D5CDAE38333A86B120CED2607AFCD03CF19C77193E1FB3E825D539FBBB,120,136,16,0.31731050786291404,PASS
90FAC41F50A8D34740E32624DBBADC69CCFE2603082550F90F40828E0F745C2,143,113,30,0.060792723530522785,PASS
2ED2D45BF4EFDFB25F4DF271BE99C4F859C6384A8DD5A58E441BB788430ABBD1,119,137,18,0.2605890342736178,PASS
E142E5C6EB9D43524F627AFB17CB9C0E1850BD008A885B39D18AA3B581EF418A,134,122,12,0.4532547047537365,PASS
109662A6007999025D9001DED1CFD3F784B287876E603ABA59D0F13FF7FA6059,131,125,6,0.7076604666545525,PASS
2B99D63D51E0AE06434AA6969791FF744E0BAF126874FB3D8700B6A0DE805E69,130,126,4,0.8025873486341526,PASS
525F74921794523DDFFE84B183D169C18B42BB581E93E1A2DA4CC00F4C8B32B6,132,124,8,0.6170750774519738,PASS
49765DB8DE14D1C8508C9A5E24B3B8464E7C314A5CD0BA07A6DF12930C5828B1,138,118,20,0.2112995473337106,PASS
1EAAE3400CC4F5D747D54804BAA0FCB8B99E61E53FC4D377161217DA7050EE04,132,124,8,0.6170750774519738,PASS
AB6C6C247D30A5BFCF0E9367B4381A67F5E42B4D5E068509B5B036DD0517B6DC,125,131,6,0.7076604666545525,PASS
B2BA4300CEE6B33D5C066B239D2207564C6B8C81D80DF936F0232B2CD4A0235B,138,118,20,0.2112995473337106,PASS
9A08FFD366D67268BEC49F33E6BF7A3816C60A6C2B28B1C2A998A8929378E11E,128,128,0,1.0,PASS
7C1B16A4DECDCED3E135DC1DCB9F8829DDAA276251AC036AC64C0BBD1775091C,127,129,2,0.9005235503397743,PASS
4C66376AB37CF42904186EC9792A6FEA336B98B5C6D8729167C5AC2EB23051D5,128,128,0,1.0,PASS
42B4A06A964FF305A3DDB29A5A3677EDDF377470EA0FA7F807F6D2136F1CB0DD,117,139,22,0.16913144470267139,PASS
B57554547C10FAFD6BC817784653343D284282F5968AC90D8257B7136E3441C,136,120,16,0.31731050786291404,PASS
DE0AA816E40B0D6034F99B2A3A6EF6580E82200B74C66E4F04BA5B53D6475988,138,118,20,0.2112995473337106,PASS
41B8C79ED7D4C7A9829048F5801CC4C460B16B28A17E6109352FD5293EA0A95A,140,116,24,0.13361440253771617,PASS
199A3D6229B29AAB8F135A2DC2E7ED5716BB3D9BEAF0AA0F5EC2198241340744,130,126,4,0.8025873486341526,PASS
7B29DD5F2F105DBAED62ED718EE0F7A8438A3675E947F8316DFC56014A60A67D,120,136,16,0.31731050786291404,PASS
A7CCCCBFC9A6FC42EB3D3623D038F064542EC510ABB1F8DD1FE4F160029B34B3,127,129,2,0.9005235503397743,PASS
5F161EB2E92762D2883FB57C447695238FE8395A22435603798F9399BE349DE,128,128,0,1.0,PASS
E01686CC7C619792716395863B8988E424D516E97169E01B442FFD1CF87DB253,132,124,8,0.6170750774519738,PASS
B22B9B2E32A36DF11EBC7B8DF926EF7CF620B3247B4E970B29DBE2144DA8C5A0,122,134,12,0.4532547047537365,PASS
2D2287D71A3D573CB8224D6E28BB40865B1D122EB482B626F46C063E7A220282,141,115,26,0.10416255883043901,PASS
D339A533C5C2DD04BBB786CB3EE216E94F5017989F66C695EF0F19E5D252FCCF,118,138,20,0.2112995473337106,PASS
DBF528647364828D47AB445F3604B51952B152DD98C69FB305D471C5CDA5D780,131,125,6,0.7076604666545525,PASS
67D3F8BCE4B2F5E24326C465D04F669C0DC26DEC06E77D7914882A122D709AA8,131,125,6,0.7076604666545525,PASS
C4126FF067F4B6C1F5CAB87393C7C3DF892FFBD564B1E677F3D4F4214F6238C0,116,140,24,0.13361440253771617,PASS
825A30DED8169310331BA26AB30DF5EF149845090F8FA1203FF3004806649316,145,111,34,0.03358661289689768,PASS
C57BB57B9E6C8F927186C4C908F48BB4478E699B18385B6E946FFEB22D4FB537,119,137,18,0.2605890342736178,PASS
C84B79482E2F01A9C793EA43004CB6B0F204210DA6093D83FDA8C882CCE9F6AB,140,116,24,0.13361440253771617,PASS
A56C49CEB74712CE0ACAF8FE616A1720A0A81B507D0020FBDAF8E837227AD547,133,123,10,0.5319710580974012,PASS
E776713FBBF432964B5D1650D00EAF5B4A311A6686521557ED7C716390759ABF,122,134,12,0.4532547047537365,PASS
91E4F0B636F46584FA752CC14FEEEDA215A44A744FD7BD6E881AE7A99CB2E074,123,133,10,0.5319710580974012,PASS
4AE15E239B7EBB004F34A363F3675724495626564D8CB7054351D7B3FE75E26D,123,133,10,0.5319710580974012,PASS
1157FC3AAE3264E0809625E530C271BB35BA2F0C640FFDDBC42C11D2300DDC32,136,120,16,0.31731050786291404,PASS
AA0378A61722260BB4DD7AAE354C6555E1ECFB2A2EF61A996AB4E5F5D4793938,124,132,8,0.6170750774519738,PASS
4851EAB6B095C7D182836A63F0FB04A5DC9809150124BF3D613620793A5463AA,140,116,24,0.13361440253771617,PASS
1166B2CC4A0DD7E8EC082071AC2366A214F7F48B95F854FF11D6132529C73F2F,131,125,6,0.7076604666545525,PASS
CC0114D22D096967400535203E2A8ED56C10929CB6F2D250E3973CBE6D21C7E4,141,115,26,0.10416255883043901,PASS
B95A4F9D7F0E8C2D5C7E3C6E74FE1C8D386B056E6BE1FC907F2AAAC7865111A9,120,136,16,0.31731050786291404,PASS
FD85DDD2B0F2312C6E0708E9C43CF87DED64ABCDF73DC95D308761ADFCB080D6,121,135,14,0.38157390570502125,PASS
61516731015523598AD358D521076C3192933DD69FAFB44ED6006188E4DF6410,140,116,24,0.13361440253771617,PASS
FB20C04C5FE56B8DE461994E6DFCC33A3F168001CB9F467408555D889649BAFF,128,128,0,1.0,PASS
B24877C1FC0D58B985BC936D546B55AD4437F0DE41C87D9B1335E64B374F47C7,122,134,12,0.4532547047537365,PASS
C4061A46973DCF0AE041B62FEBDD4EBC757C2C0E2D3EB1F627B0FA8167993CB4,124,132,8,0.6170750774519738,PASS
5D8E7BD7499847BDFC2AC3D9987C621601BB85FA119D5A29E7D34DB462773FDD,117,139,22,0.16913144470267139,PASS
866D9CDA5464B3A9E2324090C5BA70C64319AA8688FE46EE213D071778E129E5,137,119,18,0.2605890342736178,PASS
4211EB5C4D85667B2CE3DDA46C37A99CD8DE3F3EC6EC8665B721565EA2DC9B43,121,135,14,0.38157390570502125,PASS
FE4D8BA7F8411A67CFC2CC4F9DDDFC8B97B0B566D50022297142BECCDF9F4633,119,137,18,0.2605890342736178,PASS
36FB8E3D6C8242148223D8928D257B5A1A093C8124F9A9DF63B40C326BB81C4E,138,118,20,0.2112995473337106,PASS
5A8CC50204FB28C81E5C8CE8BE02F70E49D8503EAB3B4ACB46B0C0B0E103BAA1,142,114,28,0.08011831372763423,PASS
2ED125E18B4AB92A156DAFCF14B83AA344D84F5CE1568421346772AC9FBDDC0A,130,126,4,0.8025873486341526,PASS
B9840480D89D178C4958D99DC71CC5AAC2ABB0D3BB2B299C5BB200A0ED4B2C34,139,117,22,0.16913144470267139,PASS
51A0D83987A3C7FDED3225622897405BFFC740C5DFD2290C4CDD05301C52DD0,136,120,16,0.31731050786291404,PASS
97A0E804109617E37F320C147729DCF63629339283F95F091D4ED8617526E12,137,119,18,0.2605890342736178,PASS
1A82A72B3CF449F6837DFF06FEC17B08586A24FA8333EBE5420770C52E9B9868,128,128,0,1.0,PASS
41A10E69436D74251C2FA1E5D6161B8E02070C72D6BA25B0EEAC819E9FF407E0,137,119,18,0.2605890342736178,PASS
CCE63F909015FE60413E24BA0C0792DD4E81AEF938BCAD7838185E32C119BEA7,133,123,10,0.5319710580974012,PASS
7A10BF1DC91D5E479354C767116979318E129BF6734C351792DF0E0DE1E9C481,128,128,0,1.0,PASS
11040B66601C9A3FAC8AE5BDF188A796F845B58841C4D45947341DF8CFB4920D,137,119,18,0.2605890342736178,PASS
723240B9688D2FDD16B95BCCD23E9477ED18038576A51DC64AE61F29214048A7,134,122,12,0.4532547047537365,PASS
F1E7F8D040CF44EA076C862198D8DBED9B0A51C5BCA6D696DCC86465AD4B94E9,128,128,0,1.0,PASS
C666A85090A490E0BDF015214423999301668730D7F716FEBECEAA83F8B7E0ED,133,123,10,0.5319710580974012,PASS
76A79C21B403DBE200DD4655E0A7C7375DCCFA8B160C576E5AF91C9C58B0223A,130,126,4,0.8025873486341526,PASS
5E4326BE58EDAAB305A326AAFC62B078CAB62BB85D19489BE80F2D030A99A956,132,124,8,0.6170750774519738,PASS
F29C7C20A781A6069B69DE2CDF10DDB8E0F17D4C7EF233A201A46E9B0DAA0C56,130,126,4,0.8025873486341526,PASS
C3963247652A75756FC02B0B323ED51BC097DBEED9428040EA04A40847E377C,137,119,18,0.2605890342736178,PASS
7A35B22A1CA9AEC1194A7FE82FE2724608EB46FFD21247F9FCED432349EBC5F9,121,135,14,0.38157390570502125,PASS
F27B1211EB155772ECB08E508356857197221FEEBFC309B3DEC67087862D8C03,130,126,4,0.8025873486341526,PASS
B2CAC45F02D272A22C4078860DDA93015B7AAD0EB9A77B2507133D534BBBB33D,131,125,6,0.7076604666545525,PASS
F57B3759A1DB3F54DE0588FF154A0DE83092D8A4DC6F2D495CA164B82CFF46B9,123,133,10,0.5319710580974012,PASS
6B5D77B37004C67CAAA4A6EF38D1F0967629326F1E724FF6089DEA0679F110AA,125,131,6,0.7076604666545525,PASS
77AA6017170BAC16430BED3D693A96222E5841CE9C147F713FB4169883A6CDF7,129,127,2,0.9005235503397743,PASS
502511642A052FA2FEC6CC46B5FA1CE80DDC7632B11B103221CFE91FD0649705,138,118,20,0.2112995473337106,PASS
130D0F6E04C387298D4A8F7F97FE7DB4DF5A0C900490C92DDF8DF55CB86E058C,127,129,2,0.9005235503397743,PASS
F4EE0EE58FF47240AC71A068B308F592CB57067EB912D98D4AAD2A1EA713BCCE,127,129,2,0.9005235503397743,PASS
AD3559C28F663751D3515ACA43A20F2F0A92C83DB4E1A8C4F684FD8236C38BBE,130,126,4,0.8025873486341526,PASS
419D82AC63C7BBB00C028AF6A0190150D549FAF62FF28BFF12984AAE764D58AA,134,122,12,0.4532547047537365,PASS
632D2CDD3E7488D05242D36A0FC89D0E05D766B80DECD89C05ABCD1E6C71EFCB,128,128,0,1.0,PASS
E192D9FE993E286DEBA64C996BD62DA9BEA3C29ADC600A5BFA488A795F141EC5,123,133,10,0.5319710580974012,PASS
888311BE43D69FEA34CEC8C6957DEEDE365AB5D6A7B8F17138ECE8FA3B9B52A2,117,139,22,0.16913144470267139,PASS
2161CEFDD1DAF7E402234AD6E7ACE9A4C84FB85FFCEB05ECD53AFF17ED5C2CE4,114,142,28,0.08011831372763423,PASS
B13E8970C7DB343C4F6012EB63D50C0A3A99B53974AB36C11DBD4986C32AAA71,131,125,6,0.7076604666545525,PASS
3F4174875193E2BCD3D06EC3CC8995B4A771BEE9548719829BBC2FB35245ADA3,125,131,6,0.7076604666545525,PASS
B581FD5583DC7BD30A4D3F6C5C09F809B5AF40BB1A50A0E08EB019CB7A331498,133,123,10,0.5319710580974012,PASS
5133BC0BCC7CDDBA170585CC8E0A9B6DB794D62548149267BD78618C81544943,136,120,16,0.31731050786291404,PASS
C260CE4118579B36670BCB8B0914EBD3FEAB21AF3066D1DE383229CDCE5C682B,130,126,4,0.8025873486341526,PASS
C3A6AA80789101554271886603327B5A018A5D3124A26F7C5B38CB1A57896C3D,143,113,30,0.060792723530522785,PASS
61BE23F490F31501C6BA380322C81FAD7F4E3E35431B74E5C7EBCFA100AF725E,127,129,2,0.9005235503397743,PASS
CA745A1F36EC768D71947DDD65C49C27B08E77C0DC67E34F04D800EBC82736A2,127,129,2,0.9005235503397743,PASS
8CA4E36E6DCB53D345D8E051A050C8DF2CBDB67C81519A471C2E5F16045539CD,132,124,8,0.6170750774519738,PASS
D83ABA43C91C6106A2F36B05CB5A4744B474F6B3C8A40A5810D3F2FFCBDD1686,131,125,6,0.7076604666545525,PASS
DAF33E01D931700FBB7235D50E7B7FEF48F24AEA3883239EF81EF9199A03F6D5,118,138,20,0.2112995473337106,PASS
7B517C90D65775F4FDF1D9868E5AE9406B7445429DB78029F8F7758D4F9221C3,122,134,12,0.4532547047537365,PASS
E8D7CED989038CEEF8BDE3233979AE400FFBFA4B4E6B6CC50209566A78D1B8BA,122,134,12,0.4532547047537365,PASS
2BA00AE739F9BDB41F28A3A068E4C712E74627B088C0A2D4F5049394EC51BAD5,136,120,16,0.31731050786291404,PASS
10C3659AB3ACA1213317150115DFCE5AFDB85966F46E104F814AAF7D4B12CF74,130,126,4,0.8025873486341526,PASS
6DAAC4A889E129553A3FE3DFC229B47D70231AD9ECFAE9C1DA6475C8C7930A4F,124,132,8,0.6170750774519738,PASS
84FCE6DB9E28CD66EDC1E5A83E296FF9EDFE0EB38F0946F8B088F38A2991D57E,117,139,22,0.16913144470267139,PASS
81129453F2C74CF1AFF80888187FAF413A055189317A3CC3A04926CEB8DE40AF,138,118,20,0.2112995473337106,PASS
69E7B613942B884F26393CC1D421B007D701105C3CBD8E8ABAD365C28608FE42,139,117,22,0.16913144470267139,PASS
51E812F139D2D21CD1B0E463136ACCE4178D488E85E8994844C89F93ECB22AF1,138,118,20,0.2112995473337106,PASS
AAE3FA30801A0D5FEEFCBA34C127AFA0C483106F2DC81FA6D50154084D75B967,133,123,10,0.5319710580974012,PASS
FDB8FACA52C1F85039FB3D7D41DEA676144C10D2BEA4860F2F9162D784AB0B1F,125,131,6,0.7076604666545525,PASS
77EA172E3918D481EDCA264730E639A11CDC2A81552747343E9E69ACE73DBA96,128,128,0,1.0,PASS
E48E96161A5CAB0BCC9835518B531BCE21800BF68AE280FE0EDEC712E9BB961F,132,124,8,0.6170750774519738,PASS
2AAD485A8216E48684C10104F16E8212E37B8C2635E7D42897437CA1F3D0C4CE,143,113,30,0.060792723530522785,PASS
F6F59EDC1A179AE30147550FDB3B9908308BA5BD6E365ED80DF3579D56232A28,124,132,8,0.6170750774519738,PASS
B87D9AF7A429537A4EB141B24718D59F2B0DB0BC9B281B998DBFEA3B1433CF65,122,134,12,0.4532547047537365,PASS
680C9071D9C4AF5099B95688BE410D53C49687CC3DAE69276DED0246E4E56891,136,120,16,0.31731050786291404,PASS
2CA2C55B886FF001EBA7D46B70A1C56DAFF16A8871431E3CB1F22CD3B521CF9F,125,131,6,0.7076604666545525,PASS
B0F59B6978F2B58F02AA38D6D29BA8A4E72418B9A000550EE7BC4804BDFFFC60,131,125,6,0.7076604666545525,PASS
BD053DFBD330575377546BC08D4851366F04D78B0B2A65EA3CAACA3E1FC440B8,129,127,2,0.9005235503397743,PASS
3DE5561AFECAA5985421DAAB6F1BFC37CD5DF29DF9CCD8527B1A71DD040F76F1,114,142,28,0.08011831372763423,PASS
23645494AD441C1D9DCACC4D87942AC0796E269FF0A538EBA36BDF448288326C,136,120,16,0.31731050786291404,PASS
4F0C6F90B9B4031A3B2C80CA794CCD14015FB93C5C26E2671889B1AA84312282,145,111,34,0.03358661289689768,PASS
B36E43E17839C2739751D40D9449CCF36EE6C816C03F94DD39005BED4B1AD894,130,126,4,0.8025873486341526,PASS
311EBEB6FBDC46F935699CACDA6551D8DDD9F07AC7F8B461A371A8C546C5F2DC,116,140,24,0.13361440253771617,PASS
E4C0C15BB8A53947356B61FF57D0F2A17C4BF00142214B09A81282630E10619E,143,113,30,0.060792723530522785,PASS
6CC8C495BCBF5B25F9BB1B61CC57DE12B523E761B2839A2C555BBAA94A2AB37F,119,137,18,0.2605890342736178,PASS
1D8F5BC1D007DB5297D6CCD95145F4D52EE8B1E0576D0EF4CA04F6944A4A5B81,129,127,2,0.9005235503397743,PASS
A82F962963F79C59199500EB937767EDDD897229DF33B6FF81F0B73C8AFC0427,118,138,20,0.2112995473337106,PASS
F11BE4B5DF04C7A2BEA7F5D178CB43B90978295608161F3171A08E05A1109260,138,118,20,0.2112995473337106,PASS
DD4369793BB12B038AC4FFB58C290CFA74540BF18FF92B121EEC0BCCEFB425F9,122,134,12,0.4532547047537365,PASS
7C147CEF926CA045B6EF7794945046A1C67FC5F856FF7E5735A8CE446B71974A,119,137,18,0.2605890342736178,PASS
DCE841A35595309B5FC4E1A29EFD9749A56416D52A65306B0C14DD1D0054D114,138,118,20,0.2112995473337106,PASS
E11FC0668880DBD45114A37B96F8A6C4EE57B3DB018E8072F0A1A45D1B290E9A,136,120,16,0.31731050786291404,PASS
69C18599C4235878AC5AD5441A04F782EF80C506F7600AFE5448881E1C155269,145,111,34,0.03358661289689768,PASS
D6C84E34EAC5B1378F59D29C228C0AA05FB60A40C12A5B6338676AA219F5022B,139,117,22,0.16913144470267139,PASS
C2F4D08FD93B5ECD7811FAACD262BF584E32953A9D1942234B12EF3DBB4FC6FC,120,136,16,0.31731050786291404,PASS
11C576A0F726C2435626E19A5B01F6BFFC03E06F8B9B50ABECE9DCFDAF8689FC,120,136,16,0.31731050786291404,PASS
5D0C4D6C6759ECF0A359D8A449E913C1CA92B12D4B843420C2F84C804CB35F6B,138,118,20,0.2112995473337106,PASS
39092CDEF7EC4FFEB4FFBF94597C7CFF76972A0758C32818D1C0F39F5F46CDEA,109,147,38,0.01754895019147673,PASS
204505D41D0D6117E8983A5C75913FAC5A90D5A77840BA8851BAF894AA7AAA60,140,116,24,0.13361440253771617,PASS
81F9A7A1A1984210C270F9B80901F8F84368A3378FC0B6EDF95F6A6AE560F37F,129,127,2,0.9005235503397743,PASS
15CAA38DC9FE65BB1297B038A30D37E7D274780076D3464289A8B6D70F077F27,127,129,2,0.9005235503397743,PASS
F21AE71D42BF42D6C73E780CBEA94BE4BC42B6AC7B3513A3172B2262BF09B18E,125,131,6,0.7076604666545525,PASS
89059F1EDBBC35692D50B9001F1AFAA1CC2C83F18122DCC8F8FF92690BD55047,133,123,10,0.5319710580974012,PASS
76C8218BBC86022515CB45B13F8CF72CDC9C8A6DC2DAB1C639212918E6CC1A25,137,119,18,0.2605890342736178,PASS
549330E8A74CDA0D85EF88AF38718B92F3FD9EB0F5869E51776B9C5D5EF99D7,118,138,20,0.2112995473337106,PASS
F6835A095C9A700204266102FB498C6092D749B369C4515D65AB4B4E1B0DD242,144,112,32,0.04550026389635853,PASS
CE532D47425758F0E7126F3896F6F74A3E40D056C5757094D55AF9F5D36E7F53,118,138,20,0.2112995473337106,PASS
6F308F99D3099ACA79E62EC36C12F5C3D00135EC7B6967B1782B88356E403BCF,127,129,2,0.9005235503397743,PASS
3E7969F550D41D8B808843159853A5F20389B6FC4843A82F1C360CC49DE14A70,141,115,26,0.10416255883043901,PASS
2CADE80334022D6E3C33FB2F2D372B77988203F345268E626EB3D144F7B8784B,129,127,2,0.9005235503397743,PASS
D2DDA04F0313B9DACA67C9240726268CFCFF472BE7F9E00259CF618FB4DEB389,123,133,10,0.5319710580974012,PASS
4DBCCD817DAE0A5E8D7AA036BA32C711BEB57A055A907E12342005A420CC4161,141,115,26,0.10416255883043901,PASS
1A301FDF6C18B7A785146DD44398B25BFABD1FF593D9D8DD3BBB7F0ADD4046E0,118,138,20,0.2112995473337106,PASS
7B5BEFD78729C86F864E9BFAA397E88F268110F7478318AC93A81D4943BF388E,123,133,10,0.5319710580974012,PASS
87B7C35E95EA33DC910005B8ECAE0B70EA8A25F56AC9DCA7035D80F9A9F78CED,125,131,6,0.7076604666545525,PASS
123F6F5CC043407E94F8438F83C909A9C766A468DD0F5ED18DF027961DAEDF60,129,127,2,0.9005235503397743,PASS
DA9CAA0B6FE26C0D02E3BD68D36708670FAF14C82A06564AA0F6F3EB1041F47E,131,125,6,0.7076604666545525,PASS
90F882A4277BCF058812C72CECEE701D3F3096015250A17A0BFC1BB6DC561E88,137,119,18,0.2605890342736178,PASS
E33EF2152562DDDBEF1976B51919EF03A27EF6F483AD13D925CC2CC88ADB123F,119,137,18,0.2605890342736178,PASS
BB4F0806C71D0507AAC2BDD72FE227673FC6237B2F85B2B812A2C7A796F48F20,126,130,4,0.8025873486341526,PASS
C1F3C7D690A6B94C07BF75E9734C78A061B845D0FAD6707883BDFC759CC6E992,122,134,12,0.4532547047537365,PASS
7BBC1B32BD42FB8A28006CBA024D3A717F251694D023BF5F23600504AC613A98,139,117,22,0.16913144470267139,PASS
8091A3C6658C09E29589EF1E6368103FBB83216A7E7B0DE42FC7D9F7E48CE37C,126,130,4,0.8025873486341526,PASS
3F7F585FF78080B4E81186A2F5CD01ED047488066F59D6F9861958AD08588E11,137,119,18,0.2605890342736178,PASS
21DEA10197BD5AE44CF043E703C63649F94F28A4A62F215AAEF55E84ABAB311B,130,126,4,0.8025873486341526,PASS
37292CA398B3F81B9F3ADAEAD577E590DEBC28002EACE2D7548F67F6B53FFABC,114,142,28,0.08011831372763423,PASS
FACD6F1A6F83DC28FB4A7BC96FABD2E014C5A6CCE520BA2E588D042827E380A7,128,128,0,1.0,PASS
F922A0128766CE5BD719585C75D734B0D7EA07A927586CBA0E418405232F0E80,138,118,20,0.2112995473337106,PASS
68E9781E72B29603BBDC17A1D381C8428CB97F82AFF83B8A5268323722A028D3,135,121,14,0.38157390570502125,PASS
6B201E13990BD08DB65882623DA05C4E96D35BA0B8AD4D280D79E71A94110F7C,139,117,22,0.16913144470267139,PASS
CCA1D326215F53F94612C0C4425539CE27A30BB2687CA722E532E4A89C62F697,135,121,14,0.38157390570502125,PASS
8D050DD88B78B32BC2222465A4F25C622EE7C1CD60881F69B8259AD0B43461D8,141,115,26,0.10416255883043901,PASS
63876D91C963257D68B7D37738387B773BE125C1538F3B095DA5F2A076BADC11,121,135,14,0.38157390570502125,PASS
E96B0CC9C6E4E85262BD427940903C07CD33A8D4E31274A81323474F2A4CF302,141,115,26,0.10416255883043901,PASS
CDE3A8146115F22B08B30A499D01AFCB51A80D3C8B19EF74AAE4B0C9C43D2544,139,117,22,0.16913144470267139,PASS
D0A959E320041FE56A05160F7683BF61A335F9D99C34ED3B37A060DDEDD7F781,124,132,8,0.6170750774519738,PASS
71F7DE23309AF599183611B128200A99DFC4AA36E5F34E06A22732A47C391863,136,120,16,0.31731050786291404,PASS
B77AC7E1941DA581855CAF7A14B84604C09A26AD657486EC3B34641524F3903F,135,121,14,0.38157390570502125,PASS
5ECB8DBEDB3AF58F07AE803B97028C6317893850D0B4B8996F6DB4EC7AAC9324,126,130,4,0.8025873486341526,PASS
C77C80FAE333C931A0E37F0AD62BBBF3EE3D5FA51F8857FF1D8FB374BF186A21,112,144,32,0.04550026389635853,PASS
305812359A49AFC5C44A77432AA9FAE5C6EC90973A6973570B812907E6B67786,131,125,6,0.7076604666545525,PASS
CC0B087DD2F3539DF95855BC29568CC3EEFBCCB789AC9BA4479D095109D0ED6B,123,133,10,0.5319710580974012,PASS
22C7D3726B4CD5E3F395D103370D0C35F7B5D9904A9B1681E13FE13C0DA5F2B3,125,131,6,0.7076604666545525,PASS
5891FA3B60C142B6C342BA30D3827A769BA5ED16509D447FBC5F787A008BC8A9,132,124,8,0.6170750774519738,PASS
184A9FBD2CC74080E99553C26F8554C9953B39FE03BE456982B9310135414653,138,118,20,0.2112995473337106,PASS
9D80F3D0849F1DB2B11E48663A825D745CA9A0BF4E4127F16D6CFB10F8419D22,133,123,10,0.5319710580974012,PASS
C434B36DCE7B49AFB33AD3D0CC910DDF9ECCF5DDDFF1B9161919387588894177,118,138,20,0.2112995473337106,PASS
B72CEF920014EAD91405F21DEE992C1B5F1A6C7D176E80943C9F9699B26A2241,133,123,10,0.5319710580974012,PASS
9A936D55FB2BA03E593FC71AA90C5F7607740168732F0A873267C41F407ABDAD,126,130,4,0.8025873486341526,PASS
7B9D46D7D703F55D1864A1CB6742C68200396E6B0870F6E74FF8E754170E6DF7,123,133,10,0.5319710580974012,PASS
F721BE0FE2DB5FA28932B7B04E5B44E8FB7FC4A086109689B4D64406F201997E,129,127,2,0.9005235503397743,PASS
A70537829F2CE01AD3866C362ED6B4D92676F945BD3EB3C0381054293AA2041F,135,121,14,0.38157390570502125,PASS
20684E6F4F248B83CD0F367BDEDE228FA22F4F25A881375AFA6479710414EDFB,126,130,4,0.8025873486341526,PASS
297A5B994B4754C8756B605BEB9CA67FA69E1613C60B91A4269B28113234CFD2,131,125,6,0.7076604666545525,PASS
869C0BAEC782ABAB7E0A91538BC3CFE377B574E2B7AD830220A6E7389388D950,129,127,2,0.9005235503397743,PASS
33D41E7E4FB1FD7F3DC125CF18DA16AD664C68895BE28FB190633A9CCBA05DF3,120,136,16,0.31731050786291404,PASS
3536E4115BA55A4CD8DCB0E11057EF83A3FE3D07AC5C1A28C9E52CE6392A3235,131,125,6,0.7076604666545525,PASS
8462DE236FD0C663154FA89B0B810E56764867B14D052753C994B18070547A16,141,115,26,0.10416255883043901,PASS
EC5B13D1497C111C7F2149A0421870B4D13BDFC04BBA09FB71ADE0C36886987F,133,123,10,0.5319710580974012,PASS
E64CC221251090E4AB38CC4F58E3047E2BB569302A0F45857ABDAE054F3809E2,141,115,26,0.10416255883043901,PASS
BEC4F11F6A9F835EA67D683ECD65B7A676AD1F309112D8B24447CB07F8BD2182,123,133,10,0.5319710580974012,PASS
4A031033D2A4A1E43599C2C1065503589BE1FFB47E298327F8EA95725C567F83,134,122,12,0.4532547047537365,PASS
5BEA3067065EE412B934643B3D1F4F49072CCA7E839E159A5AC8A8E9427DAFE8,128,128,0,1.0,PASS
415D4CE62EF6F8480EB3AE8110A09F3F699969016BF8BDC0E33A713D24B4CC65,131,125,6,0.7076604666545525,PASS
3031F95EACA66859A2DBE929B31BAE344CF9351CCA99083C6CD5D211C2FE480E,132,124,8,0.6170750774519738,PASS
67F31C04D88607E6D35238B7C61575165E69ACF37F96E4C17F98F8FA525EAF78,118,138,20,0.2112995473337106,PASS
53F4F30C653234A4237A0CDC6B706C7FF9D0B094B803236A37013D1E8DA60A04,138,118,20,0.2112995473337106,PASS
9CC10246971E7D98457B69E82D0396C43AD5A2745BDEADE724414A7B2DACB9BA,128,128,0,1.0,PASS
2F3B2B7406EF1499C51922FC58467B97B2FFB013810E83C47683FEC9D8A915BD,126,130,4,0.8025873486341526,PASS
6752B0451C582DDF9592ACBFEB949762FD31E5940784F028AFDBD72DBFA1563F,119,137,18,0.2605890342736178,PASS
6C8776A4F9427D79E612459C82CB22302F66E3E1C13A76157D119FA0588993C9,133,123,10,0.5319710580974012,PASS
4C9E7EE67606C22552F21C721AC8DD65296E94A474BDFBE673F21D10BE3E0E47,124,132,8,0.6170750774519738,PASS
81D8A382CD245563AAF5A93673F5F3EA0E0F2420DF853650B2A6E715D16565CE,129,127,2,0.9005235503397743,PASS
44F46226B2D7AD93E0AEBE522A53E3BDF401D97EC80271D26D63641494F1CB25,130,126,4,0.8025873486341526,PASS
102A829DAB8562C7D62722775136BC8F64B6286FC1FF70E4844934EDDCD635DF,126,130,4,0.8025873486341526,PASS
224F792B4D941067100179FBEBA27799B51B931604E728707906BAD5D2238824,138,118,20,0.2112995473337106,PASS
62295D76AFBE399E439DA3BD48E07F6D17071CFD2328CEF9CB196946A4D0AAAC,122,134,12,0.4532547047537365,PASS
E4875242D24FCA546ADF67424184ECE736C49F086A88A0227929DB9789930167,138,118,20,0.2112995473337106,PASS
97BC32C28F4A42A0A28CABB07DA1888CBD14B4FD924C1BA87BF650CE0ABDCA57,132,124,8,0.6170750774519738,PASS
80671B0AB940EDFEBA0F483F515E25EBE5012E7240A76F85F71190E92734979F,128,128,0,1.0,PASS
70608882ED96565952AD89ABB8EAEE81B3AB227214DFB22462966BEFEE755E62,127,129,2,0.9005235503397743,PASS
38C7C4AB053A6708FA9A5E07A6D26E21D9DFC5FD54C47ED8CA228827F223EEBF,123,133,10,0.5319710580974012,PASS
2838202C08ED238A140691C358A28867F62646DF03274A0F19E336B596889F44,147,109,38,0.01754895019147673,PASS
DBADAD7DA9249BA484022AA24E65B1B9685A682986CF458D9F5755C2418DFCAD,130,126,4,0.8025873486341526,PASS
1C98891CB969651B7D0FE1E97C2401488D8F75454E04027E078A1095FB83A162,142,114,28,0.08011831372763423,PASS
50193491431D5C1588FF1D111DA5CC1F33FFECA7E95D01E333C3D3125ABB5C24,129,127,2,0.9005235503397743,PASS
3A16AA8126F71C0B8D8505D775D35F3390FBFC1D0CF0337BC166B6A6D1EB3F16,122,134,12,0.4532547047537365,PASS
BE2FB98653E69275841626046DC34521A177079C273FB6EDD3FBB25FBD352890,124,132,8,0.6170750774519738,PASS
ADD4733DE955BE2CE2D468244F15CA83A46750250B3C44E842E1CE8167C230CE,137,119,18,0.2605890342736178,PASS
F6F4CABF60691BB4BBB6FD14CD897DCA1FDB8677464934198ED20C8468A11EA,126,130,4,0.8025873486341526,PASS
2F86930BAFE3C35A4C878EEE7F4693A2D177A79357480AB58A00A85973A4CB37,127,129,2,0.9005235503397743,PASS
BFB4BEA9A46CC8814A995C79FB2BDF1741396DCEFC43A163CC4D8B2182B57820,127,129,2,0.9005235503397743,PASS
9A924E893F4FFA2B623E1A2A9B3D5782CAE034B19F9A6F4B926C123DA36DF5C7,122,134,12,0.4532547047537365,PASS
755E30C07168C36812196FFF9589FD8899CBAF89DA350C005833DA614566FF8D,130,126,4,0.8025873486341526,PASS
AEB5841805DA2454C02AC3A6356E07CF34627F9D6CB1B62845E24CE9BA820054,141,115,26,0.10416255883043901,PASS
74515AD766738A309D8A44932F30359E525AC271E2DF87ED02FB63F236C6B941,128,128,0,1.0,PASS
CCDD6161DA25D29214F57ED0892E84FA50C8C2D7266635B18148F43AC088F0A,141,115,26,0.10416255883043901,PASS
2010D8695E428747E7D45D3FA855550BCBAF74C8B2C2765F0FDD5CDF91B31098,127,129,2,0.9005235503397743,PASS
3B057CDD6F18CA3A1B5AE7C269BA9C26C14CCFEC56E1499CAC47D8BB9AF613E1,122,134,12,0.4532547047537365,PASS
869825D9701AEDFC7903C4EAC6854DC69C36A6DAAF93B1BA7B5C759E7F97A9EE,116,140,24,0.13361440253771617,PASS
835678CBC179E3D4308534E1AB651C360156638D552122FD244438851388DCEF,140,116,24,0.13361440253771617,PASS
6B2A41DAD11A7EA4CB6270299671935BB799C26CF502063133D6599E2E513E64,132,124,8,0.6170750774519738,PASS
B87CC0BDA24C7207E8C4982E16EBC4FF17EAC7DF087D9F1E9F4FD3DC92DA3DF6,114,142,28,0.08011831372763423,PASS
1C166B86A73A13A1359267E74DC3ADBA8327566DACB6054AA70F2A545C2B061B,132,124,8,0.6170750774519738,PASS
98031F8DBE42E423DE254AFB27FAD3970791DCCE611AD8A9C5CF6D8A5078BCE6,124,132,8,0.6170750774519738,PASS
A6F6D979132215311FD77B00D54C5124C78AF626DB6ED4E4B4B5A1321FAC9FA4,126,130,4,0.8025873486341526,PASS
D1F28391C8987344B526C04EFB7D3474A12A084CAA4423028A07AF9F50E3A559,141,115,26,0.10416255883043901,PASS
C4CF73040B4A7A659063D39D212340ABF01FC94DA2AEFF46F83786EA0C713A27,131,125,6,0.7076604666545525,PASS
2E7094831863D688E2920DC6CC73D0AD17AC5A7EBA9E9E508EAD2AB128973211,136,120,16,0.31731050786291404,PASS
EEBC743A5F8479FEC6B8DE4399DAA0E51BB4E20227694D234210CF25B9E3E722,126,130,4,0.8025873486341526,PASS
7677E4D5718D86CB655FBBD260F02B70BB3DB8845CB3B832F1EAB89E69F056C,121,135,14,0.38157390570502125,PASS
EF9AA676ED572670B663DB83179A1D70400EC8FBF030246874A44D3ADB8FC642,129,127,2,0.9005235503397743,PASS
A80F5E1F66D64AC0CF4991B91D77E288685B2056AE60BDB8E7BAFCEEFFAE3ED0,118,138,20,0.2112995473337106,PASS
AAD47DE452C12A0061AC7BB8187003AD74C54D20DDFB40384BDB4DD2F9FF10B3,132,124,8,0.6170750774519738,PASS
862FB285803DC8ACEF91D0A2FBCE5B28EFA4F548F3DE5555B3F9C3F99F8E1626,118,138,20,0.2112995473337106,PASS
BF5947FA27B271318B16C265DE62C0358F1B15AB99AE208F13C758CF5EC2DB15,125,131,6,0.7076604666545525,PASS
1D366754F4D75CFD8768CDDEBF449FED058F73EA91DD52FBB0A32ECEE1B676AE,108,148,40,0.0124193306515523,PASS
7878B4893C15E903F9936760405101372936DAB65F6C48F1BC3A3220D987EF14,135,121,14,0.38157390570502125,PASS
8476258A7F1949212DFFA4A7B2B5271F865AA60C939096B31AA842D7699CA0A4,135,121,14,0.38157390570502125,PASS
55C7601B7C9584ED51F6DF8D7885140BFA34C3A66C8B0FD4E73448F83B4D73B,126,130,4,0.8025873486341526,PASS
5F7335AB7E9BC0D98E7736D4249CC7DA6737626501ADA09C7D3AA792EA758BD2,119,137,18,0.2605890342736178,PASS
9679D21433C2EF46F838702992C3625EF8A85772614FB228E041D842A8458532,141,115,26,0.10416255883043901,PASS
14F8D67640889CB8D3302420176B152A6FC7567AE79A4ED137692598A7E7621C,133,123,10,0.5319710580974012,PASS
2DA57681647DC3381278CD3B2CEB4D7004702274F99B35897292E102B3A85453,138,118,20,0.2112995473337106,PASS
788572FDB61245F3B2BFBE816CADB852F7C3B05C4309F9D4DF3D67891EE96547,117,139,22,0.16913144470267139,PASS
9D05FBCC5FE77DBCB8EC2703CE5BCC359AD02FF39668E32C6D5069E36472BC67,116,140,24,0.13361440253771617,PASS
6AA3E60E022E2D0B633EDBEA4E0E8578B8B36B891B51DCDE1295B871CB70DD,131,125,6,0.7076604666545525,PASS
176129D25DB2BF42E631496995ACD6071C13BC16E39D0E13AE85DB3E41B16C3D,129,127,2,0.9005235503397743,PASS
446190C183D1DE014D5BFB0C16E47FA7D671E82F7E402E15E08630D225A869E6,136,120,16,0.31731050786291404,PASS
5E92B62B1632AA6868B3E10CF232046512B753C971AB49990DA5D499417726A6,137,119,18,0.2605890342736178,PASS
B14142E7610F0445F8D232E11A0E98E3760E709C63C383355CA92072C519A4EC,143,113,30,0.060792723530522785,PASS
97403543586E92D0414E9771D469058353EEDA8655985F89B66811EDEBC3BE71,131,125,6,0.7076604666545525,PASS
EBF84522E6DBF7498CA176E8D68DF38E749A56CCFC14C91081EB9BAA04CFA45B,124,132,8,0.6170750774519738,PASS
85A0FF571EFAE8152E7586198A2F8114012E68181B7D4E2B46B3291AD5C96FD2,133,123,10,0.5319710580974012,PASS
C0E31675A447F33490FCAB2EC31C9E78B5244FDF180CF0561F29348B74093FBE,128,128,0,1.0,PASS
B303FB88D740A54D8E150562314A5B3E23B4AD4967FE923063BC3E1402D2F835,135,121,14,0.38157390570502125,PASS
237579046E3DECF46BAF500B949DC02142E2E8F20B6C5A49DE2CC1954386CA24,137,119,18,0.2605890342736178,PASS
E5434A860741DB3907EAEFC843B130E129F8956E4732C604CBDBD17B748222FD,131,125,6,0.7076604666545525,PASS
25C48DFB7B9D317FED08941DFCBA47BAA892C2FA8D43204106E36E22CF4726E2,128,128,0,1.0,PASS
FCAE8E0FCE3121A58885D219F5382B28E1AC0D05C92522E7CE299DEC937FBF0B,129,127,2,0.9005235503397743,PASS
71F4E1A8D87FBD8B7C09AE486174A5938954E582165201C73F7A41844D8A5029,138,118,20,0.2112995473337106,PASS
CE191B16FAC7F5FB0F10972E9CE785BE9106DE7DCE7CB1D1DE43D6517B7C096F,113,143,30,0.060792723530522785,PASS
EDEB0A6B6124ACC1E3B2C7C49D5620AE1C4DFBD94DD72F773C8F2CCD6AC15A59,121,135,14,0.38157390570502125,PASS
65D9D07C43184A6C7F3FD3EB136CE0E61284F47118A1399A28F563CE1040CECD,133,123,10,0.5319710580974012,PASS
9FDB33AE9665F463118BBE146BE7B79B4525628DE9CCE66B4126D8D608F2D3B4,121,135,14,0.38157390570502125,PASS
BF0BE9D1DC15ABA4BD45268DA94E4E0AC51CF062786CE289AB3E2E66DCF5C115,127,129,2,0.9005235503397743,PASS
B365A5397F662CF13A992279820738B4B99A50688C6007A084DF21AAE1963A88,140,116,24,0.13361440253771617,PASS
D46E45E6767732321387D7F838F820F2E990C2534550D6F1117BDD8422E016C2,134,122,12,0.4532547047537365,PASS
64AC04B15A4A7E238D45A8B25021F621D1352021F16C4FA905726B1F23173B64,142,114,28,0.08011831372763423,PASS
62C47E9BE73A3233461633DE9EC62825B31EB7C28650701042A2F8ACD028909D,139,117,22,0.16913144470267139,PASS
748051EAD5710FA156F3C1A436F94CF1D8EF360C17300FB13E830100AB08F840,141,115,26,0.10416255883043901,PASS
553E4305FC44FE5A59A183CDB762AA2387C4483EB2C6B7A47897B24F791F04D6,127,129,2,0.9005235503397743,PASS
2BDBD57579AE41BBAEC068F896E51727ED26A0AFDF9D36A60F067BC2DA7824D,120,136,16,0.31731050786291404,PASS
F987EB751001412B3CF72AF8A746A65E20C92A290B317BC95E128003F4D8C987,137,119,18,0.2605890342736178,PASS
32878385A90F4C3B7B9F7F2432351C07197B73F53A6FF4274C84E81734D9A257,125,131,6,0.7076604666545525,PASS
AF94519F05D2439350C74AF31B5BEEA0062866B93FF03EEB97DC8F7036746722,125,131,6,0.7076604666545525,PASS
A8F1B3F209D21AB99169E60A4D8B44A1111F858541C204C5C0549F6840BF3C4F,143,113,30,0.060792723530522785,PASS
C165FEFE6C56AA9947C6D530E7226D69BE247486A0FD2DA6C8AA928AFF1F4C5E,121,135,14,0.38157390570502125,PASS
28AAC9E4BC6D73DD56D8DBD8C46B6EAFF7DB4EE92B321725DD42E7BA79044D0D,116,140,24,0.13361440253771617,PASS
E18F7F1DF5F05827DECEFE0AFAB55323533988D004A374C84DDDCAEDF139F0EA,118,138,20,0.2112995473337106,PASS
E0BE3F4BA137F993AA7C63211B34276DC456BB725A3853BB9983C2A2FBED0F0D,121,135,14,0.38157390570502125,PASS
32C78A0D8FD1A14E3A8CB894E1312A508B86AC88A787A24B4C9D63FD4E9F026E,136,120,16,0.31731050786291404,PASS
944E118281C7B3EE9DE8C964E3F88AFBBCC13F9541349D37155761E4FA19E57B,123,133,10,0.5319710580974012,PASS
EEEE4E89AA1FC3E049986FBBD8E1B692F0A4500D61A6900A9AD0A7145A4E4580,138,118,20,0.2112995473337106,PASS
799D3AE692CBFE578C1E1A9B5812418F159B40B83A469F13C54F3D65002F65AE,129,127,2,0.9005235503397743,PASS
67990DB85947B29491B833C7B72F1F41D553007A2BF507CC7E6E117A68F6B327,124,132,8,0.6170750774519738,PASS
A455DC55E35E76BE12F604990CD86A0701B0412E74133B1726042720B1DEDB87,138,118,20,0.2112995473337106,PASS
1774047E68EE33CCB22CD846E5D39837450A19C2C895BC9CAB44742E0D01C5F4,137,119,18,0.2605890342736178,PASS
3B419C6B1B876A9E804E7FFD0E1138A5EF369134CEE3AB1CB039F842B07711CE,127,129,2,0.9005235503397743,PASS
CD0177FB56305444A2CD408892E70CE0FDE15D22E4638BEEBEBFE7315F84B3E8,126,130,4,0.8025873486341526,PASS
78A06BD48974BE53DA7347281F19454FB8B8D18DF1CAA7153669999E7973E91E,123,133,10,0.5319710580974012,PASS
1987C709649E468B2B3F07D3826D82DD872A708D0956AD53B52A40E5337E7989,133,123,10,0.5319710580974012,PASS
BD816A13CDA08BF467FE696C192CE0BF5C2A2C593D1FF6BC7EE817909B4F84A,124,132,8,0.6170750774519738,PASS
5B3CAC80E378BB78C04FB86D791E276D4E9750A63B6B7DC6C2502EC90B5E520E,127,129,2,0.9005235503397743,PASS
393DE9BD9F718214092FFEF63B39D56985A34F730708D3A965A23E4008C92C8E,129,127,2,0.9005235503397743,PASS
B1118F2134422D967C1C636EAD2F5EACED006200178F084B5D6B3AE8FE098DFC,134,122,12,0.4532547047537365,PASS
ADA6F240F83B4A211E8DE5749C9219E091D47E9FA467488236964A4F4341E254,137,119,18,0.2605890342736178,PASS
58950A7F3A3D48BA76BBA549C2534E055F940192A5C96D623E28D48831AC5B2,138,118,20,0.2112995473337106,PASS
73A00D1947F437503097D4921D41F19509AF4B53BBD820D00DAAE70A8ECB155E,136,120,16,0.31731050786291404,PASS
44B8B08E5A2CF6D2642AF6F01216C7D9FE9E2F06B8840F58EA131CC689FE26CE,130,126,4,0.8025873486341526,PASS
AD2C7C0C3DE498296AC4EC5D1F4A31D0290C8E58B6AFB4DA6BE0A4C312186C2F,135,121,14,0.38157390570502125,PASS
D4195BC4E85E497F2353EFCDB9504CEEF4D90DC12E8A8988782A278813FDDEA3,126,130,4,0.8025873486341526,PASS
FB9F2FF5CE739CAB59635C71D1D9DDBA0A78819DCF7EC53BFDC1BAA0F833B009,112,144,32,0.04550026389635853,PASS
13302AAD1B51627A0FB9A3DF7B7F64A1BAC4AA775F43A0C41E3BBF3C5B5A22A7,121,135,14,0.38157390570502125,PASS
3702C75412B1E4203082C8F7B0164A5A6D7CBA0A2A94784EA17998144A8242B,150,106,44,0.005959526470109114,FAIL
6125E10E431434DE15CFA76B60AB8B9F68FBBBD1145134C7D4E6B30626A84EF4,129,127,2,0.9005235503397743,PASS
3259AB42194E096F3B2294321E217B2496C3AE3AFD317CF41AD5944E12089FF3,133,123,10,0.5319710580974012,PASS
89CE29AC79844CEA06DC6A1DFCE11511AA325C050A42AAAFB2E8482E246BB7F1,137,119,18,0.2605890342736178,PASS
5BDA6303725948153419D1DE218577EB97D78033CEB3882C4F51D33ACF2EA0BE,128,128,0,1.0,PASS
93CC05833989651992B9C87CEB0F2F9D70202B7E3C900218F0E0A35753FD22E3,136,120,16,0.31731050786291404,PASS
5E26A51322CB43CAC27EAD5CC3AE562FFF02A56E38F0658786DDAB280B167076,128,128,0,1.0,PASS
1C7B7A8F3DD1AFFD4E193F38B9B919B7F1BE8A8A459BE2EEB3363F2DEBD8E372,107,149,42,0.008664896726025117,FAIL
9E8B77857EB73EAF00FDB7621D7E1AC0408BBC7A2C3E225756B1B734B496A0AC,123,133,10,0.5319710580974012,PASS
F4AB3EA0134B5158F7FEDA6CE5BA95D61682498C800FB955CB8D55961B1E8485,129,127,2,0.9005235503397743,PASS
13A86EDDCBAFCBD01FC6F8DAE000CE5DAD51B2FAF369EC2E8A9707B786A30475,121,135,14,0.38157390570502125,PASS
E79D0401B1761F56890B8846AD0A2CC2401AB8FD9DA40371DD23C7D8663DCBFC,134,122,12,0.4532547047537365,PASS
1BB11423426410C24680067FEB48E2694C3E175BE9DA03AC135B6F8FBA6166B4,137,119,18,0.2605890342736178,PASS
CDFECA09A79B77CEF3A84FF83F416CFEA5C29B2F6278A90ACDFF4C29FAC6EB1,113,143,30,0.060792723530522785,PASS
F1B88A8B4D0506E3D4B0F78E49B220C07E303B2171F9663E49E75271F6AA8164,134,122,12,0.4532547047537365,PASS
81E4FA0472F24CBD24344FEC396A3F8529508A6DCF3ABA44D21CB15FC51A479D,130,126,4,0.8025873486341526,PASS
FFB48D5224C857D46611D812AB1C4BB634C45F525EB2ED7625412351FB73ECD7,125,131,6,0.7076604666545525,PASS
1721C3AD0957875BA869633E2CE302517BCEF2541023373FC17E3DC01D7AA6D0,131,125,6,0.7076604666545525,PASS
F04F35F4FCC3FF63711347E49CECD0800459C60925A4EC34CE930F5F29EFB27B,124,132,8,0.6170750774519738,PASS
153C9BF902D4AF1D74D4DED6CCB448C58E7762D06BB369E534AD554F17C5EDF0,120,136,16,0.31731050786291404,PASS
8903E4A836027931FE069A98A8C28A1817025CE5AFC7592D13F7EA8FE4B79A7D,131,125,6,0.7076604666545525,PASS
F8026D58551FCD4B59E5643B77E6EE70EF61C92CD2ADB55753BBAF70B02C5729,118,138,20,0.2112995473337106,PASS
B8A3439139ECEDB5F3F2DB325351E0456FBD101714A5428EE0297612308FD8C,134,122,12,0.4532547047537365,PASS
E1F25C1C43F1FC48A535C9A0E02588B33BFDDD70C236EE3FCA4A0CFC4E271967,126,130,4,0.8025873486341526,PASS
7ECF88ED63B46BA37B70A45FED0112AD728EF8A08DF2FB481A3C0D72A84115F8,127,129,2,0.9005235503397743,PASS
F461B118D37C5220FDC962AA98F71E1DD838A07C14B489B97BDB3CD6B82E3B4F,125,131,6,0.7076604666545525,PASS
514E8139F27C440E2EAF5206BD1025060CBADA0D3A324D24F9BC8C4E44BF3D9C,137,119,18,0.2605890342736178,PASS
B596EA8D4919A688A0247AAF24B95715E061DF99287774384B33918921BBF18,136,120,16,0.31731050786291404,PASS
A35491FD2DA2207D75E6E123E1391B9A622D228EF0F7E8B41F55D71869A6A95C,127,129,2,0.9005235503397743,PASS
588A3665C09BBE0FE2AF8ACAC13AF8693F8E0269BA3C1EB0F70477096DE6853D,127,129,2,0.9005235503397743,PASS
7A0F2207C91FE7B52D7C3336F001E17F6C4FEAE36A7212BACDE242A4963519F8,125,131,6,0.7076604666545525,PASS
CC19202A33FA72293B63198805C35742F16C10E9E5CA93A90F62AAD1B678A48C,139,117,22,0.16913144470267139,PASS
330F3DD661C215678290E03F43EAB97EEE142DB7140DE7774C5A298B83505A3E,129,127,2,0.9005235503397743,PASS
EE30C7F1C52F1C0A3E66517EEAF77F76E08D6C73DC5FC52BD890108C529EF58C,120,136,16,0.31731050786291404,PASS
830DA68C94DEA8CFD88D6032EC77166C6D917AA78549BCA89ECC277AD1D27762,127,129,2,0.9005235503397743,PASS
BBDBD50F1EA743A76128D91B094ACC13E474A0727E25A24BA7F6C720819F79B,129,127,2,0.9005235503397743,PASS
8E9BC44134F411F1C2EEDEECFAFFA0FCCDC6A75CEA14C2EDAFCFE55CB90BF451,114,142,28,0.08011831372763423,PASS
355F67AFC5CA1A12A2C5556899DEBC3E04D601693B9E16E317D10CAAC8F8756F,126,130,4,0.8025873486341526,PASS
381C5F2BB4315144CBF628451C1EF1FB54741E9FD800CF1BDC4CDF87A1223F23,129,127,2,0.9005235503397743,PASS
FC2FB3D48BF26A8C0614B04AF65A2942E8963921AD5D9CC652B22518700A91E6,138,118,20,0.2112995473337106,PASS
7768EABEE21426E32CE6000A1D03B7A4B6FC9E249CB063A4453BDDEDF3526734,128,128,0,1.0,PASS
5B47C93B4CB3A2FEFB56C69918123C46C0981B8BA89D3168C1A87F66773BCC07,128,128,0,1.0,PASS
22CA89DD9230C564B439D8499D827B49EBAB26D7648C11DED19A8E68A449C5E4,135,121,14,0.38157390570502125,PASS
5FB96CAE09D1398B6194F3973FF2E1E4EFC53303DF09B832BFF156C03EA17A0E,119,137,18,0.2605890342736178,PASS
2B0B589E3A3DEEFD9442398287F7CBB8E89ED0EE6E6939FB0A791FF77C90931D,116,140,24,0.13361440253771617,PASS
F54B16A455AD414407F416EDF6C9992DAF6E48E20E73EB9389D58DDC82B3AFE2,123,133,10,0.5319710580974012,PASS
B09E0E766DBA1AB57BD48351CD4616FB29E17F994C1F98A5C1D624A6A25537AE,124,132,8,0.6170750774519738,PASS
1C81A2CB6208189B0A790706519F1CF41186CFFEA769EC8F724C03520607C1A9,142,114,28,0.08011831372763423,PASS
C93988CBE92EB532F2D8B6AC5D35B119EB6F41C3AD1B7193CB9C3EF7CECBAB3C,115,141,26,0.10416255883043901,PASS
F6C552BA98D505C45DA847ED965F5FE406C2CA61311D8621A6A9A115560391B2,136,120,16,0.31731050786291404,PASS
959939044B37EA3FE39F14BBBF07F0AA97E3E42BBC721DF039A49072B8BAE9FC,118,138,20,0.2112995473337106,PASS
D5B26067833F29AC4D65E1D19A9E050C14BC43042CE9B9690FE9909DC3704C96,137,119,18,0.2605890342736178,PASS
E8927FD2E0C0F36F7432B97F9DBE097D041DCAD2D506E278783F329E4336B16D,121,135,14,0.38157390570502125,PASS
96F2CA70358A32CF15B04990B60AEA7136FF622CAA62F96B4F432B0D953EBAD3,127,129,2,0.9005235503397743,PASS
6425D219543C471CD6DC2D01FB69594AE09D171B6868DFA216D6A455AC99777B,129,127,2,0.9005235503397743,PASS
1F8346656359682001F2CC8670F0FF811A06F7E6574CABCD71E4DEA7617B461,132,124,8,0.6170750774519738,PASS
81764C904153595C26EAE4806262B14F5EAFCB7378AAFF2D57031C8A47EA0D48,134,122,12,0.4532547047537365,PASS
C524164A4B6F26CC801C4F303C88D865315C7B84F2E7B705593BE1504359B0CC,139,117,22,0.16913144470267139,PASS
FD5CE29474E4D5D5F69FF66B4680BE701B6585E725055AB3DDA621698030368D,126,130,4,0.8025873486341526,PASS
9A166E06BEA3E7B4F2C7B7D8E4BFF383E9AF456BE5E5ACBCD1A032F1B4B9FBD,111,145,34,0.03358661289689768,PASS
350E64763113A7F2F91AD2EFF4F8D8B114DD63785451B3F0543C9B153715A222,128,128,0,1.0,PASS
F644F1DCDAEA51FB3416E05447081F3FAD0B87F8269CCD769C64BCB2A1C73DFB,120,136,16,0.31731050786291404,PASS
C5E9437741229ADB6823FBDD7F53EE039CB205223828F522789FF498F7935A22,126,130,4,0.8025873486341526,PASS
3E368930D04EBE87C9C55E5746BEAD9EB903CC9A2B064078708D66AE0EE22787,131,125,6,0.7076604666545525,PASS
4ED9CC0D5FFC212D3C3B8CD2B92CEE10F75EDF3B13EE2BCF23E5EE8E171A273F,113,143,30,0.060792723530522785,PASS
DF57E0483A83FCAAC5F759F9150968022731922B8C62C0EB4A0137418C3A8F35,137,119,18,0.2605890342736178,PASS
76E1C30FFBC07FF26DD7720F5068BE6DA78CA60885B7681C4EA44F4FE60C97FD,119,137,18,0.2605890342736178,PASS
ED9764F382CF224F3FBA137F2369D8DEF04D4F0A2E6B6A1633FE6EBCFCA250BC,115,141,26,0.10416255883043901,PASS
DA190612D409AC0A9448DC6D830675E193B8046F9A4B99FC6BAE8E7138861274,140,116,24,0.13361440253771617,PASS
94E644B84198EC1A080E0C83879509B7FB883F6D3DE194D529D27F053C9D0EC7,134,122,12,0.4532547047537365,PASS
875627680A4514DC10B4C41356F01345AF8D122FEC928218E39B61459B991969,143,113,30,0.060792723530522785,PASS
90039692665E67D92C55C86E9D0E491E638B3D47299F6FB1C83CB769A3A77972,125,131,6,0.7076604666545525,PASS
CC3799D3A9CF8245CA514DEFDC54378E37ABE97B6713D41FDC90795CAD2EDFA,116,140,24,0.13361440253771617,PASS
AFB7CCFE506FAC59CEEEED5A0ACD0114080E936E4E9616AEE9B447E2F079BBE4,121,135,14,0.38157390570502125,PASS
592F15B2E21F391977161486C99B5E7629074BF1D7B600C76291C9B0CC342FAC,131,125,6,0.7076604666545525,PASS
AEF8757528608C0F191CCC7B0DBA4D8E8B340260E015647E07D7E34FFCCA7425,132,124,8,0.6170750774519738,PASS
898CA15A7672B0B02EF1E28A3F4167966AA23AAAFDB16E853D21C429CEB05EC4,132,124,8,0.6170750774519738,PASS
7B11C32CEA93B1B48A18D896A8DF2E0B9A013BC8113ACB8E267A9162D047FFD3,132,124,8,0.6170750774519738,PASS
2CCE8E2E38CFDBC6EBB575CC3ECDE3FA4FA85DF87E05470412A0B704ABD70EEE,118,138,20,0.2112995473337106,PASS
5F356CF64A8826B8C36B56C430E44E4D6948E741D4B5CBC6626066FF7F433F7B,123,133,10,0.5319710580974012,PASS
2DAA2E46939FD1A17F9761B53015657F3ED716FEE7AF9F6FE535E2FDFE456770,105,151,46,0.0040402749798920095,FAIL
673F00EA196A74F635633FF9E1ACC23C83BB4EB86AE31D60DA6B2D60F8341459,126,130,4,0.8025873486341526,PASS
9C9DE1EC90F6F5BE2B332044C1395C220DF07FB2E5B6C9A760776A3B3FC15852,125,131,6,0.7076604666545525,PASS
7CD09B3C3D00E33525BC3EB7A5E9BABC7F7F16991ECA910797A848BEACD1FBCB,116,140,24,0.13361440253771617,PASS
15F989C69764C837A82AF50CFF4574A0ECEAA438D88D93BA2E2EEF935A3A824,130,126,4,0.8025873486341526,PASS
5FC9A445B90A449A2D6D7DFBB40DD061652E3928E154D0518A03729B1DA84E67,135,121,14,0.38157390570502125,PASS
D000F6BD63E91871B882E70D07CDE19E802EF542FD7F7A5F426B608648603C6F,130,126,4,0.8025873486341526,PASS
C44AB01CEE7A13490558AB3663AB1D287808AB42FDCC46A219B9B2FD496C963A,135,121,14,0.38157390570502125,PASS
9A44DA75A069739A7DEC3C460788D90D75038B75523C2E13EDFACFB42FF56E3A,122,134,12,0.4532547047537365,PASS
158F21E4BA88CDD7C599DFD956D1134FBB861AB985B978A0AA28B97990E28853,129,127,2,0.9005235503397743,PASS
4BA469766E41CFBB3E6C2B40DF9B934E40AB2D988FFBA7269B8609BA1E4BD859,123,133,10,0.5319710580974012,PASS
ECB170503EF6B4A13F4FB044B2A317E7DF2C28B86DCE283EF4ACA78F4E5F1B47,120,136,16,0.31731050786291404,PASS
F3E887C7671023A5E352ACE6F10C535487BD6BB9AB72CF4AA5C288EE1FAE9436,123,133,10,0.5319710580974012,PASS
ABAAF57DE33CFB333163DC191E96F699BA0CB76B1A2C7D69DF66204D6A47348,120,136,16,0.31731050786291404,PASS
66F91A11C2A83CF6719F5C121C03C3171A14CEA0FB0C703371C232147F64D52,140,116,24,0.13361440253771617,PASS
8C1E694A5CC7E2090A07345342AC4383B1639E69B09C441A14508EDF18F857B1,143,113,30,0.060792723530522785,PASS
E762BF1B66A09F3A76CCF768FA281CD9E8278DFA7ECAE4993B4209383ACA4821,125,131,6,0.7076604666545525,PASS
14A972694C5661F0024CB266BF4F87D615FB3F4A6B1DDD7F1218A1904339B6C4,130,126,4,0.8025873486341526,PASS
4DDFF7F5139B49B9D664AA906275FD696F223D71DF595C06A04D525ABCBD327C,117,139,22,0.16913144470267139,PASS
912BCEBEE047320EC0E5FC484AA875C7610DCDD3E13D8A9D335739028C109021,139,117,22,0.16913144470267139,PASS
10FAF8DC620462797E9246BC560BDEA0369BA794A4544D1A94067CB3B048C4BF,135,121,14,0.38157390570502125,PASS
ABA15BD11291A817D383D824851B4E5EB06BBC18D617761F7E2F56C977E10B9B,126,130,4,0.8025873486341526,PASS
6ABB9D8CDCC821823705C6AED3C855C6AA7BE645C6DF4D900B711739FA0FCD5A,125,131,6,0.7076604666545525,PASS
36E97A06CAF5A01CDC1CEFCC85DBBA8454B9EAD2567AF9C9108B4F31A234B61,129,127,2,0.9005235503397743,PASS
8C713A5B91EFB8432BE28E83D354D92581E7897F33F43E02BE6C6C44493D5350,129,127,2,0.9005235503397743,PASS
E6A27602EA5B5A0997026C3E35B97A5D13EC035FF44AE4E58DFEA4EC2533F61,126,130,4,0.8025873486341526,PASS
E939FDB4EC7985D7DEA4F7EC176006074E5A59AC9CB4EA2ED2B0339C3697D142,122,134,12,0.4532547047537365,PASS
8981D0123046BB91E78A86BFFCA042084B2CE5334F21FFD435BB01566839B626,137,119,18,0.2605890342736178,PASS
84093030A9DD9F7395076AFEF75B15AC2D0B2572CA01A4B5EFA4E619F4CF0FB3,125,131,6,0.7076604666545525,PASS
8A83CB17350F73ADC413A5E2E2630D7A90A8C39509026A50E851AAFF47349C0B,138,118,20,0.2112995473337106,PASS
40251D7436131BE89FAC47DF2D1F6A38355DFE26242F0993F896222116E9E5B4,130,126,4,0.8025873486341526,PASS
8D781414495F9D80A1F41444E05491725BC00932C6C6FC86B78C59FD4100EA0E,145,111,34,0.03358661289689768,PASS
6F4BD3A35204AE53203C5D3E83AA1F1FB2D5A3BF2CEB1741E292B2173F03989B,126,130,4,0.8025873486341526,PASS
E72114FA968901993CC883E70F14E9D21B8F5BDBF23FD937EED9404ADA2C2126,128,128,0,1.0,PASS
DB39ED0CF680A422DBA24DCAE215A5F8844C6545E9D880D52CE1F973C6FB47C0,131,125,6,0.7076604666545525,PASS
D25C0C54EFABB857BB4B9B26882E49A44D4BAFFF29BE08B68D75177B27ECCA0F,119,137,18,0.2605890342736178,PASS
36A5C2C12B33A04DD89970F4A5A3EEB708183BF627F75FFF7A0BB6AEB0C60123,124,132,8,0.6170750774519738,PASS
6B5C3F930AD7747266907D3C998F4C79CA6C4ABAE4ACF4B1310DB1DCB31BBBFF,117,139,22,0.16913144470267139,PASS
4535D97B4619869EC084813054C8BFAB50FAC74422BE663A759171BBF2A8B9B,133,123,10,0.5319710580974012,PASS
4B91A4E17DEB78F3F584BF660A3BE9499C1741B8C18C1F84AD3820C6ADED0BA9,128,128,0,1.0,PASS
16F8D28649CF9906166244E3E0C5BCF2B1326CB10753C3617DBCD456687734C2,133,123,10,0.5319710580974012,PASS
81073814D7C9C818B37B243643194CEE951E87CFD49F66E20CC34D66BC095B29,134,122,12,0.4532547047537365,PASS
7FBFCB629B47D6EC348FBE301F976DA55946075ABBBCC56BDDA72C8F6FFCC10B,109,147,38,0.01754895019147673,PASS
65610CB543E9A5D415241073A8446871D62712A60A962A956D80DD800A264FE7,146,110,36,0.024448945310089426,PASS
E131B69BE19C9922690715C15987D6B7A3A082247E1BAE33A185C3293F9F19E9,131,125,6,0.7076604666545525,PASS
5D81EBFC991420534A928D2A6A9A8F0202F6997FDFA4D9C0ED64360A19F1EF0F,130,126,4,0.8025873486341526,PASS
A5421B3696BEC3DD7DD08C89D356A0837E76806077A949AAE0E5598C3C3C6160,134,122,12,0.4532547047537365,PASS
B1382CE095370660C7DAEB6CB49F59D38922A56EA14A17F19807DF864BED686E,128,128,0,1.0,PASS
ECF89BFA855986C92004E143E9B1BBF8C21C53C489B4D39C072FE764A03F2FD6,128,128,0,1.0,PASS
C30950C041C4B3F6D1A1C340967DE7AB503D21826D30E9AD702FBD05F7EBCA6E,131,125,6,0.7076604666545525,PASS
CC8AE9689A9B7708648914DD639D42803B03A16CD6F11D53D0FE073D06E6D57E,131,125,6,0.7076604666545525,PASS
32DA2786DEA48D6F5D5E9F82B22C38C07077696E1B8C46B5046C84C49ACFBA69,130,126,4,0.8025873486341526,PASS
FDF58D1339BC4011FFD2DB25D98FCBD203E76D189079A3ABB35B98128754B855,123,133,10,0.5319710580974012,PASS
A52613897BCA9BD865F6D4784EDE32A4439FF42649692D49EA3F7D1581C20A5E,127,129,2,0.9005235503397743,PASS
3C920A7D74E8AB317BA1DFF45C8E61B79027666DA837CF699181CA22166C633A,128,128,0,1.0,PASS
54FAD22F63A00FB4AB42E6EFCBB3ED7B6421C4059E2BA39D9AE6916ECB280952,126,130,4,0.8025873486341526,PASS
D81BE7861F8861B6DD957AB802A84BDB57F187F0B1CAD5EC7FADDA35FBE29464,117,139,22,0.16913144470267139,PASS
39EF043E0B28EA6292C35D2E07DD2DA00B95C6F3FAC32BD04F4F03AFF17A61A2,127,129,2,0.9005235503397743,PASS
464D2F86B7622F4C705B2C870306D7B555525AC1D775616AA58210BA2CC6D0E1,136,120,16,0.31731050786291404,PASS
C7231DC0D1F0F4E69D432DE0DC533351CC2DFEADD7B9D076A6821B17E0BE7AB7,120,136,16,0.31731050786291404,PASS
B984A64D94AF38A97EB81D624075FBCBA944205E948A26EB2636D97C8374B2E2,131,125,6,0.7076604666545525,PASS
98FD55A2A68CEA12688585765445FD175381525592D0B29C22B4CE792975BB02,136,120,16,0.31731050786291404,PASS
5DEA3818150846A885C02F09B82F5F53B5E68295CC997794DFCC434642953CAB,135,121,14,0.38157390570502125,PASS
2FA780CF4DD555A99816B3BE4C421CAB9E5A698E3C5C167EE7E5A94F169EE12C,123,133,10,0.5319710580974012,PASS
8A2CA96BB291D5C7B3094CB948E56FA72FBA6D2D0DC459A43EEA8C386BD73445,126,130,4,0.8025873486341526,PASS
51DEFE97F96C641137FB274864E950BF650C4E51B22538A367AD5A459F273829,125,131,6,0.7076604666545525,PASS
4552C30DF5EC6B6138D517AF1A7ED0CCEB585E5AAEFA5F0FD5DD0771954FEB00,118,138,20,0.2112995473337106,PASS
C4B62EFFB0AC1CD7A0D7029F3C5A5D8F1CC8113E5D492672B70E17D04B59FEF5,122,134,12,0.4532547047537365,PASS
281348E4CD884B76F2183607C7D1B4E0D82C8005D476DD0A785DC179C029E056,143,113,30,0.060792723530522785,PASS
9561631785BC1A8576C7E2AB924180F9AF5174B604A7321446B8017EE40CFFEE,133,123,10,0.5319710580974012,PASS
24E2AC247AD51A922FB43E59D717EB3D6DCD69A9D56B82B572CC221F108412E4,130,126,4,0.8025873486341526,PASS
DE0236F9B15561D0DCAE9F4C45D53AA9AF58C469146D7937A5D2195C5DD2585,128,128,0,1.0,PASS
351571248ED2972660FA323DD4ADED3C105C308BCC36F92434239DCA338D4F83,134,122,12,0.4532547047537365,PASS
E7A6B8A42B5F361D6559AE35800B8AEC013283FBF7045B319C5A057C1E3D27BC,129,127,2,0.9005235503397743,PASS
F7F2A654A1F011B8B1D285F516A33CF4A81095660241BACA8B3350C529ADAF21,137,119,18,0.2605890342736178,PASS
880DD23FEED869682D80D87AAC7CB47509C890CC07AB545F8EF230DCE0E71EDD,129,127,2,0.9005235503397743,PASS
74010ED9BFB62C203B0EB70C28F30DDA6205A8016F011B4B48D2B001A12844A,152,104,48,0.0026997960632601987,FAIL
48EE2448159167D29ECBF971F8B68A477EFF7FA9DA20EC27E2BB6D93F84E84E7,116,140,24,0.13361440253771617,PASS
23AD3F71A5AE500DE45B46DB44A9846A3EBB5A597F85332A64D8697B640C13B5,128,128,0,1.0,PASS
F50E19452AEDEB2177BDFF37458EDA2B420A0AA21744B5F45BBA17CF3F0B7FD9,117,139,22,0.16913144470267139,PASS
57C8AB3A50C31CA807173278704DB63E5CB139ACD4D367F706EF1017EBA0E32E,128,128,0,1.0,PASS
E6E837F266EE6688B90E7C43D384C0B096C3528AF474534512CB74F83EFCC62C,129,127,2,0.9005235503397743,PASS
C64E309693875B92C353D284B903778AF0E8442B2EF67A73361C507FBC518EF7,127,129,2,0.9005235503397743,PASS
730A381D44F49D9EEC751593B50689660394F9CE8CC23E90AFEE5EC77193E8C3,127,129,2,0.9005235503397743,PASS
ECFCCE6A84E98368A12A33EEDF957D4276FF1799BD39CE1AD366E2F7109BC3B8,115,141,26,0.10416255883043901,PASS
970095CBFC90ED8F10A02C0464102A6DA42C1B9C8B1C762365CC08FEDBA645D7,140,116,24,0.13361440253771617,PASS
8B72F821B158D4C499D6820627C8D710C4D0B33CBD34468FBD2FAC4CB5432887,136,120,16,0.31731050786291404,PASS
3B94FED37E2C496CC2DD3616271C9669F170D8CB9A543E05A854EC8BD4D63B6C,125,131,6,0.7076604666545525,PASS
B0E39B5DD6993A527777F42B076F39E05C054785101B1347FCA77195F004C43E,128,128,0,1.0,PASS
A8DFBC67002BEACB7C73FD7E25503605560F4200E9FAACCA014BF6895EB57AB6,125,131,6,0.7076604666545525,PASS
1228A57876C20E0D3B78D8B0ACB0CED1C22FEF27BD230C8FF8BF7488EE116CB1,129,127,2,0.9005235503397743,PASS
22B2DA4AB3D84E0999B721930382537CCADB9940FFBAE5F05E236B6AF19DD709,126,130,4,0.8025873486341526,PASS
80234A2D49AAA282CD785E4D355E602615DF640C939ACE33AA3641CBEB9A04A4,140,116,24,0.13361440253771617,PASS
750474BE562ED262BB6FD849A3AA013EEC7DEA79484C8195D6B779D5C558F437,122,134,12,0.4532547047537365,PASS
5F5DA911515144689C3D457274640A00ACF887F9783DDEAE017C45B69DCEB5D0,132,124,8,0.6170750774519738,PASS
44C0FDA1DA8BCBBE4B78E8D545FB6681EA08893C57F5D0EDBF778D55FC1AA028,122,134,12,0.4532547047537365,PASS
4FE8E2B3D613B9033C5370C9629FA65ED4E9F725876F2FE19E62EE5B4B39C403,120,136,16,0.31731050786291404,PASS
105B961A4D714121B8DF494E8DADA2A77EC64A3248DFA686FAB68A92BCB5ABE5,127,129,2,0.9005235503397743,PASS
8EC9D31BDE9164FF8C315052C02B8A90CE49F2EF7BE84DF836897E4F7AE81134,126,130,4,0.8025873486341526,PASS
7F7F9CC38552D7567A7474607AAF3CF88A021199C7FAEF72022A5F5C3EB61747,119,137,18,0.2605890342736178,PASS
A3D726B4257B24F610959BA537BC850A22AF78F17C34CEC57DD084AC0539B478,130,126,4,0.8025873486341526,PASS
3E2816946E803E6B69FAB6507B89B8372853E494C111BD8DEDCAD936B6DE2898,129,127,2,0.9005235503397743,PASS
3170414DBEB941BD724BA326F3E069C8ADDC9A385CF0505627FB4BA3E03FFD66,124,132,8,0.6170750774519738,PASS
3F74E316E4CE602FF9C59B099E272537538ED8C3290D39E84AD4DE4B5BC14899,127,129,2,0.9005235503397743,PASS
DBEF47066D72616B646AA5AB891981B3F7743F1A72FA227B8BAA01F639B98E95,121,135,14,0.38157390570502125,PASS
7AA6012FEC170F664EEE6699D442F03747431B7F31268F4D2C252565DC85DAB2,128,128,0,1.0,PASS
4325CCE447C8DECD8FDC9345C9CD2A8F3530AF9FE9A3AE7E047A694244FF4545,124,132,8,0.6170750774519738,PASS
85C5D01BD2A13B12521362101D5EB8CC9ED09EA8C0DCC8FB6708DADBFEE14DC0,134,122,12,0.4532547047537365,PASS
5D38A7C0F5A35955089B38EC3B90B7026DB537C02BC995FCDC7BEB1AD89B182E,125,131,6,0.7076604666545525,PASS
C20C5733CBF5A0D13ACDAC82F2502F42407A2803DE34D85BE58052BBB617CB7A,134,122,12,0.4532547047537365,PASS
1BE1588243BE816C0F07DF3A1A17A1AB39B25769C6FAEFB26E8B46D7A44A0283,129,127,2,0.9005235503397743,PASS
84DB942155A53C7E794B5804AFD2D7F45864235218AC31E547A8ED0D82433F27,134,122,12,0.4532547047537365,PASS
6980491BACA73E441E909A3B1AD63D5085E78375E82CF0225764FA030D6A13F5,136,120,16,0.31731050786291404,PASS
61D6903925EB9016FFCEFB82A963CBC7BDC00F7B9FD07DF17F6A2AF2FB00097D,116,140,24,0.13361440253771617,PASS
E2A1224158144FF98C4F7CD5D1E4FEA400199B1FA8C26090641ED7C7D67C88D,137,119,18,0.2605890342736178,PASS
A909E92E3780BBC2A216811D85E9F327C07037DECE0DD3B22733EF020866D7B0,133,123,10,0.5319710580974012,PASS
B1ED2861918749BBC82A586E9FAE8E2AA7C9D78B3DA34D2E36AF68B457FDA069,122,134,12,0.4532547047537365,PASS
B4E26B39EBA54ECE86C9221E247E5EBC75B90175C5D816E9D805CD299FDC46A0,127,129,2,0.9005235503397743,PASS
66996DB705D93E1AF4CCF7E5FA41FFB32CA915FD03E5F678F1EB0505C3E7D9B4,112,144,32,0.04550026389635853,PASS
2A9B74B8082A38977850375911CEF0D2B3D2B221CEE7A39E6C7506EBDB45CD94,129,127,2,0.9005235503397743,PASS
2253F1D7897EF019353278C77A2008BFCA0E0857873691AA1E9050363812BA28,141,115,26,0.10416255883043901,PASS
6EE208E10CD704D308D40C35879B5165EB6296DBE28452BB8C29E29D1B04DBD7,135,121,14,0.38157390570502125,PASS
8C6EF9C9A8E30F95E7BC2967AA7C6AF17A91BF469712DC26149DE959B51906BE,120,136,16,0.31731050786291404,PASS
D4F5BC1F23518FB348F048A41257E0712DB5C30323BFF8339E1B08EBFB226FAB,125,131,6,0.7076604666545525,PASS
E0CF73268A9522D57B1242C643C75FA9E7731ABD9FF3D520544098571BC7201D,129,127,2,0.9005235503397743,PASS
91A7C25F1226821D9F1113C81EAD9DA42E354B9A45994ED6489CC11E9BA842C4,139,117,22,0.16913144470267139,PASS
E1067CCC3406F38BE97EE16A7576D6412935833C2DCE2811A74286E8E8C5C1D3,133,123,10,0.5319710580974012,PASS
A11CF6602505CEB4758181AA13710BC46DB9AFCDF9CD0A93DEF8CB682B8A119A,132,124,8,0.6170750774519738,PASS
B231AAC3D299ACEFB359C29BE34CB38DCA340829E26A280AD53E7AFFD3ED1622,126,130,4,0.8025873486341526,PASS
7868FEF8E7D92405D8B2D8A60B6B4D8C914352BCCA343A92E92ADC8014A2C5CF,134,122,12,0.4532547047537365,PASS
645371004EF1FFA86E7182FEBD7485EC8F4BE2B9F2EE51A6637B60CFAE3B19E2,118,138,20,0.2112995473337106,PASS
66B4694D7A921322C2C88136CA28958FD43A4AF121F00B27D34DC72826DC046A,142,114,28,0.08011831372763423,PASS
DDBB29E5EDADB31D18669619D69BDF8921398BFF2E084B29BEA075A467C8FFD2,117,139,22,0.16913144470267139,PASS
59009A20224D263DB835D829BC79F9B415AFC101D0E26FE59946894F7E3C271B,134,122,12,0.4532547047537365,PASS
7BD628182A38A44F95F04EF106B8DC37F97CBCECBD394EAD1E1F5AEF023B0723,122,134,12,0.4532547047537365,PASS
CC6D0CF0EABA7AF57B0DFB276C8C6806A52A4F619FEB6A46AF46803FE3F15C43,121,135,14,0.38157390570502125,PASS
C767422EC1E5B7CD9EF421FB30305B0DD20763EB30112D59D98386F9992A2796,129,127,2,0.9005235503397743,PASS
FFFCB27F3440C5E2B47B96CC5870FBCE05AD9812F1DB514DAE3A3CF3887849AA,121,135,14,0.38157390570502125,PASS
133CD9DB83C141E8CAADE90F41FEA784753A48BD34AB0CD2C0E3BB44F0C67670,130,126,4,0.8025873486341526,PASS
609CD9431C8DB5536EAA6C223FB1EA9D90E928C39A20ED152806224E2618E75C,139,117,22,0.16913144470267139,PASS
FA3A7150C004C2D94D20AE1552A40127C50905447323A036B92E77B23A6ACE9B,144,112,32,0.04550026389635853,PASS
ED28852798E11F7710CB981D46ED3547DA4AD4F30CB9AE8A3FA193E2D67359A0,127,129,2,0.9005235503397743,PASS
305D89280A5297EF7F62B63E81479B2C66B8AFEE006EC28A87C0D05B2A571803,136,120,16,0.31731050786291404,PASS
EACCB2722889BA47EFD8320476F63F2D69AAD3F0411E0D436C4002D83C2C5E5B,133,123,10,0.5319710580974012,PASS
A7C6E84801C35BAB96A7447A945A9824AAFE9D0CB23122E8B46D5EF9393DA0E5,131,125,6,0.7076604666545525,PASS
C1D720683CED4E8E05BD3DF99265FE4C06C6243B9D94ABA546DA0DDC4DFDC1CA,125,131,6,0.7076604666545525,PASS
98715DAF4C20E6AB57F97D97F99F869069A97A53E16093B91C1D48AB677324AB,122,134,12,0.4532547047537365,PASS
82E3C2C52381DDB3312122DBDCAE204D15645573D6FED3ABD5BB35C339CB26E6,125,131,6,0.7076604666545525,PASS
3893EEC3C98C0772FF1D77B26C00890B1105B6AA328BA5F59F71D3613E0DA80,134,122,12,0.4532547047537365,PASS
A5FC4A4990D80610FA7D96E0B3A6D6484079839A49E1B35E6AA1467518E1704B,138,118,20,0.2112995473337106,PASS
8EADDB3DD37854C8CDAF0B93B3DC4FE4C9547BC02F750727FB74C36B5F8DDBE1,112,144,32,0.04550026389635853,PASS
853553EC97566F9FEFD5D02447E8693FE4DCDA02A2CB1F0D5D2D34BFD34AF6FA,114,142,28,0.08011831372763423,PASS
9A4BF15E549E077430EE3F7749BCB8B0740DE5961E20E8665E19D3601B65B5E0,128,128,0,1.0,PASS
94AB9C1F56B58BD35A63A40A592DCD3F3CFC8DD2B9831C8AA1A7CEFF618AC81C,124,132,8,0.6170750774519738,PASS
CF26000D902B57E7CCF2F8FB531F0227BA7797F7B375203DE7B46A9AA3501892,124,132,8,0.6170750774519738,PASS
153625669E06413B4BDF18093869BDF8DD77426FA18EA33783A582D061F88B7A,130,126,4,0.8025873486341526,PASS
50CFB8652A3E58907BB2FB1BDBCA47479A3AA30089ECEE70A6AEB81E0E308417,131,125,6,0.7076604666545525,PASS
59ECBF00381F7CACE1BBD4ACB41DEB8BF9C9159615F2A785B953482E82A8E6AB,124,132,8,0.6170750774519738,PASS
EF9EBE672924148B95D708B72F7306183A7C3C1DE6B7EED3B05A5DCDC5F17122,120,136,16,0.31731050786291404,PASS
80118E72BB9D696F3085DED1F3DD6DC62049CC5D86EC156F996D2BD6C9BB30D0,125,131,6,0.7076604666545525,PASS
9A912F626824A5B9B17285D19C867A0447445BF51A39C40C2EDB1B103CB3A964,139,117,22,0.16913144470267139,PASS
ECF117AF737169111A163A1432D9CBA665C7AA826B9376D3620FA3E5CA4FB614,126,130,4,0.8025873486341526,PASS
52597EFBCFDFAD0D4855904ABC9DC3B7EFE6EAF3E4E5AD1851F46D69AFBD84D8,110,146,36,0.024448945310089426,PASS
D46554DF10EBA74D8205D511AAA7130EE9286F4F635B34A767F087F37CFDB8A,124,132,8,0.6170750774519738,PASS
2D24B631E52C668F768A2B5E9B9078146A4239D6CEF0876F391BC6758CF6E4EB,125,131,6,0.7076604666545525,PASS
3DA124482037C313A9088263CB1F553C061189A3486B07B06CFBD4A0F4036764,146,110,36,0.024448945310089426,PASS
E1CAE6B48771911259615A0BE3CD45F7D37EA3AECB84EB64E322FBACEACE6A8D,120,136,16,0.31731050786291404,PASS
345578C43B21E5D9E727F1A2DF85C20DB227DF1EA990C705BF0F6A84F6770BE,124,132,8,0.6170750774519738,PASS
F5B849958705D641DE1C657A0924DCA0B528391EBD74B0F45FCD5AB4B78B4FC9,126,130,4,0.8025873486341526,PASS
988BD298C3758FE0E10E2926C6B10C53CD0B96B78F2AD4CC44A9EFF48F186A30,133,123,10,0.5319710580974012,PASS
27072FF60A14B8C9626FEBE7730DCC214914587698D984CFA80B42E803CC04E3,138,118,20,0.2112995473337106,PASS
8341F127A87FC513A7A1BC46E947BAE15FC6354EA5026D2B2A66A1EDCFE831BF,123,133,10,0.5319710580974012,PASS
14FEF8F01E2CE148D617F47F9B82C9EE3C21D0A78DA4013FE6263BE1722F4167,126,130,4,0.8025873486341526,PASS
72EF7B62955E9C5A5801BB0424EBF2C605686E64FCA8E786ED09919EA438727C,129,127,2,0.9005235503397743,PASS
A26418E54ACB22D1C85269E9E5FE695AC158D23B6726977B2F3E1125CF3D35D1,126,130,4,0.8025873486341526,PASS
ABF38D31DD6CF27A2733CAEE2B0350547D3E1C96CD235FF006DDD1A4515231A0,127,129,2,0.9005235503397743,PASS
F360EF243C2FF60EBC6580FAB42ABDC449913F2A0A8E8AB734CC2CFB861E2634,129,127,2,0.9005235503397743,PASS
FB0D4140567546CB14758A05455BC8E17C6C23B3CF1D4C37F2FA095B4D4BC482,133,123,10,0.5319710580974012,PASS
D34B2B23DA1D06421FFECB6F33BCE45B1824A6F486C9CE1A9F8B922B1BCBDAC4,124,132,8,0.6170750774519738,PASS
8B02B62DF524991C725D6C7AA59CF9F9481C6C3DB87C72DAD0CC11506582BF61,130,126,4,0.8025873486341526,PASS
4972473AE5536B8046351D4F0360E696CC6B17E5EFCE4DFF66FA4348B2622920,129,127,2,0.9005235503397743,PASS
EDD6C66081E489DB4E277129D9089EF73C9DAC2BF19BF75E945ED5D65903EC8A,120,136,16,0.31731050786291404,PASS
B351AA5D6ABF517A08DC8CB5B0874543E5691B0B33CD8BB31C1F41E964D4DBB9,126,130,4,0.8025873486341526,PASS
E4A04A05FE32B783FF034E6F09A62EA97CC07142691AC73E3566B353A1AB45E0,131,125,6,0.7076604666545525,PASS
13DE4A1F711B091C8DC462DE2BA08DDF7B381998B9580B1733301DBBF211C81F,132,124,8,0.6170750774519738,PASS
F4B8CF6CEBADB684134CF599CE2C58A5795335D0037F4AEC8CDE5874CCD9E17E,120,136,16,0.31731050786291404,PASS
FB0627527B3945F75166F9AD67EB8E6C26907D2F01DB2BF602F4BA0E81591CB9,122,134,12,0.4532547047537365,PASS
AD172B6CDDDA482E14ED1F0207B48AA9B64403095DDC884FEAD57ED4611E95A2,132,124,8,0.6170750774519738,PASS
D0E36C7724221E2A9687298891F0B31C5F40499D04D0E9D51B9F6AB2B084A4C0,142,114,28,0.08011831372763423,PASS
DB4227918E37B34783E62B09036217A322A2FCCBA4BD91BBF4B786644BF2C7E9,126,130,4,0.8025873486341526,PASS
8A56E09EBB1B3C87B1CD6F970F6E63915EC403CF55FACB249A7AD8583663ACBB,120,136,16,0.31731050786291404,PASS
D4DAE7B953C3BD1F156102286FC42F1F3BD0147F83A971531B86B601E9AEDAD8,125,131,6,0.7076604666545525,PASS
F4055FB3194218CFD0C1052AF919D5DDCD51F36D07E13DF62B8420B022D0212F,135,121,14,0.38157390570502125,PASS
44F1B16A753294AE6394892118E425A24BAC2833DD4C26E9BA5D5130A6393557,138,118,20,0.2112995473337106,PASS
7B1EC1AA14AE410D5D7B9DFB4D4171A0E2054BEBB48710523FA5904253A5B5A2,134,122,12,0.4532547047537365,PASS
48BA7DA2780F1C76D6AC42AB01FAA5B52E0AB44FB0485D3179FE35355E214ADA,129,127,2,0.9005235503397743,PASS
8FA1FB8B60826965BA8B375F900387CDD13B5FB02524D923213D8F0E0C503F7C,131,125,6,0.7076604666545525,PASS
43FAFE02233639FE2D33199D5BA03EF710B559F04DD510B993B1765B8B6066F0,125,131,6,0.7076604666545525,PASS
C38681D1D0FF972EFE11D187BE570EA898C96DB8060B1FD7EBD0FCE849D2FCC9,121,135,14,0.38157390570502125,PASS
78D26233D9727E2AFE190F3E02B9E75EE90348AA8133778F415D2B09B66FAEED,122,134,12,0.4532547047537365,PASS
28E9A38994461DEDB4A6ADA2B82F6DF2926249079F5328E190A8BB8089E910FE,135,121,14,0.38157390570502125,PASS
52252BB24B79B528BB0051FF5920108099C703CB4A0AEF1CAF4EBF6FE9F4C94E,130,126,4,0.8025873486341526,PASS
A1FDAFF0F8765D9694FB1CDDF28A6085B38A2712FD3E899E24978AB6F17C9C96,118,138,20,0.2112995473337106,PASS
AC4FC372A1652FB7F905080B518887869B0F1F2DF0FF315FA516A7D1EB2E0EF4,124,132,8,0.6170750774519738,PASS
7A815526EF8232A026EF5CE2C6FA59628A74A183693E496581566FECEC4E6230,133,123,10,0.5319710580974012,PASS
6D20DCFA4C622411D9D3CE2A66A4C098C32DEF3AA244DDEFF24D76702AE0B79C,129,127,2,0.9005235503397743,PASS
78EA4A1D469BE0B20CDDD4FBFBC4AF070A93B050076B11CA8A165D67E2259365,131,125,6,0.7076604666545525,PASS
8A69D7BA0ACC312DC0637338AF3AD58DE27112A2A0D3CEBAFBFD52497F0C7E2D,123,133,10,0.5319710580974012,PASS
EB44AC18B272AF4A60CC5985929AF0776C787EDE99280A27459F14C0B7D77191,131,125,6,0.7076604666545525,PASS
EF56D24D4EDFDE39F8B9AC3A4A33783790688EBB7E8AD10E55A65F1D4102AE3C,121,135,14,0.38157390570502125,PASS
C76DBB546282508B5AD0A60946BA618F567A0552EF6E6C0D1A98E8AA402AF116,138,118,20,0.2112995473337106,PASS
7A8E5DB6B19FE2DCEDE53DBDD6F2C544DAD85515CE155ADE79BB7872B4494B31,113,143,30,0.060792723530522785,PASS
904FF3CB70531933A8EF2E6CEAEDAD45C50EE8998F75D71B0B3BFD4B05ED9CB0,118,138,20,0.2112995473337106,PASS
DD4ACDCC307B48DAE84C609F14B73DA2B5D4E832BAF634B504BF3FAD5A9D9AFA,119,137,18,0.2605890342736178,PASS
5D67C5DFE307CED775AB62E2E2BC98894A113696FC30982118A96584C4E02EA1,133,123,10,0.5319710580974012,PASS
1C178FB5FFF9E96B56661AE68951567B928364859A00576C3B56487AA6527B21,127,129,2,0.9005235503397743,PASS
B1DE7C5EDBE9F3D14F2592418F9B2F9F7D9BA51F7DFABBBB7C83F26A57084713,107,149,42,0.008664896726025117,FAIL
32F0A094DFE8A45C9FA801F04C119FB98E04A445DF135E8738D983C66C8FFC18,134,122,12,0.4532547047537365,PASS
3F6020485EC6FB605569A2439F29FFC7A3161858A89B2D1901483B9090BC15AC,140,116,24,0.13361440253771617,PASS
22AF07DF5C6F8494BF3F160260E25CCCA8D6561C4494D270F6EAE6075CCFE260,130,126,4,0.8025873486341526,PASS
D91977AD1484D69C32AD783ECAAFFFA7607A0D906E4EF1F87CFEDBB944BA8810,120,136,16,0.31731050786291404,PASS
6FB20951E8DFADAE22F714FB20989593E9C2C85EECC6731B2D32149BBAD30114,129,127,2,0.9005235503397743,PASS
262BAAE4D9956187CD7101A3EDE0E07832F4A0AE508AB7D892041909D56DBCE4,137,119,18,0.2605890342736178,PASS
93596721B3C9A5989B5C69A150B405C509C9E8D1352A6786F3427AFB67D81008,137,119,18,0.2605890342736178,PASS
BBDC73BDC6E94DE103515887D85F13C3C03FA77B6E9AE1A01278F9C63219187A,125,131,6,0.7076604666545525,PASS
60FBD3866BE45540ED2FDDBDC788B2C7F27EDDDB994AC103CE19ADC3EBE3869B,115,141,26,0.10416255883043901,PASS
C730CE64030BAD3528FF9F4DD34517C0D47510BB79C20DF37448EA9934C5D278,130,126,4,0.8025873486341526,PASS
5CACA74BCE8A6CAA7F185DA667AC9F917BF8305FFBF49F87EDCF21C818AB9BCF,111,145,34,0.03358661289689768,PASS
8869C1485E2410C52D10A23A0CD32A28A2C4D3367BF74588CCB31E2B6A0C4ECE,144,112,32,0.04550026389635853,PASS
E075954148B14C24A34C35A6995B36A0B48ADE9563319C85BCDA27655B813CEE,135,121,14,0.38157390570502125,PASS
5D843220D3223D6D5844634726C3543CD4C9B2DFD44B28F2CF2003A924C5C10F,141,115,26,0.10416255883043901,PASS
EBEBBA0167DA1F5E537D9466937CF721EA9D1D2F991DB9F5FDCBA29F2F024D7C,109,147,38,0.01754895019147673,PASS
,256,0,256,1.2777508801076536e-57,FAIL
F01DBE87F24F140C008E533B3B9F4DC2C5299352272FE63761BCDC1A1E5CE93E,126,130,4,0.8025873486341526,PASS
71D0F44F96CFDFA74B267629FBEE205A053D2DD3ACC27F89FC5662174265C23C,121,135,14,0.38157390570502125,PASS
A29C6CEB04FDE5CFF291A1702C77094ADADC03C555ECAC10C6B4D75AB4F9E555,125,131,6,0.7076604666545525,PASS
BBE21D042068DC8FDD0E4797D2BE8B20689A09C94AF2281FD017E0AAF9D65978,133,123,10,0.5319710580974012,PASS
204CE0940B30FA5F0896BD61002ADA0CE1123315A9D794083081BE1032DC75E,151,105,46,0.0040402749798920095,FAIL
8951D88410839869D9A043507AFF3287EC6F05871492C96B3BD1853B5033716B,138,118,20,0.2112995473337106,PASS
895B384E393180C83EB7DA48150D424DBDF2815044532FB16FE92B4D64D023C3,138,118,20,0.2112995473337106,PASS
373F22396185A71F8116D8515E243E7E4FE954E2E75A552E3D0FECF4405C27AA,126,130,4,0.8025873486341526,PASS
D5D93576FB6BD462E0AEC960D03EAFE8FAD60076542178734E7A0545B32F2C93,125,131,6,0.7076604666545525,PASS
D1788C7A5E9A2EDABC8C724707E840633246AE960F2801AC32DB700CE3373877,135,121,14,0.38157390570502125,PASS
1E9D30BA17228CE790B83EE5E1FC4302D92B128963AE5EBCE332A03DEEB7DEFA,123,133,10,0.5319710580974012,PASS
D8A39866CA503B59EA1C45C4CEC46C74EACD7BBAFDE8EB4397C55479D95264F0,123,133,10,0.5319710580974012,PASS
BE4CCBA302ADEFCBB0DEFF562C4383F9E1A369E521EE8FA03BE28A8B9F5BF607,116,140,24,0.13361440253771617,PASS
B9560668A122AA0270C820DD5237F377346A5C0BF8EF4DE4A2236ECDA6B7F679,128,128,0,1.0,PASS
EE674657897D3946175400F11DEC32BAC8B0A8433374EBA82C8013767650BEEE,132,124,8,0.6170750774519738,PASS
86227158DAC701348FDFDA83B92722A99186435FBFD51AEB88DB4C28BD3A87C6,128,128,0,1.0,PASS
36689F2DF3B5181CC504D5D26D93DC77E4CAEA38346505AB09C8EF1BBBB48775,124,132,8,0.6170750774519738,PASS
2CD43701B090A9528EB807E14A71368E5B30707F59CF048B00ADE53140FFD9EF,135,121,14,0.38157390570502125,PASS
BADFD81F0D4AB16E186E5645BDF28731272CCF20BD93363FA1E2BA6812FED6EA,120,136,16,0.31731050786291404,PASS
929FCABE580554DB30C96ACE219C36F854C23A75258A49C98BE6AC92BC0920CC,137,119,18,0.2605890342736178,PASS
4125E9CEE25FA1E3312E63D40D77D403DB68AAF31A82E745BE82E93EA5B7F255,123,133,10,0.5319710580974012,PASS
BB4CE2B14F52F8643A57946141758980659CC1DDD3A425FB401748B2CEDF52FA,130,126,4,0.8025873486341526,PASS
F01C2C3551A305E05AF933599A19BD517BA9AB30F8D50B191BEB6BB0BAECE4A0,129,127,2,0.9005235503397743,PASS
6593AA70099D0DDCF989B917F0AAAC7057CDDFD4EFD0CAFAF04D0DE5565EABE,119,137,18,0.2605890342736178,PASS
E6DE5B7FD90D1436A652D2E4B3A62048F48B875650270955A91C367E0F596AB7,128,128,0,1.0,PASS
6093687867DD99190D87C7E195CDBBD5038118422E082DA45AC0C88E4BFF15A8,138,118,20,0.2112995473337106,PASS
B1DD1731CAAAA397B9101952AE686EDF3F1242B25EACDF91D3BAE32C06FCFC6D,120,136,16,0.31731050786291404,PASS
CFE272BFDD030B45A5CB89A47A148181666DEFF84216423C2AE15DAE283AB5E2,131,125,6,0.7076604666545525,PASS
4697FD4D6342A5A480BA7E01395BE5F1B6ACBF6852D6071233B7ED3A3A92B33E,123,133,10,0.5319710580974012,PASS
1C2A49384C56599734EB52A58BDA2417DFDD7592C71200DFDA9F6B441C974D29,129,127,2,0.9005235503397743,PASS
47C25D08752324C5B3C655DEE2794D853F202A8F90C0ACB7A67C8553C87DC00B,135,121,14,0.38157390570502125,PASS
F9854C348985C5504A8C25381443A06E9C786DA80E1D170B32E595412625BF,148,108,40,0.0124193306515523,PASS
48F4755C54B5EB2A63FEB0B1C4E388E61C502E2B0BF1D227A639498BBFDA9D6A,125,131,6,0.7076604666545525,PASS
926F749B8C82102F222DA8CFD8305AE6CCC43A6046FE017B9DBC59947B75D410,134,122,12,0.4532547047537365,PASS
C181F6491927E3FABC8D080358FA087F197BCD8169C7E3EC3B9A32A3F91F3A47,125,131,6,0.7076604666545525,PASS
5C4AC8D5F55434738361D58A631267065EF11479C001067891B4A4306B1FEE,143,113,30,0.060792723530522785,PASS
2BFB0747303215EF63E9CC7FFDC4FA6A248EF355AF303A89144B0975BE49E980,124,132,8,0.6170750774519738,PASS
EFCC339625AB0BE68C32A8A5782EEF259E756B96A7A573A1C2DEBFAFE3F848B3,115,141,26,0.10416255883043901,PASS
CEC05918946A7A88F34611B11A1EDEE335DA30631F6C4E4E3802492EA20DF80F,138,118,20,0.2112995473337106,PASS
5A55A8781E096B2A55BEBC09AE0DA24FB1F95D910DE1B2C167CF86A3FDCF09A6,125,131,6,0.7076604666545525,PASS
ABC7C23E9A463D7672DDBE5D2386ACE52E7220786BEA2A29046B8A880C5921F9,131,125,6,0.7076604666545525,PASS
8B0451D1A6E3F0C86EE373D1A8F5CAF37D0E35AD885885F4A2E870905E2A11EF,130,126,4,0.8025873486341526,PASS
6F4566EE6F974098A93ED020C733970E64DF71711A142F60DB52A006220A130A,140,116,24,0.13361440253771617,PASS
53CD3DAB98929EED5E63E3D6483C9FBC0ADE958FE1498B7169CC60503934E70E,124,132,8,0.6170750774519738,PASS
B9ED9BCF3C092BB620701BD0B5E94372343FB10A01E3805F15D8181D35204152,140,116,24,0.13361440253771617,PASS
8465327B7F04444FF8F877D3C58D6B13232D34092356FB34269FC73439121503,132,124,8,0.6170750774519738,PASS
F51B1F971C888F36ABCEA0296FA2C15BB26A572623D96E16A3D22C5965452BC6,128,128,0,1.0,PASS
ED40C96D3FEB17943DD816E0942E7DADD60028DCC958CD588C3D8800D96F6634,133,123,10,0.5319710580974012,PASS
350CDF872B1F2C7508B1F1A201C47983ABA56D99EF1C4F170775D7480503C668,133,123,10,0.5319710580974012,PASS
423530302BD8A718F91702B954F27B8BED39C7C6DE880FEEF1BC29DCB66D47AC,124,132,8,0.6170750774519738,PASS
C1A555C83B2EDF65FD5470F7F2477BC91B1D4C02E2E375796BD63220F4BD750,122,134,12,0.4532547047537365,PASS
A23EB3398A9199160CC293EF60161F01AAD51C2A1534324FC14BC2F4A8087062,145,111,34,0.03358661289689768,PASS
6F86ED65CBC34A555442D9E2E7819538A4DB819329F02E3B902F4052F42D0306,137,119,18,0.2605890342736178,PASS
3D51CC7FAA0516937EF0574597D2E88DB09E160F358B639321DBDC5DB50204A9,129,127,2,0.9005235503397743,PASS
371E1321250B0247881BB744F58B9230A8AD70D02E2CE3FA7D3AB99DC9454BD9,134,122,12,0.4532547047537365,PASS
C0391BF03191A9FF8D64948A009863A5ECE5E72A9552FBAFEE1DD92E2F7F2F23,122,134,12,0.4532547047537365,PASS
EE0E27AA1DDB534C4945D771EF16AE73825239A498F5F3B70A75A8FD634E28DF,119,137,18,0.2605890342736178,PASS
D415703B3B4E4B405D73104F00112E921E24941074F7D8B45D89987B248110B1,147,109,38,0.01754895019147673,PASS
B5BEA6BC16D899F6E51E41EBC2DBA856EBD33FFEB022DA8E1CB1B0DEE0103521,122,134,12,0.4532547047537365,PASS
8EB01C3D4DC8A1A66CA4BC5E9357817FE24881E0A06D2DFA200393BF9A657F6E,130,126,4,0.8025873486341526,PASS
6DFD0BC5FD42AE4F4AD211901B19390E8DEBAE008BB118F370ABC65E27DB2A5E,127,129,2,0.9005235503397743,PASS
7104D4900DFE0810A14B7FB064BCA02F8C1D2F635775B102E431A6289237EA34,141,115,26,0.10416255883043901,PASS
FD87B526A9A5E706BA78DE9872DEDB42BB67E73DCA454F290032C7C3DE7E711B,116,140,24,0.13361440253771617,PASS
D9FE321F15AE5CDE7862ED5264186F89187766F433EF3833BF252D51750CB20C,123,133,10,0.5319710580974012,PASS
3AC82B2DD7678A0116DFD49DC32F38B32D21F510E8D0EA0DD81F13678853ED45,130,126,4,0.8025873486341526,PASS
5A2E6F6DEA63227E21E4E2FAEB625CA7D0FF75604530D69C6B9125C96429182F,126,130,4,0.8025873486341526,PASS
5D4B749A8E52E46A3786126445587CBC33138E4C203C6A35F46C6EB89CDFB7F,129,127,2,0.9005235503397743,PASS
5204201AABA2A45D001CBE0A15E828121C6E16C799413EC5E2C440464D9DAE85,151,105,46,0.0040402749798920095,FAIL
200ABD73E2636B8A994CBF292DA70FA0B7426A591AB65AACA2E7005245DFD90,135,121,14,0.38157390570502125,PASS
56177E13F427E9DE7DE74D46575F2798E5E9E9B285484F56EAA05C4463FD1393,118,138,20,0.2112995473337106,PASS
45869633C859DFD95E4C3D57B0FC4D15C14256AF19854A2A0DA6C40775F15FE1,129,127,2,0.9005235503397743,PASS
E3175E722722401542826E96DD1F9BB7525145D7446A2FAFE3DFCF87AB97C062,124,132,8,0.6170750774519738,PASS
7695C2642B0E0C558D83931882A3ADF942E1B5B7F3FC1DB1F8CFDED9745FBBD5,118,138,20,0.2112995473337106,PASS
DA865A85E489CADF5C6C442B147CE3BF7E63E816C3F38CBCC64952DD6E7767EA,118,138,20,0.2112995473337106,PASS
2BB39848807DD6DA186A0D17A8DE111F085EB71B5A0BFC16C3EE88724F6CC098,134,122,12,0.4532547047537365,PASS
27C9B52EBC5910F3C4CC053FE0F504B88998C0027404499477AEB1DEE07275EE,135,121,14,0.38157390570502125,PASS
48EA27392396A8D70E9F32B2AEA261E900BA3A42DF8ADCF682CE9630E5A70351,133,123,10,0.5319710580974012,PASS
865F60CBC008C8ACA3973910A47FC3237A039AC60694ED6B8E1253CCEC2BBAD1,136,120,16,0.31731050786291404,PASS
6F7D5754EE4BDCEEB1EB369A95E23CE832FB83B36505B6B07C3C4090A73D9691,120,136,16,0.31731050786291404,PASS
52A7D0B0373FE439DC887540C172FFE7D4324E8EA18652CD86774312043E3232,134,122,12,0.4532547047537365,PASS
D2D2C3A3FB142DFC1BAFEF5F30D43437BE8E92A91D58001945DAE29F666E9BA6,121,135,14,0.38157390570502125,PASS
42835B23CA84436D41503A23346AB3DFFD40122F0DD8F76A4873A16FD88555B5,134,122,12,0.4532547047537365,PASS
7E49202C0A49A40366AF09CC04BB973F96A0E0851954A7D51EF8DD5B4A68A261,139,117,22,0.16913144470267139,PASS
29ED07BA0A806233090F57788B6A1C86ED8C04CD563EC533C76E555C5C7B47AA,132,124,8,0.6170750774519738,PASS
D56E53D88E12DDCD1B9D6B9AC1CFC2E066971D6080110D4DDCF4A2C17954AE66,130,126,4,0.8025873486341526,PASS
C0E1D6E0E825DE908455868BB4E990249544DEADC208D967D663A17CE1DF7DB8,132,124,8,0.6170750774519738,PASS
F52342DF629CD5AE254D810A736F1478FF30BD80A07D62BFE90C9F920FF75052,126,130,4,0.8025873486341526,PASS
DCA72EB07A3D5DE7E592BD69B2C0220CD5B4ACD52C5B9B89E94AA32A219CAEF7,123,133,10,0.5319710580974012,PASS
974345A12710F40E35B3E682027413B6A1A3F1383054F71735B02A6EC9BDF523,135,121,14,0.38157390570502125,PASS
97B458F638FB0476AE755718DCF93D9E817436802E09409742BF7F1D071B59CE,125,131,6,0.7076604666545525,PASS
F049024CC4CB69355AA250EFCB9E9C1DE03754E73F968B3EA484DE5D19EF7927,124,132,8,0.6170750774519738,PASS
D720FAAD00604BCA893FEFD4BBE017E1CD5DF3FF77E5DD5C60FF275B09B175C4,113,143,30,0.060792723530522785,PASS
DC9A351A17ECF1200AC5D8D8DEFDEAF409359D0C027E0BDAFFCED7FD77F4242F,116,140,24,0.13361440253771617,PASS
C8B1DD4B02B1EEAD80923C2110F14F21B0C73C6CC0F0E89F83DFAC6472C982F7,134,122,12,0.4532547047537365,PASS
1810E90509D46EFBD5DFDD5767FCD3743400D96BC59CD831095AEFAACFCD841A,124,132,8,0.6170750774519738,PASS
8275B8C718CE4941120784C2F0AD12FFDCF774D0C2310441D3F49127B5D54252,139,117,22,0.16913144470267139,PASS
7DCFB8850B047CA42CE5B4E5831052A490C1F53C5740225CF8BF6A4BAE942EB1,135,121,14,0.38157390570502125,PASS
747C6FE1E1F5EF021D2A490DCB71DD95095C6DAB977B4D0E261311BB28D46B64,125,131,6,0.7076604666545525,PASS
5BFD8BC65CAF2F8AD06BA54AF2D936E80DEE45A8FCDEBE69C8A23E7956C22787,117,139,22,0.16913144470267139,PASS
72F14C11FFCCBAB6D1EEC9216ED6DC5552CB0BF1A69B73279F1B5B3C8BDA9591,116,140,24,0.13361440253771617,PASS
42CA64C5395F497E707FF12C9954B81207CD87AED5B93E247FADA46515B96D65,123,133,10,0.5319710580974012,PASS
7DBDFCB7F42778D1ACE194F9D9EBB5A6792B9128C21362626FC079815EDF51E9,117,139,22,0.16913144470267139,PASS
B3A5AA3E8B0B5AA4A5F3163B5215EABAC45E6DC774BD98FA56676EAA800699DF,121,135,14,0.38157390570502125,PASS
4320EB716A7F6838018FE6F3ECA6E852141CC61FB37D1EB85F1DC3C4C5466C54,128,128,0,1.0,PASS
ECCDACA6952B59407B176B1A0B3CFDB64E8FA6734A806FC2EEF34862549F7BAE,120,136,16,0.31731050786291404,PASS
31F8B771A611B4F43B3D46D6A97F85B729EBADB6DCC48741A2390EA795301266,125,131,6,0.7076604666545525,PASS
7B70E3FABA040B0E0807213326DD1BE41090F0500E768B8136D376535A39595B,139,117,22,0.16913144470267139,PASS
7AF0958EB1E93DC1D2106D0C9E962910693A739460BC57C73B372BE66BD7BED3,123,133,10,0.5319710580974012,PASS
FA2A964BCDAD9890C6BC03701E950FE02F91310017F6116CABAB57B3BDEAE873,128,128,0,1.0,PASS
5167EEDAD1ED19ED4EBCB50A0567FBA93A646C9EEABF59F17D0F233CA66AE914,115,141,26,0.10416255883043901,PASS
F330F3A04C74FC4E01888CDB091CCC3D20A58F93A188782DB9F36324898F951A,138,118,20,0.2112995473337106,PASS
8E1AF4EB5F7C67206BFA68F3A0DDF74D7332C5EFC746E868492F31912E5E4AD1,118,138,20,0.2112995473337106,PASS
4E946E1084FABC316D344B64985105C05CD1A30728AFCB462BAEB1CC9FA7FEA3,132,124,8,0.6170750774519738,PASS
442CF32C3707A2710AEB04957D177DBEAF14EA31C241D61BCC20761EF2C6EF4F,127,129,2,0.9005235503397743,PASS
269BF7352150115B605E3EAFD8C168604BF64E53BAFD2FFDBAF1802A836ED37A,122,134,12,0.4532547047537365,PASS
B2689EBF0F62E53BE8ED12DBBB02BB07BAADD140CAA3CD6DF37BC6947067345C,119,137,18,0.2605890342736178,PASS
C9A50CB7B29192E8E0E8DEFE2F88FD026D6A8E13AC356AEE563EB88B7211367A,125,131,6,0.7076604666545525,PASS
4D79B590A4BFDF07535A4D72D842B8E693296A6E6BCEE069A008D9D9F3347332,126,130,4,0.8025873486341526,PASS
AEAFD33CCCFC50809E8C7B12D79ED8448D652AEA607AC550DBEDD0F2100B24FE,128,128,0,1.0,PASS
AFC96CD59631CD5EE45AE4059173D33D09194C62A9F397A1A363FA9BB7A135FD,120,136,16,0.31731050786291404,PASS
BB0E68FF0023F67DBEF1FD9B1567799F6E614C95C423749C443BA4EE0242190D,125,131,6,0.7076604666545525,PASS
ABF938861F144E4C7A24FAF94A18ABC5CDC42E50DDD090A82458769D41261C95,137,119,18,0.2605890342736178,PASS
B0908B7A339F8B2130A7C9859F1D713C98A1ABCAC483EC8748472FEFCB4BBF49,127,129,2,0.9005235503397743,PASS
9904B02D14889EBA9C1DA17844631FA7FA296FC7BE9393A716A5AF29E32C6BB5,126,130,4,0.8025873486341526,PASS
BC96600BEADC4DB71BD5F35A0C8438DAB0EF7BE84DD94BE2FF0A405FD3B6050A,123,133,10,0.5319710580974012,PASS
B5F58D8789D4C7B4C63B7CEAEBF0A8BEF895A7E887B13C5E53B914BDA0361282,121,135,14,0.38157390570502125,PASS
A23C7CE222171169BBD416D2E26E2C34132AAF8E316BD75698621E0C0B2BC0A7,136,120,16,0.31731050786291404,PASS
CA74CE6A549C31CE3A5A1346AAB1FA7A9FA0B5E869F59FAC10E27B81962BCBD,125,131,6,0.7076604666545525,PASS
ADBCFC067D5609A36034389F6E7E2530B1CBED76AE439CBB57B6394233082FCD,123,133,10,0.5319710580974012,PASS
F21E953491124EC9845873FA20BD85A0391D0BD1CEDB55BF7191F1FDC1C7B38,129,127,2,0.9005235503397743,PASS
FCF1D8CD95EC752C164972DC9F76E67249075789D09301EDAE801A6798577B26,125,131,6,0.7076604666545525,PASS
41262C433410BF5C5C8AFA576776CC59A3C29F3F010D88612CF6578C4997E0B7,132,124,8,0.6170750774519738,PASS
83ECCE5EB4EAA0D87007D973156BC03013DEF58730E277BFC355C17B9E3DC9A4,123,133,10,0.5319710580974012,PASS
8BE8858DC48347175284E2A8C1B68A69A5ACE38B8428A18CEA6C6E792749F130,140,116,24,0.13361440253771617,PASS
5F1E925DC64F2E1D4ED05395D7AFE7FD05E0935F9D13AE2438EDAD30B3D23C4F,117,139,22,0.16913144470267139,PASS
65A3AF607817088DBF3BAF0F8441D7FBDF669F3104FD8E6A53AB96F2FAD204F9,117,139,22,0.16913144470267139,PASS
E58692D9AAD6F941C40AF69018F8A866565DB0A237B05C8A142C31125D63C1B,141,115,26,0.10416255883043901,PASS
DBE35AAF9E650076E6A040C2436EB77C1AF3201A194502766D6FF3C6A6CF4A8,131,125,6,0.7076604666545525,PASS
8F486EDA47C08D0D6C3006EF0B56411B2C6283C9766F9628D86BC06AC383F706,137,119,18,0.2605890342736178,PASS
9EA9EBB6B7A8B45024C16CED4B1F7CDBED6F5BD78DBDDD01718274DB4A744D56,115,141,26,0.10416255883043901,PASS
C8EEFB3C3ACDD829953241999888F12084B59B53573EA467A32E8515A76B386E,130,126,4,0.8025873486341526,PASS
D52D7EA7D8F96B5DDFBC6C960076565F53FFB01D7B4E0EBBFCBECB3466F44E75,105,151,46,0.0040402749798920095,FAIL
3908B3B10F9ABA0804392AA9840FB0AE0EEB5FA531AC5FC6776B10431B219,143,113,30,0.060792723530522785,PASS
392A1B0C59B8EA968D668AB2B434F4A7E203C48EE7B4B40D39C23435AD704426,137,119,18,0.2605890342736178,PASS
C21C8E426E501CFDEF625504ED41990360A3CD4577B9A240838EAE97126ACB18,139,117,22,0.16913144470267139,PASS
BC5C9E9BCED94022BE1B67310A836EBC7C9BFEF1F7D3782C11761F14C3538D7A,119,137,18,0.2605890342736178,PASS
CC6779B2D32340CC92FCF0303AEC99D9D0B679FB5BBEEE89E8A820EB3FAE0E88,122,134,12,0.4532547047537365,PASS
3491A2A93F3007FA2D51B8E895F0EB55B32321B31CCAE4E5BC0B7FFF5D5A79B3,120,136,16,0.31731050786291404,PASS
3979272D330D99125CDC9401BAF534D9EE301F5CE3113FD65D4C448872D4D48D,131,125,6,0.7076604666545525,PASS
250E6802A8ABDB393D5EA39CF8F9E1BA78A7E5369AF71CDE2A6F1EE3C6B62454,120,136,16,0.31731050786291404,PASS
A391010F42560C9E33676C44470943C50529C87069B12CCDDD8EB482D3970242,147,109,38,0.01754895019147673,PASS
CDF70C7234E0CD689C04E184A2D81E85C688F8EFB36681FF0422BC655C137607,135,121,14,0.38157390570502125,PASS
59A174922A206E63CA4548A636C55D69D2B0902C65ACF3D84124E10CDF6872C9,141,115,26,0.10416255883043901,PASS
8B5C355B8B04044D835E471F8A1EE3B0CDB9CF4D8C5265D659313DC19553DCC3,130,126,4,0.8025873486341526,PASS
D05C7A0982FDC5274462B62C22DE153BCC27DE3C293C225029734DC16C9383AF,135,121,14,0.38157390570502125,PASS
C89807AB5E43B815DD65D6A5527D908EADCABE04C126E5643973D6281AE98BB2,131,125,6,0.7076604666545525,PASS
F0E36F425077FAB68B844D551E4944578990E9F6C74FA0BCB33B1D62DC8BB836,125,131,6,0.7076604666545525,PASS
E49CC1CEE22AEA43C5556ED2C8E5BE025BAC2D9C20CDEBC5561B2E4F6714B74,129,127,2,0.9005235503397743,PASS
741BBD16EC577E57987D187C12467AC301D10B1EA6A9664512C6028839F6B18A,135,121,14,0.38157390570502125,PASS
7AA0F233CB92CC2A47469A03F83ADA5A619AB8F328D608FFB01FF1A20625B317,131,125,6,0.7076604666545525,PASS
D766EB054E5A530FB1E9E45081CFCA144222F74688FAD84F2061AEA9F046264C,136,120,16,0.31731050786291404,PASS
8FC193C342CCCD0DBBC563B2C8CF5CD612B68D96EEC0FA601B31B3EEBC6C885D,125,131,6,0.7076604666545525,PASS
FD2AEF07D9B2B290CBFEE0C47998BD4F9C36AEBAD5710EA25093EC5A621925B2,123,133,10,0.5319710580974012,PASS
84800B4D5A9F83B46C088DA6557F0602921E93252C6399C7B6355667E2AA5B3D,136,120,16,0.31731050786291404,PASS
24FAB8A3ADEFEE4F4036699A652C5CB13115FCB446A4637B0BDB31B313CCA81A,127,129,2,0.9005235503397743,PASS
7B6C0B2757C0E6CC20502372DD4D96A31C07ECAFE15E6875A792733A37E29975,126,130,4,0.8025873486341526,PASS
F18112A059CCF28306DBD2A3234B1B91A96F20A801A3025BF7D10A00C59285EB,145,111,34,0.03358661289689768,PASS
23FC3B4A01BB8264648868506582F0DFB56DBC84C27F724D3F11FAF4432B6FC8,130,126,4,0.8025873486341526,PASS
FEA95CF2A474DE8A570307D9618AE9249DCD4511A08700D440B4B1F6ADCE4854,137,119,18,0.2605890342736178,PASS
D66E892114D5E4B5D96FF25C082020D6C9EBE0C7B1D11CC4E582F7ECC9E448DF,129,127,2,0.9005235503397743,PASS
A77A1A62328E0BBC34CA80E6BCF0A86177B95601C35AF7488D0393703FE8B5E3,131,125,6,0.7076604666545525,PASS
1ACFDD83538711AD52F11CF3385D15CEDD927FFB773B8756139A443D93658413,121,135,14,0.38157390570502125,PASS
27202C362A7401AB0BE4A1D739674360B5295E84E46B23648B6EF788B08A81E7,139,117,22,0.16913144470267139,PASS
B7A02EE49BA13E348D4F015B4A9861307B8BA64B0FAF62C57E9A6F30E264DEDB,126,130,4,0.8025873486341526,PASS
68C0229F73475297C9D23EAFFD916BBDF7A761D813378D2145A9F678072EE6A4,121,135,14,0.38157390570502125,PASS
6C21C307E1119AFA579930B23DCA6E7CAA56A6BFAC3C952267E039EA9EC52FED,123,133,10,0.5319710580974012,PASS
15C8FAD785F84BA6B8597730546403C20B2D33A01F53217789D1BA9CBA2C686F,132,124,8,0.6170750774519738,PASS
DADFCEF80826F1F4CBD4F028F45FA52069B0A5C8E3AD002B8E0415C5C8BC46E,135,121,14,0.38157390570502125,PASS
A4B311566B4FF3F059479FAB8395FB6471EB45419C44E43CCC5FD836F7837FF9,116,140,24,0.13361440253771617,PASS
87A5052E3A54DA820CF07302AC89906CE1BC926EE272FAC9F887213009C2F38E,140,116,24,0.13361440253771617,PASS
5254E332F3CB8FF6CEFC936E762F2CEB56267879938DF548546E204AE592DC74,120,136,16,0.31731050786291404,PASS
CFE1028E7CAE66CED2BED6AB7611D3C02C0D647A51E155EE5A6C3669CAFEFCF2,119,137,18,0.2605890342736178,PASS
5534125AA5C355A9FB69AFF4990EF2931D53D8E60E8CB497A644086DD9709D80,131,125,6,0.7076604666545525,PASS
B0C75A33EE7F17C59FED41BF4096C8E9AA3F235E5E285FB3D9FC203381FEAF7F,111,145,34,0.03358661289689768,PASS
D059CD921EE6F81EB3629D93AC684363E6C5086AF49CF985E1F0BE7C153CC7E1,125,131,6,0.7076604666545525,PASS
20B962921AA219A944855A2A90C54C32BF5BD8F7A003AB772513D91868054473,144,112,32,0.04550026389635853,PASS
AC9C632108DCBB3F240577354E0FF05E60C72990AE8297F0712C27095A7D6018,138,118,20,0.2112995473337106,PASS
DE07BAFFFFD3CAB588467FF4452590F781A11145FABA726BA889A88CA7E92555,121,135,14,0.38157390570502125,PASS
165690DF9857D27DE192E2E96F84E45B11CE913FD5F4803B5D64E724CFD06C8B,124,132,8,0.6170750774519738,PASS
9D581DDD824701247557EE665299C2DD187E3B3CE67E2783043D247714ED73F7,124,132,8,0.6170750774519738,PASS
C10CE10FB55C1AB0B26C667C42FA40B7120EFF70541DC3BBF43529893E192729,133,123,10,0.5319710580974012,PASS
CD11DEC910CA6BDED26D839FF8265123646153AEF4CAE9099A5AA0E77797E194,126,130,4,0.8025873486341526,PASS
9038BEC91D397F210561D89E2A22E4922A17246AB52D1146E3C060868070AAC1,148,108,40,0.0124193306515523,PASS
74B10F32155B7D61F72BAD77E8AB4EA6FA61B967A943BE1111A2C80E5F0CF91F,121,135,14,0.38157390570502125,PASS
C521D3285541E4262937F9873B0CA36698012442F9D66612B79E8FE10A72EAB0,138,118,20,0.2112995473337106,PASS
7DAE4021FE8ACAC38BA6461D7F60106AA46630D57DD937D56D699412B2A3C701,132,124,8,0.6170750774519738,PASS
B7C58C37B614C6C584C77689B6CC5E10995291EEF7A3B432EDDC15695DFE3070,124,132,8,0.6170750774519738,PASS
454CFB9DEE5A161F164765118BC075560426C3F43A65C65218D74D527FC5CDCF,127,129,2,0.9005235503397743,PASS
798A28402FFE342BCFD8DB31D785378FD0B62E93187F3159E1D23C94C93783F6,123,133,10,0.5319710580974012,PASS
F77C84930BF2B550149016048879C6B76606E304903237EB5A67A752BEF0D433,135,121,14,0.38157390570502125,PASS
C7BED26AE152A8E28260C7AB55F95307EA6B7DBEF8917703B30BD01FC7C56802,125,131,6,0.7076604666545525,PASS
88283AAD4CA89F38ADCA72B0BD09126773D6E7A7000ECE0923BC404E6FF96C0E,134,122,12,0.4532547047537365,PASS
751792EF931DADDF9A5D6B06ED0AC33FD8B03DA61F82499EDF5DC6A42D926D19,118,138,20,0.2112995473337106,PASS
E7585113F48CE7DE80817D71867DF86BE32A86EF45D0647769066584C863ED11,129,127,2,0.9005235503397743,PASS
C632A87BA7504973D73D8D1D04412FC2F305636685E678BAEC7EE1B3AC911881,131,125,6,0.7076604666545525,PASS
783D55F54DAB5BCE7B707A5BFD7461E62089D661800EB0D2783A39E7E528E2D0,125,131,6,0.7076604666545525,PASS
C76755515D93D21541A0274C4500C72910D0EE5BBDCD38E2D4DF8E94FDFD74DA,127,129,2,0.9005235503397743,PASS
87D2508AE40FD81007FF85F2771BCDC0E32CA2EB22074BF880E9B13B76A1327D,131,125,6,0.7076604666545525,PASS
F6E39F1EB8958C296A38C71435EFDEDC5040330B10015EED104D55EE39D0FA21,132,124,8,0.6170750774519738,PASS
58C54316808E883703533392CB7ADDDB8C9D7DF1857B36CFE93E97F09EA4D700,125,131,6,0.7076604666545525,PASS
4525F67AB89199AB578773FB72BAF067B32193C01DA63FA5EB022379495BF941,122,134,12,0.4532547047537365,PASS
36A23716C5FDD5697B70B843D545EAE540BB4D8014CD8B9131942BC12AEDCF67,128,128,0,1.0,PASS
B6B1674164BCF5DADC4F91721028136E2CA52B4CCBE2C5037D73849E5F07F96A,127,129,2,0.9005235503397743,PASS
18C91441F2076BB96B6EA759ABA13396E7499BD9A8A72728E9F34E30356D4992,128,128,0,1.0,PASS
5FFB63B8CB2F53428FFEC3669E202991FA212426AE2F945ABF0F47E20D0E8F14,125,131,6,0.7076604666545525,PASS
E89CC065E64C9260CC4CB6C40087830E6E484AA691797CB7E5D719940893FB71,138,118,20,0.2112995473337106,PASS
DE78AA89C28A6C8D53FD18F3CDF2CC1F21BD6ED1FF36E9D0D25903038DFCEC0C,121,135,14,0.38157390570502125,PASS
D7866787E2D0A38F8ACA515C11DBE5AD9C813D2A99F1537791A37E8B7A62E060,127,129,2,0.9005235503397743,PASS
47C4621259D9F3AC7B04DBB647760E2835D9FFEDF1E85F8057DD2FC53EEA8CAA,117,139,22,0.16913144470267139,PASS
B9F095167ED11E0B5716736A5208E0D6A2F83BB6C1FDF8AD84651FEF980BE639,123,133,10,0.5319710580974012,PASS
5D8559AFB033BE6855C606F8691B0B2A27671122331F5E2C620744770D10CD1A,137,119,18,0.2605890342736178,PASS
46C17E9AAB6B4C21B09D45F4123CA254EF88A9C1CF307BBA2B5190BAC92C9134,135,121,14,0.38157390570502125,PASS
C329F9193938CD9B0B820AF7656DFE30F6F39804875E7C40DDC364A98D7116B6,127,129,2,0.9005235503397743,PASS
717DBCF87C5DDE8FFD7F16EB8D9568453BCCBD61DC1CD6511F2BA3515B0DAEAF,109,147,38,0.01754895019147673,PASS
B3F16A6758B6F9CD65E95668835124DD0B8BD043F149F10FEA3178156DD06285,129,127,2,0.9005235503397743,PASS
B7D3DE6B7F80D3ACDB04FB260064D029CD1B1178F890857409F2012A1025B8A7,138,118,20,0.2112995473337106,PASS
BFA99580B2C8149410D1A97E3E227CB72BC9B941FE06999E11849BCD83EC45B,134,122,12,0.4532547047537365,PASS
6EF7191C0B9FC4EA4B9EA99814B568CACE63DA4E093557250935477A70785BEE,126,130,4,0.8025873486341526,PASS
9FA4F11BEE5C5A8027BB86FB8BB8121682E8F234872BECEC10DE2586C000EBAE,132,124,8,0.6170750774519738,PASS
F4BE606FD54BBC6550643DDEE31C702517FD6E2FF22E39027022CC17E85BF88A,124,132,8,0.6170750774519738,PASS
4A150D38E1522BD7C619A211AF719993ACB96CF14190FF2A94EA979FE5D3DFDD,122,134,12,0.4532547047537365,PASS
4AA505B4BEA01BBC185833802BC5189B8AD74680C4129C7057811F01788BD75F,143,113,30,0.060792723530522785,PASS
4A6F31C031D29E07210D53871618E3097AFCC05AF61D4DA6B935F02BD709AE99,133,123,10,0.5319710580974012,PASS
984E941DBCBFE2EF1B81157BAE98461C57A9691BE8A82DA748FD3C4C2FB805A5,126,130,4,0.8025873486341526,PASS
5A4886CEFD7F6BE2394E8373B8E8CA3C8FA2441652C54C1A86A40D9E509DDC53,131,125,6,0.7076604666545525,PASS
E8B50EF013B4C13D5AA23069ED0599CCEE6B51EDD1C5AA20AB403F78195EE81C,132,124,8,0.6170750774519738,PASS
4D2D8485CD163CEF909DC347E95A4E7B685C3ECFFD9459763A16E50F866FAAD1,120,136,16,0.31731050786291404,PASS
11F782B7EB215636A6EB9C7756580410A8B6EA27B09930CF8C61E46E9F6CF649,128,128,0,1.0,PASS
B0B9301D37CFA6CBCBAC4FA740DE5D0F386DEB4E455DBC38E3925100DA6D3827,125,131,6,0.7076604666545525,PASS
B03C2C72241899EF44F914F30318A540D843B081C4DDED601748232AC95AEEA0,145,111,34,0.03358661289689768,PASS
FA0BA8D06819FF5E267A0885CAE6A859D426EAE8365145F26F3A80CF3BA54EC3,129,127,2,0.9005235503397743,PASS
CE3BDEB5EC83F41BF41ADFDA5EF46FC424E970D2F29C5161BF65689C932B4FF4,114,142,28,0.08011831372763423,PASS
332A678FD9FBD85B3AA288FCB751D81B99236511C4C427CC488FF4AA0DF706AE,126,130,4,0.8025873486341526,PASS
171B2191604036F571C01619D278E4656D0D9BE4F83EC94D42EE3E0721B9A360,138,118,20,0.2112995473337106,PASS
7A0036D9B7701448BBC949CD2EB5B68E1462940D1CBB6FE06446C6751D541E48,136,120,16,0.31731050786291404,PASS
61F067D3EA47FC0CF0230F1B38FCC999837D230BFD62D5DBEC5373CB61379360,121,135,14,0.38157390570502125,PASS
14137CA72DF535E09DD1E4FAFA03A9DFE6B4AF7F29292E03B91195D4A1434D49,124,132,8,0.6170750774519738,PASS
6F35E409783C85FB3D43CA3F9FF301F1AE60C59909EAEBA9BBEF726C0D088CF5,120,136,16,0.31731050786291404,PASS
E00A45B51A930EF4167CC9D4EC843C074ADD6C794FA094A42FBB9D40145C6D9D,134,122,12,0.4532547047537365,PASS
3EB5843F64DF226109FCAB3182C91E0779A2F232D434C10646132EF4BBEAF69F,128,128,0,1.0,PASS
7019A0C26209554F8F4EA2099F16D01F79781D7ECD97AE0E87DAA8B3B8A9E54A,130,126,4,0.8025873486341526,PASS
E82D9B3B5351FC386173BFB1763DB278365BE5FCAD4F0EF315E99B7E61AEE59B,109,147,38,0.01754895019147673,PASS
572CBE22EA04F66FAD937CA26625F401D6808A520E0061FBECDE0610637C38E1,137,119,18,0.2605890342736178,PASS
B10565B3B5CD11556B2E6D8B95BAAFC4A717456F4F34665A2F20E0EC2F09BD27,124,132,8,0.6170750774519738,PASS
5F78E0EE5367C6A790715A0350833EFE08F96899CA2DD84BFB6B1F381BBD4E11,124,132,8,0.6170750774519738,PASS
7DB037F554B39970A240E82597010233E102EAD3B810DFA116C2E33DB0B22025,142,114,28,0.08011831372763423,PASS
1D3841C7027F059971C25F93D87476AE11BF6DD26C069F637F1650EB649CCC0,130,126,4,0.8025873486341526,PASS
B88FDBFE6101EB28D5658EE9F849F98E390A50C776E48B10F28356F327220155,130,126,4,0.8025873486341526,PASS
574C70035B14256AD8345215B3926C312F52A0D91BE5EB537C21FB8FAB6DD9A2,130,126,4,0.8025873486341526,PASS
9CE3E8970BF6DD5423B3F74DDD321A23D7040F036CB78B40B589C58152F00B1C,131,125,6,0.7076604666545525,PASS
A27DD7DFBDC0C8DDD4EAE906CF6AE2BEDA37D6E4F099FCD6CD8B011095461607,119,137,18,0.2605890342736178,PASS
32E8C56530680E4BB9EF32EBFDBE25420E360C574140F7193C6953C2A3F4171,134,122,12,0.4532547047537365,PASS
5D1D8EEF768D7F83705111708A8D2D25594A437D4532570D7F0894DEACCE516C,129,127,2,0.9005235503397743,PASS
2933F8C9DCB167573816F2D0A814A84CFADB606616854AFA3DCB5404B2106FBD,132,124,8,0.6170750774519738,PASS
C21FD611ADAFD5A38047B1139EFB8A00036E6DE4E2302DE0FE415850411FC63D,135,121,14,0.38157390570502125,PASS
27C719BB8737D3C9EBFA3600245196F38235E1231BAE7E74B90BD92213007A3A,130,126,4,0.8025873486341526,PASS
4F8F4221C2AD8EE263BFD82A168E144D665C249350D466252F4A02B1DBFD42F6,134,122,12,0.4532547047537365,PASS
EFCF8E89131BD3B5423530947713EA923C3742F7FC36F43D430D08B7C23D9B48,125,131,6,0.7076604666545525,PASS
509B0FD547F66E30748EAC94848B59DDA4853E06174FC880378EE0281FD66D0C,135,121,14,0.38157390570502125,PASS
DAD6DFB5072E1103BEFC9B0FD590806963342B572854E305934F950A547DBA05,131,125,6,0.7076604666545525,PASS
564BC5553E731F1F867FA98881CE12B811E111205B8E2B2724E3C2CA87E5DB2D,132,124,8,0.6170750774519738,PASS
5AE789C69645C9277C3FC339DAE7501E70090A382983D1AE75C767D2CEBBC921,127,129,2,0.9005235503397743,PASS
7E39A71E561D048EB7D461129CE0D7C6F66395BFA33A4A9DC7A7BED714B36625,119,137,18,0.2605890342736178,PASS
4A224197E77A69B3C0DB9BE0C4230B5DE428AC188F8728D528379A6987190961,139,117,22,0.16913144470267139,PASS
AE55978E2102D4E62D6EB1E0E856CAABE13B8A5BD1D3540B916B1AC4186B598E,132,124,8,0.6170750774519738,PASS
FB2A2528CDFCF930BB8DC4D6FDC382DEC75DE2B6459175C6DBCA564689327491,121,135,14,0.38157390570502125,PASS
9DEA7DB08CD9512F8B9D894259D30A7734546D8B0A3167E78F9B02D4E8ADE267,126,130,4,0.8025873486341526,PASS
A33AA030F92344FBD39868913F7E549864332AF51059692144C7B1F14687D11,139,117,22,0.16913144470267139,PASS
3ED389A860DD33F684E8417BE6B7148E74E6DBEA27B9714240674CD95C45BBFA,123,133,10,0.5319710580974012,PASS
8B0878EEAC5361647D2CDD821C5574D0CFCA4D089F8016BFAF4C7D957BBBD29B,124,132,8,0.6170750774519738,PASS
9AB8874F602446B000DA96E52E3409737C907B2D9F4437A842AB79EEA46A386,138,118,20,0.2112995473337106,PASS
20C752C6043793355BFCAD548C530AFDE31A5AA1651C9315572864A57AE27014,137,119,18,0.2605890342736178,PASS
DBAD3829BBFE0B89AA0231027A83C1FA7C26C2338EADE3EF43FEDA5F3E3663E2,120,136,16,0.31731050786291404,PASS
79A0CADF58E28D29EDC9559E68739DA34C7266A73B1DBC2A88BCFAC73FFFD1C7,114,142,28,0.08011831372763423,PASS
D959D38A185BB6C1824A259080B1D44F1A91EC0752E571111A039EE1F23DCDAF,137,119,18,0.2605890342736178,PASS
6D74CEFA21C2EFBAF3D907DF6C6FB7271221188ACF72B644957D85229A879847,122,134,12,0.4532547047537365,PASS
55699FD42FBEC3DD64BE6D8AC0EAA23A5D3F7EA7EA1CD3E92B63F666DF67B891,109,147,38,0.01754895019147673,PASS
224E0D980FCCA5AEDD7AB30CE6908995428DC3B680382A216B33263110C4532,147,109,38,0.01754895019147673,PASS
D7CD9731379787D64B6F6478469FAD3F842D83F1E4800E66B717F5D15B05AA66,120,136,16,0.31731050786291404,PASS
A677665B552D60052EA2324147E1B0252A469ECA2FDFF4D6862250AD9485581A,138,118,20,0.2112995473337106,PASS
D3BC85E052544176AA255A2F0D8F3D2F1EB2704DC3DAA9B13771594BF0382290,133,123,10,0.5319710580974012,PASS
D0A72241BFDC3EED9363F64F91D70186751EA231D4B4805CBB306EF44021B013,134,122,12,0.4532547047537365,PASS
E27C69676C0346BD4BB4B6D3AEABD3D93B3AC92494E5208C922DC2948B9EF8C3,127,129,2,0.9005235503397743,PASS
245617B29C6E172AAB9CE788D2E34A46003ECBC7185DB91A7405C68F4422932B,137,119,18,0.2605890342736178,PASS
3948BD7B6E1FDFD032D1874C490AE1DEAE3966BB6A59BD56A81D80863C1CC89A,127,129,2,0.9005235503397743,PASS
8417CF4EBF064821CEC30E604DA648A547B78E32585FE7213108C8751924821A,143,113,30,0.060792723530522785,PASS
E3BDA9A249667C2C630531871EACA302965AE7F4D5F09B084DA4FB4D00EAB4C5,132,124,8,0.6170750774519738,PASS
37B68959639C026E4CE45AC44584AA7B7D69B03BD112092C0B05E02EE8C1CEDA,138,118,20,0.2112995473337106,PASS
75BFF5C7CCABBB5905042043D646A9B89BD1DAF287CC16DA56B263FAC9AE9BE4,120,136,16,0.31731050786291404,PASS
64D0FA8A14845EC89473C8AB83F673A95FB2E9ED24AD8E45A1D786794E7DF09,127,129,2,0.9005235503397743,PASS
A644B0E8E41F1E31C0EDEBE6474E059A7F6FEA32F5627B5736EBD2D00EA21589,124,132,8,0.6170750774519738,PASS
CA0AD232C149D1631CEEA3F7A598701BE5F56423753FA19395F6E10149820707,134,122,12,0.4532547047537365,PASS
7E61AF5A2E2C73FBB895FE7715F2CF9EDE0F38581CF802D582CC57C9F5E1EA74,114,142,28,0.08011831372763423,PASS
9E540FC094D9D1AB972081679CF60AA831570AEB38CB8DCD5E6B5B9212446F4A,133,123,10,0.5319710580974012,PASS
5AC112B36705ABFA4117DB881300844BE7D7430C6DA83C32F433DED01BE5AC02,137,119,18,0.2605890342736178,PASS
67E10B987CC541859F2B8DB6F35ACFB0EE19383D79C406F650027AEC225C82E9,130,126,4,0.8025873486341526,PASS
4EAD6F26F17198A84F5F1E4687072141581C5B8601DF5B948F130FF3534A7D64,130,126,4,0.8025873486341526,PASS
1EA891769D589DDD7C810ACC948FB451A48A68FB9505D7ADF0E625641C06D615,133,123,10,0.5319710580974012,PASS
BF098DF0D6D9A93C31ADD2F1180EF20FE81CB6A408457243F9C858BF719E8825,131,125,6,0.7076604666545525,PASS
964AD8062A10A4FAAA889A01EF742990C04AEB2F046018EF2341883B21817F21,150,106,44,0.005959526470109114,FAIL
59F95A68B6D947073B62F9C18645EB57E4B8FF44F940B6676576C41927FDB88D,119,137,18,0.2605890342736178,PASS
9A45E244EE2C3B377CF0AA16861239FF3629846706550B31F33CCDD58A7A6952,130,126,4,0.8025873486341526,PASS
158670CC784AFE86C242591F42B09EA3941A6E2C2A8147092829B11C02E146B0,150,106,44,0.005959526470109114,FAIL
C2D0FE9CEAF33A64340C5BD21A97F2FFF4E5807D0B15FDFB888977B72470D454,120,136,16,0.31731050786291404,PASS
FE108DFC49A5715D512C191772E8C3B01861893A8960C3DA5CC75C3699A0A372,137,119,18,0.2605890342736178,PASS
FC032B7D9C8E35FFFB88F0ACC870E593BF39EA4A3528463BC3CB7D97B4D58C32,118,138,20,0.2112995473337106,PASS
E3EFAD3BAAB750ADED95B4F39EC6AD1664F1D1CD67B6C107A4307DC0520D80D2,123,133,10,0.5319710580974012,PASS
9CADB052BB5B31A3808B94BFA985AF430F11E18FBD9F53303A8B0E2D22571316,131,125,6,0.7076604666545525,PASS
35A229248A51F2F76483EB57C6A55558E0A0EC68E0398D49E13026BCEAAECD18,136,120,16,0.31731050786291404,PASS
D90C51A724FA27CBD2FD0DFA625B9AB814E1C09A602525F3416803542EA73DAF,132,124,8,0.6170750774519738,PASS
7995DBAD5A597E7B61C64D5F9486FDEEB0A3DD3B3788AED39F9085A1EC3E1FF3,110,146,36,0.024448945310089426,PASS
350D2619E97812D784B541BBD1C52482CC79E787838F64E3748FC2430FB3AE7D,129,127,2,0.9005235503397743,PASS
ECD749B51AFE0F00F0387E7D6B4B97EEE60FB5118317D54215006234D28FCD20,130,126,4,0.8025873486341526,PASS
C852D3441C98670A703BB934A7A3D9B2BD16BD0B74A1C7A13FB3CF0AFE72A24D,126,130,4,0.8025873486341526,PASS
169539EC8CC5FE4E102BA10D794FD448B12C21454EEAF74BB2A93601AF48AFA6,132,124,8,0.6170750774519738,PASS
9C1EBFC72EF12BB64A4B1173087310793F5506668518648872068AEAFE63ED81,133,123,10,0.5319710580974012,PASS
E1A9909B35E264BE1824B924CA9A345B36AA4AA2BC441CCC1A63BFAA6025CAC,140,116,24,0.13361440253771617,PASS
4B3D731143ECBC880F1C1546FAF47D65E64614400475847FC1310DB63DBA3147,134,122,12,0.4532547047537365,PASS
294055D47D03BA59A8FA812C85F47FFC418179F4EAD3BC7CE6F50990662FAA6B,125,131,6,0.7076604666545525,PASS
8C604E4F4D68D29B0AAFC3F1ED8E02296EC03F32E51D88084366F39DBB509E4C,133,123,10,0.5319710580974012,PASS
8AEEAC850CE40A4C64E47E140C58C102DE0E3B2F1A45EE2C509CC90E9F23651B,141,115,26,0.10416255883043901,PASS
CDFF6C034C9E8518D067E53022524F43F77D543D7F028A377318B09C99B5E10F,128,128,0,1.0,PASS
A142F8B3A45142D1E5DC3C6FE6A4793D51827A5743E062135B3A613BF18349AA,132,124,8,0.6170750774519738,PASS
E894E4C1AF17F569591CA9CA7A7A0B51E6B04089CF36CED38FFA14432A0B8,136,120,16,0.31731050786291404,PASS
C7CF9A57960ABE439B01615EAA23DE595A07000B21284698FFC2DD8728A7BC35,133,123,10,0.5319710580974012,PASS
792ADF0551A00716FDB5BA7BF50BA3FE0CCB01A4A6F231AB7F3FBFF6963C319F,114,142,28,0.08011831372763423,PASS
DC36F622A6E43F785D22BA432A1A43A4406880B93FD261B11684B60A3593B6A0,140,116,24,0.13361440253771617,PASS
437E3AAA6B304974BCC2EDBA9AC01D0C5BF94E89CF0CA6364ABF7A7CCB6D8BEA,121,135,14,0.38157390570502125,PASS
AD04A52BA0DFA1AE26D66F6ABAF50D0D51E5B61026580645B0A0B081DBE73AEB,133,123,10,0.5319710580974012,PASS
AD8CC9AF52C4285EDB63AFF188F974315AAB4B6DF267969B166320C0C934323,130,126,4,0.8025873486341526,PASS
5D079F044BFB0C45FD47D3D17C9E5B1A79BA09FC3878BDFB9D50BBB2903754F7,115,141,26,0.10416255883043901,PASS
AD3D5A9B2DACDD4367336550F606B2EEDE401C067BBD9ECAD6D415A0586EED41,124,132,8,0.6170750774519738,PASS
EFCF3DBEB1B98311D3AA3A1290B0B688FF7C0B6D2E5EBD4A2772B50C35B3F9E2,118,138,20,0.2112995473337106,PASS
424054438C26F8B7BCB797A10BBC667AD6611A0E66DABE8641CC0E521C6C0C11,139,117,22,0.16913144470267139,PASS
6FB1617CB1C66BF5E93F0229F7E468EDC5F41880B1981423F5F5BAC09FD3503D,123,133,10,0.5319710580974012,PASS
424C78B832050390750E21E7D5143146700FB843E58EACA921D9370487C33CBA,144,112,32,0.04550026389635853,PASS
8DA150A1ABB5018B206DBBBA3F043525FE9876EAB85A022B6D7B5E3F37EB75BA,122,134,12,0.4532547047537365,PASS
AFA8F77C623AB1859ED5C347AFE32542C848290EDE555978AD51423040EFD943,130,126,4,0.8025873486341526,PASS
770AC10272BA3BB482BAFC094FA23196FD11CD2D0C0821AD64C6D2BDD6FC3172,133,123,10,0.5319710580974012,PASS
AC90398F57B427395DFC0FBE13CAA9D329DC15211E02EEE9BD28C56B7EB01D01,127,129,2,0.9005235503397743,PASS
54A72077B66C66F0C8961BDB36B5E9A469C78A09502B54CFAA64146B1AC363E9,131,125,6,0.7076604666545525,PASS
9BD657D6CA68DDFC0E9636A4DA333607318370FD9CC5DC22ACA1291A2AA04B42,132,124,8,0.6170750774519738,PASS
64F27E01CE1D425BA42EDB0DD112E421E83D8F35336952B9EAF96DAF233E252D,126,130,4,0.8025873486341526,PASS
144CF291915220FEBDE4D3CAAA06AEFA243D2A325698D941A305B2730C068499,141,115,26,0.10416255883043901,PASS
2F3F0F0FA12B565294DF2BB981AE0B8B836A8972A2695D9B264059D9C74124CB,132,124,8,0.6170750774519738,PASS
9FB90B22EBCF2DA22F6BC9C49E6B55082D4AD9663DF366E0455315388AACB96A,126,130,4,0.8025873486341526,PASS
A97258AA5840D8685AA223AFE9BDA72C982D88A63232C91170908FC61EEFF089,138,118,20,0.2112995473337106,PASS
92B2B5EAB89DC43B0787CB513462BEC1F460E9D39F70BC8495FAAD3526A432E7,125,131,6,0.7076604666545525,PASS
ADCDC155C2171152AD9930C8E1001F26D8C5E53AC1E4A7FB6F51BA11F14F3EC2,131,125,6,0.7076604666545525,PASS
B89B12E11189C88B5A3C825751CAD60D25F3EBC18CA157793781EB720AA33C86,135,121,14,0.38157390570502125,PASS
961F306FB5EA7D914D59B5E96D6715B293CA58B9B1002A4E180C4603B329F65A,131,125,6,0.7076604666545525,PASS
D574625E1DD5472F3537F7AF55E43D0DBFB0B0C5C7729CB3ED6490B82EC33ACD,116,140,24,0.13361440253771617,PASS
80429CBEA1E6AA4ECBC49FA0BEDDBED3341609288C5177B7F9FCD01A83DEE5C9,124,132,8,0.6170750774519738,PASS
58C6B9B332E5FA75A231E875C97782510ADA55F38E63D4ADA168A1BD2A48798F,126,130,4,0.8025873486341526,PASS
D747F8A4503D12F334C2A00298DB103CE6C6CAAB2517AFD2D52A176F31D0A994,134,122,12,0.4532547047537365,PASS
68153058FE1EFAC2487983EC93BDEE7D18D51497BFD21AC3E99DBB6C87599DD3,118,138,20,0.2112995473337106,PASS
A0BF2E00968DC47D20D9D74949AC5F89D111307171FC3A02E669DBA28C3EF284,135,121,14,0.38157390570502125,PASS
9B760E24C316D0E1D6A35C9C78648635BDA927E868EC9EFD65171A333C8E5A0A,129,127,2,0.9005235503397743,PASS
A94AB69A00C047896FD6EC4FB61D2AD7BF8BBCCFFE0BE3CF903A475DDA88E2A8,120,136,16,0.31731050786291404,PASS
17F98A0F98A5A32F025B86049B9A8AF540DE7428BD2FBDA985490B4E8BBAADF,130,126,4,0.8025873486341526,PASS
D889EFE357B530DBA555E1A014919B41D7CCA4FC33F09683AA116C3A2DB90BAC,129,127,2,0.9005235503397743,PASS
5A81A1AC640248C7CF3BA6030DB5930D8395278CF2A348AD9778975841397AE6,137,119,18,0.2605890342736178,PASS
F3B4FD8D0D21EAEAB66AD39D60A58BC188BACDB642CA40FE3CCF60149E072FF1,125,131,6,0.7076604666545525,PASS
AEAF52537281480B03841CADD6BD8C1739D1108264B7D5749ABC9ED1654E70F8,134,122,12,0.4532547047537365,PASS
74125FDF7F74D2BF83A8C5E805AD84DBB125873713E6447719A19108C9A68569,129,127,2,0.9005235503397743,PASS
82631D54750169F3DAB7068B9FA421404ED3E5B9083840ACEF800629CADD84E0,142,114,28,0.08011831372763423,PASS
FF8BD659FA90959CB3EB9AC266C681A1236256CB006D21D834F6101FDE4A976A,129,127,2,0.9005235503397743,PASS
552F072871E6951E7F6D432F53582946CCCF1645B57DCDD64E07352B5D72DED7,119,137,18,0.2605890342736178,PASS
74593E6C2900B76CDCBBA2F6B9D5608EBB10BA2B9ABA35A6F60434CB072F0A80,131,125,6,0.7076604666545525,PASS
8772ADCA8D3D872BD1DFE37514A2E5E70E3F00FBDF7FFBA620B71EAC15A4368C,116,140,24,0.13361440253771617,PASS
518F63B5349DA07F5E461F16CE95B4A80567FD9B43D37C2EFD10287D7FD7026F,118,138,20,0.2112995473337106,PASS
C1E673529896105C61BB5E26110ACF720709DBE6E495DD718041D789674623C7,135,121,14,0.38157390570502125,PASS
A787FA398830D031AFE107E32774A7A32241E1EA72206BD4355E7D91E8750118,135,121,14,0.38157390570502125,PASS
71FC8E8D574995C0FE3D3CBCCF81F2EFE9407C1D364701994847A67352E87BBF,120,136,16,0.31731050786291404,PASS
F8AFD2045E2D469125009BB98C056D3069D0D69C34DF075C8D13C62AFEAB1EA9,133,123,10,0.5319710580974012,PASS
5B16B9F24DAFC7125FD5C7D0B8956E7A26A2C20221597A8A76E8136F1C7889F7,125,131,6,0.7076604666545525,PASS
135CF5512D33C615F2B54DF14557D4A8CE4FBFF12B6C8EBF6782E640A99E00C2,125,131,6,0.7076604666545525,PASS
EC9D5082775A2E20126CD1B1FF8949C5FF32DEF4DF6F41FD735C3F195C0BA524,120,136,16,0.31731050786291404,PASS
45666103E2E47FAD9DD4C94CF9209961EDA0031F0D50473F20BBA196BD483900,138,118,20,0.2112995473337106,PASS
67B4CD31788DB69A6724776C81F35457796A24B7658832E17D9D563AD22020DF,127,129,2,0.9005235503397743,PASS
E78D9B6760F6FB30A39E1FC0291FDCA0C0542C5D3C8FEC0A092E8272FF11B8E,130,126,4,0.8025873486341526,PASS
BC83F8EA83CADFEF9E32178E1C2003B0C45C5819275FC272AB8E55023C5DA116,133,123,10,0.5319710580974012,PASS
D58B61F5606084E07AE03CF06B84B98C46E371685679C59269FECEF4AD55B9FC,126,130,4,0.8025873486341526,PASS
3F24169FC93B38B9948C78B62C5C313CC9DAB1DC5BC3270929AB04113F173BA2,131,125,6,0.7076604666545525,PASS
BB3C1E291B5FF785E6D8DB845ECA89480F1F5381CDBFD7F44B6B7DF250BE021D,117,139,22,0.16913144470267139,PASS
28ADA02924D7761AD03943927C1F47401E6F0DB29F523593AD91C8C2AF573B20,135,121,14,0.38157390570502125,PASS
DEA66F66DEF2EBC2B34D4B2590D262173E87A177A400409A86C73A006E86899A,134,122,12,0.4532547047537365,PASS
9319E07F40674369DA2BBAD0BA4744B5D7CEDB9D92B8ABAE932E9351731E9B54,122,134,12,0.4532547047537365,PASS
E2C9E53CFE2847E7B26F3F62E1063C914608E8FEFCCFD64F46665E8B7FDD86A4,116,140,24,0.13361440253771617,PASS
E71281DAD11EA7574F52A7805377A246CF42FF8C2040C1F6A357D4DF3BC993D5,125,131,6,0.7076604666545525,PASS
84E78146C4D472D89A1A06CD5B18D8ACE6F0391EC75179442FCAE72296AA6D94,134,122,12,0.4532547047537365,PASS
F454E9441F70BBD27958117B5526323AB269CF90E176DD9D56873CD3F10FCD34,123,133,10,0.5319710580974012,PASS
10254FB25FC1063C6E4499D8AC363D78B1CB5C6DE42920A955454684AD9EA421,139,117,22,0.16913144470267139,PASS
BB2FE60226F62C67F33A2211E07D9990D271C687D79D81B967506C8E8C29EB00,132,124,8,0.6170750774519738,PASS
FA68BCC33F4E9DDF36A633E668FDD6E38FDE490D294BB13A1930AE5424267846,122,134,12,0.4532547047537365,PASS
F76A1C2C6F94FE6F1CC7C45E1E3D6D2FADAFD47B6EE1FD00D24C3D930C12D1A7,116,140,24,0.13361440253771617,PASS
E03A9580E437FB4F1A82704C37519511D89A44A134416B212F87D154E21EB7C5,139,117,22,0.16913144470267139,PASS
77808A016EB7F03A096764A6B1CD8AF766082B9DC22D1401E6F54D2899CDF42C,135,121,14,0.38157390570502125,PASS
E5F89F81D16F28AD2D178C3EDB68B04FE1E36D7EAB734FD53CDD234AC2BC62AA,117,139,22,0.16913144470267139,PASS
7BF9F42D5CC6DFE7DCD7D67A093D9A0554A42A8646E9CFE7904BB5E6BE3C7100,118,138,20,0.2112995473337106,PASS
84CF0A554B8A1C86720574817B061401F1208CB543887CDD3E6E3075FAB995E0,141,115,26,0.10416255883043901,PASS
2DC1ABA02F44A1DD1C4FA7C4660CDB7550FF23AFB9458A549691BAE7FC77DB11,122,134,12,0.4532547047537365,PASS
7A613515AA681C47B3F0CE51B728EB0C2C046F92067F6B307A4715C04BE5AAFE,131,125,6,0.7076604666545525,PASS
BF4F52BE2A130A5DB98A1E8806619405A79335AC22325A8B3E144A8C4D119AE6,140,116,24,0.13361440253771617,PASS
C19DFF871F93C72914B7B05C7B1A4F7C02065038BEAC887CF1397602B36B5861,129,127,2,0.9005235503397743,PASS
97C437FBD1127513C42C493EFDBFE7B472E5F3749273BEA18CF706D11B95BDB5,113,143,30,0.060792723530522785,PASS
C0449A18F191C89C2FC3CF5398C57F27B884C662D8E77B87DCD35031DCF4D686,128,128,0,1.0,PASS
AD625F788B9275BD15CCA23F2135864CA412F38A75CCE2AC71138A7CEB3FA123,128,128,0,1.0,PASS
1B3C22604E2BC3211B6272793F2E544A9B8E5BE8F163A24BC3CD82F678CA74AA,131,125,6,0.7076604666545525,PASS
8B1589E458DA753265DBCAC3710770DA0AFA931D70882E3AE05977CA634241FA,133,123,10,0.5319710580974012,PASS
C7AF40409A21D985C059BAA3C96595A234937512F37C02A675A23606D9E70BD9,136,120,16,0.31731050786291404,PASS
F74E07DE75D29E57CA7666DCCAAB253061DA9C532DD1FBBAC58DCC1C14E338E2,120,136,16,0.31731050786291404,PASS
1F7D2E83B70BBFF0115A3D3CFE0A314B220C431927C9B29101B9548050D8F474,137,119,18,0.2605890342736178,PASS
8D5D1220E798909BF1DA7BD61960568F19AD15A15E4CDEA39F81828C4B522A3B,133,123,10,0.5319710580974012,PASS
51198545B33CCC24D82BB390041F107C9F9BAB19E6661564093B00E083DA37FD,138,118,20,0.2112995473337106,PASS
52A44139B5AB03051DB027FA9D6EFB545EE9F9D40E34365B88B0E372E643D4EF,125,131,6,0.7076604666545525,PASS
1E69069589B6A1BD7F71C8DFA349A26D4F0B9C9B7E2FD10D61306C5162B215DE,126,130,4,0.8025873486341526,PASS
DEA6236B34162736A4CF877B679E6FD27AFF52293C2598E3F6E967ECA219EE71,114,142,28,0.08011831372763423,PASS
2F012E5DCE5720F50C026317B894A63C1CBA82988F0099A699A683E63F4A6BD5,137,119,18,0.2605890342736178,PASS
6BBEFB4703DF37235CAC127E2CDFF0891D2D6AE4AE3F5CDE379D16A1DEE86239,114,142,28,0.08011831372763423,PASS
65E889446B7F503C8F8ABCDB3E215D317585FA99D07B1AAFB60C8A5ADAF6C161,124,132,8,0.6170750774519738,PASS
9C010DFFECF875CDB3FF06935E284EDED16A0E3CB4B4E9E2674C6A4181669C95,124,132,8,0.6170750774519738,PASS
8D6B6C3CFF4D796186FEEB6D80F7FA703E2E793C5261FE0CAC3FF4F8A50D00F5,115,141,26,0.10416255883043901,PASS
99274D5186A8424CB96716A4FB6CCF4CE6BE8002EFC47CF9D980647B060FA5F3,129,127,2,0.9005235503397743,PASS
994ED10C2AC866BE046F1C1AEA3C9CF795A71078977BC375F99237E68146086D,129,127,2,0.9005235503397743,PASS
9D9D84EBD128596708D2043685381119DCCD06D5AE920C20458A2CB2E8C6073B,145,111,34,0.03358661289689768,PASS
A74684243297ACC21E53F623A08837309DF7962175C8CE5E9556043444151D5E,139,117,22,0.16913144470267139,PASS
CFC15D55C0AEE79BC81E690DE9C58C25D70D4312B641A5D18E51E11E78A5395D,130,126,4,0.8025873486341526,PASS
8377682CC59550001A478EF8A247D4BB05AA7EF1764FAA54ABC2ED203EB07FC3,130,126,4,0.8025873486341526,PASS
6F1A8C4FB46BCF2F6360FB711E9E1587C30B7C468B9D3AE974A991C186C86D7A,123,133,10,0.5319710580974012,PASS
2D555C67C6F24C1AC46085FEFF8A180AB6660729E0B61E766798161F30301CEA,134,122,12,0.4532547047537365,PASS
3BF250FCCA7FBC04FE800037430305E23263B9E5CA24067E463C66988E050E58,140,116,24,0.13361440253771617,PASS
C61D3C5295213B62318249CD8416FE3E72B7EE2959ABD33764C03B3EC87BC38B,127,129,2,0.9005235503397743,PASS
71A5F8BAC3C167EA9556D3C21C1494CA4E190B99958395EB142EA22BACC6E3EB,130,126,4,0.8025873486341526,PASS
623E90189D49230A20EF22BD27330B3ECD553AF4151AC67DF4FF280897F30527,132,124,8,0.6170750774519738,PASS
D068A85208735F256721DB14844DFAB0B5E488E2B8EE700FDEEE49C00B5E9C8C,135,121,14,0.38157390570502125,PASS
AA0F163BC5E3DDA687002A7C5D9DC81AB283E7B1DBC0656496BCE552F51D4D6F,124,132,8,0.6170750774519738,PASS
384F80EE9F7A18D4411425EDEFEB454F45F1A28433F4186040C04B7298A54BFC,136,120,16,0.31731050786291404,PASS
50267D3E1B175F0397FD8888104B7B97A6FE87012362002A724DB6CC88587ECB,134,122,12,0.4532547047537365,PASS
A936FEC9C95C5E31F26F7AAC21782E61D4BD3E4B49FB396D7501166324E7BD15,120,136,16,0.31731050786291404,PASS
CC3B4C6F446615E692CADD9BD36F5E32AA1B8EC665AD6666E4488CA6AB0245F2,127,129,2,0.9005235503397743,PASS
C59684B1F58280933A9E8DCE50EAD78E5801D4817FE333497036E4C14A82C25F,137,119,18,0.2605890342736178,PASS
80E2EB6A7F9ADCDE98F694A4C9C574FB4759CA96A06AC7DFA41F0169A7E5A417,121,135,14,0.38157390570502125,PASS
FA4ED89DEF851673D503FAF65DAFA4588D753F8DC136232448288CC5D1AD437B,123,133,10,0.5319710580974012,PASS
A09978C1820859E7CCD6240360D1112FB76962295270BA6EA5BBEC2D126F82FE,136,120,16,0.31731050786291404,PASS
2E7DAA38A93B3C7AD6F813CA05011655D5EED260DFD339CB9FA538FF27123AE,122,134,12,0.4532547047537365,PASS
6F742497230D291E27A8E4BFADA4DABF5941EBBE60BD105B0F8F5CB290375ED,124,132,8,0.6170750774519738,PASS
A736E9DF09D24A2BC7500F0A15A4E395E181564B35E3EBFD5E119DED98418A32,129,127,2,0.9005235503397743,PASS
8C75B8DAC9FF5ACB4A1ECD81370B37CB01B5BDE1CAACB267A65473E5E0BA240A,124,132,8,0.6170750774519738,PASS
8C61CF5F60D6E661AE336A1AA4F9F66F2B64CD439E92B0251E98EAB5F88443C8,127,129,2,0.9005235503397743,PASS
B6BE8FA93190E719E73FB92EBD822B60FEF8D58DC31B3652F36BF977DEA6D38D,109,147,38,0.01754895019147673,PASS
D730E8C8187767FE514733A12537CB4D315B8CFCE57969A7BAA06B4B7A659752,121,135,14,0.38157390570502125,PASS
76D5F98E8E4E8310B0B72C5317D0A4F5994ADC39188736A667C1BBEE754B1320,129,127,2,0.9005235503397743,PASS
BB6EBEFDA3767E4F7FA41E19A425D4093C54D431FFC407CC2F50F58E05F89363,119,137,18,0.2605890342736178,PASS
13D19FF0C1333D9D18E0CB79CDD4C7E2F79691707E970042ED82E0D33AEDFF3C,121,135,14,0.38157390570502125,PASS
61553C0B980A79F2A570E499170B3A8B8B26CF3735F4D94528BA7FFDB43F05B0,126,130,4,0.8025873486341526,PASS
85417F5EA1A6BAEB2DCEF35D4F9AB3AFC5627606CE63BA61CDEC9321B1F854B6,117,139,22,0.16913144470267139,PASS
651F8C2FDD1799FCC2319C4FC671C67AED7602ECE6EEF6A4453A75E0775DAE07,116,140,24,0.13361440253771617,PASS
F71D546BD4253CFF0C011C5154582DE28493D73B880385D85A21AEC712B6FC62,135,121,14,0.38157390570502125,PASS
C7456C988B5BF6BD0F77F3CF77E799EAB1D0042D772C521FEDDCB580FD013EAD,113,143,30,0.060792723530522785,PASS
2525AE701A6D203389E005163D008AE884CD57712E996D2B1ACDAEEEB2BE9EBD,133,123,10,0.5319710580974012,PASS
48505E31F5BC360378D3D8A5D35BD6A22BF309BA686B65895F8823EC2EF132A9,128,128,0,1.0,PASS
A56CD040994822DB29A0067F34828E9F69B7A66AAE9547D933E9022D3EE9AFCA,131,125,6,0.7076604666545525,PASS
2E5C12EAAEEB4DCB35235368A77EBBFA1CF3939B8CE6C48DBEF56DD8E552E939,113,143,30,0.060792723530522785,PASS
8B35A9225773E391994ACC60D568CE42BEC6422AC93A60A0C18F24970EA29608,143,113,30,0.060792723530522785,PASS
EA6735B9FF4A0C2CFAFD1927D6590CA9E1A5FB3D665704089F089F95BABC3470,122,134,12,0.4532547047537365,PASS
1E3C80F86815712BF781963C3F2DF7AAA70690096BD84A53B44E982DE1B456DE,130,126,4,0.8025873486341526,PASS
17720ED82529678446DFA35796346390F5A7A0C0D781B1AAB21E353882256341,139,117,22,0.16913144470267139,PASS
E37D4E632EE6FBB6C5DBBF7FEE0B79AB55A2182D4B7CF9A2B450C78755FEBF0E,106,150,44,0.005959526470109114,FAIL
3052CAE66B3368021C9B0910316C42E73582FBE6A0BFC8A2BB60F05065A5AA3D,139,117,22,0.16913144470267139,PASS
5A36F504EE008F857CB53C4EA37D86997675DABD0670A7CDB6FAFAB3B39D98BB,115,141,26,0.10416255883043901,PASS
2D9CD97861834C19EF2E638FA5F305129D705506F408C0A794E6669070C7B2E5,135,121,14,0.38157390570502125,PASS
35D7423C03AC1D802DD13ADEDA41C3BDF2B273D2A1CE74CBF2F78997AFA213DC,122,134,12,0.4532547047537365,PASS
25EB6BE7E1DE767236113B803BDB5E625C41196D7E88CFFBDC7F6F8C83A720AD,116,140,24,0.13361440253771617,PASS
161A7A33249243E9603BFFA4941BD6F762D375959AA5F3F0908108DB82204193,136,120,16,0.31731050786291404,PASS
40013204D2F46640C91CF26784C3CDDDBE63A4A9DF973BB8F25E9D0E513A6C30,133,123,10,0.5319710580974012,PASS
A4671B768F68928129590E6E0CA815B0C66FEDCFCDFFFC94475BF59F73B15803,121,135,14,0.38157390570502125,PASS
71782A97B5C267829D62D62264C57D1FDAC66A18AB94A0CE014745087BB2FD84,134,122,12,0.4532547047537365,PASS
A9DF538270585CB961CFBE39A8AE616B4FCCFEDF332D536DA64ADA43D3FA37D2,114,142,28,0.08011831372763423,PASS
BE919DB2E7D81FC6B8C09959E2CD640EF2AF5AEFC91ABAA4AC1E4EAEA023D18,126,130,4,0.8025873486341526,PASS
D5A2ED03879D68F7ABBEC28AEB66B56B35EF48966AF5B7CFCD0090A613476B4E,118,138,20,0.2112995473337106,PASS
5775E9892E8E718419F78ED73354C03EC08A82D3EC92D31836346221005BC942,140,116,24,0.13361440253771617,PASS
CCB418A7458003F0AB0AEF581AA1227DCC42A5264A77819CC6C04946F1C07287,145,111,34,0.03358661289689768,PASS
87FD2A3102A8B94B844BC525F55EA743CE1CAB8B6353C24FADF67AE7D3A15F6B,120,136,16,0.31731050786291404,PASS
F2AC104764534F209840670305ADB52D43EB7C079881E97C7985711C453D5158,141,115,26,0.10416255883043901,PASS
A78FE99544A93EDA211A8AC5D93772543A04C389598561D779E8DC6C3F96F53A,126,130,4,0.8025873486341526,PASS
722E0B2046E7730E879569063C72992EBAE5FAE751C3388B196E50790950172C,135,121,14,0.38157390570502125,PASS
33AD0D4B9267625401565017CCE78B620D19127EDA4CCFD18646FBFE92202BE9,133,123,10,0.5319710580974012,PASS
BA2F9756D354A07E1AC9FA811F9E43588279C9621CE6DB0CDBF76501813385A5,129,127,2,0.9005235503397743,PASS
C914EA43B4A62D14322671D5BCBF89FC8B0F9073DA79F187417221EF86168F32,129,127,2,0.9005235503397743,PASS
1394156B4B4E21043FE636B4314EBA1409B1539B9E92FD8CCDA60C9541DD4C23,136,120,16,0.31731050786291404,PASS
C93B9AB89344E9105A8E5899DE1F0B5F9B01122D253B4352CFBAE1D30A34CC92,134,122,12,0.4532547047537365,PASS
2A691BD983C78986324621511CDA3A9329AE2BEA941A1D8364EADEB682B007,142,114,28,0.08011831372763423,PASS
9F29FCE3F25852612230DBF45C82C215EF242EAD3587A3ABA55E21FED02E2CBA,127,129,2,0.9005235503397743,PASS
4CF7F52D91CDBED7471AB7DEF2BB27E1E2ADC5F9BD33C54FAA7B1862EF820393,110,146,36,0.024448945310089426,PASS
21F0977F714F480AD705146554241A401771E820542B262A771E90D01F61A75A,144,112,32,0.04550026389635853,PASS
DB7644B2741371E1D04C894775E2992EDFF64A1EB343FE22092A4283FADA22CC,130,126,4,0.8025873486341526,PASS
7BD8E2928C563B745D04BE12329EE080FDD9D4D00A0027E753C64D60C5A78E48,137,119,18,0.2605890342736178,PASS
7C526A65294E135F8F2999241D39DD000729AE1BD2F55A6E7C06509331263A97,134,122,12,0.4532547047537365,PASS
D48C8DA7BAEE8D1105550B1A28E1F10D59DDA8C085C6C5C2DFDE8E1212AD6B17,133,123,10,0.5319710580974012,PASS
DC7A093BCBA37956847C158AF1D8D8AAD396A2CDD40AF1D91F89D523ED2F9523,124,132,8,0.6170750774519738,PASS
A22C7A2C4BD256047B8B1895D052DF8BA414008054ECE250D01BAE028A8C23D0,151,105,46,0.0040402749798920095,FAIL
9F7B9DEE18EDBE37C628A08B67034E3AEC04772C3E6931D388BFC205CC98A16D,126,130,4,0.8025873486341526,PASS
A1D96CB1002889C6DC0926E45ED1C72163F96F7D4A7D45F12F7AE5BFAC4FE3D9,121,135,14,0.38157390570502125,PASS
DE65B413847E42F5EA74DCBA1F08E920409BFA1491BFF3ED5C9A9F4B41DDA82E,123,133,10,0.5319710580974012,PASS
C0A986FB8AE1ED8F7864916C89CCCE68E4E3EDFEA1C566629B9308FFDA2A71AF,121,135,14,0.38157390570502125,PASS
32D7A00BD88ED1FCDFF765790222A52DF49B2413AFA992BA79F7216AF3EA1B50,122,134,12,0.4532547047537365,PASS
47B822C3B2BE2A90460A244261F8889D9C1C32BE0114168EFBC33D4F8812A150,147,109,38,0.01754895019147673,PASS
200166AF7E8DA420E5EC7CB3E213BBB9DAD1773AEA80D81F6FBF4EFFD2E9639D,115,141,26,0.10416255883043901,PASS
9E416051A59C2C6BA29FEF81936FC9D31BC3AD9E546D2F82F7094FC39A841735,126,130,4,0.8025873486341526,PASS
F96F86AFADC7D3F29F5234DB75CACB1C28EAA234CDFA90EF7A7CA78B2DD7E485,111,145,34,0.03358661289689768,PASS
EF60A52EC09A702C22A40C82BE273608D4303BA532F69B6C34077BABA85D6BD7,134,122,12,0.4532547047537365,PASS
C77C6F0A3241A54C5D0EAE1FF54354BDC3F0F2BAB56C84ACA8E02985BA1CD602,131,125,6,0.7076604666545525,PASS
7A8463F8CFB4D15EE547CEEEA7379BA32A5F1E3B976CCCAB6D117405BE35F54,116,140,24,0.13361440253771617,PASS
39836148A4CEA64C23F3EC6C575600B659EB3B0D3CF10F23D1D7EF4097AE5B16,127,129,2,0.9005235503397743,PASS
F40B2520D76B45B0A48149ADCA36A4857BFE6E424D60E19EF0B31FBA098923B8,134,122,12,0.4532547047537365,PASS
618BB2580F2962A03FE711D5DE858FB80FBE967BD26D3E76DE42BD9991B6E512,121,135,14,0.38157390570502125,PASS
C0B9785B1BBECF655B61A54F0A728FA36CFEC150735BAC5798CE31C93B4F3881,123,133,10,0.5319710580974012,PASS
75689DF84AF07A899482FD214525F72E3E4CF1BB6003AF0AC6E8D5CB2E929365,128,128,0,1.0,PASS
6A19128A0F7E15E80A00A4A6B0354F64387A891BE9315A5ABC907D8EA25769C3,139,117,22,0.16913144470267139,PASS
F1F7BCA4ECC2EE412034C6C74585B5386F18AAC301B3BC9A79E06F4295966C74,130,126,4,0.8025873486341526,PASS
3ED6DED9E50838B893D2BC52B2221AAD74985AC4AADB3E558526D69BC4022593,132,124,8,0.6170750774519738,PASS
56CFAA5E21A89F50A89948E6C361AB960413899AD00131B27F042975F3997DA2,137,119,18,0.2605890342736178,PASS
3C83E8EB941B31069EBFA14497F3B034FDAB5B0B813E0B0226205A5232E131F5,135,121,14,0.38157390570502125,PASS
AA41700DB38C6832A6124121B3621DC4E4FEC118A2FE9F4FE35621A3185E458C,140,116,24,0.13361440253771617,PASS
E37B9B3E42D6D2B1D43859EE63DDD5D08FFE90ED2133FF6B7D964B75297F810D,112,144,32,0.04550026389635853,PASS
BCD0A149FF1070518CE66A73EEE0825FAB0C7079CC29A2442E43244816D2B89E,139,117,22,0.16913144470267139,PASS
3509D36404FE1160095ED3A383D69CA3D5D60B218D9D9AD38726D890E4BA3A91,136,120,16,0.31731050786291404,PASS
C1C675A8635E9EAAA64DE64B9827D4E39DE4680F5FB11987DCA9392378FE10D4,125,131,6,0.7076604666545525,PASS
3DC84F18CA3ACB5D216212E276C9C85647C133FF1F90B65DF1578740E6763C3F,125,131,6,0.7076604666545525,PASS
33B4D4715293517AE3E7DBEA1415E37208B396203E02604C4533057080A8A96C,143,113,30,0.060792723530522785,PASS
FDEC4BB018EEEE7E0FB5F952C6881AA4CA754ED7AE6B2920EDAC045CEC6FD96F,117,139,22,0.16913144470267139,PASS
468913299C6FF10ACA67AE6850B498D8C28EDA8FBD27B040C9E52485E6720A7C,136,120,16,0.31731050786291404,PASS
3F6DAA7202D70562D688D201CD89A0D7756F3B1B8CFB6E2C7460305FFF100AF3,128,128,0,1.0,PASS
3626CC809DF93365F967CA23996D0FDDE80B192037F46CDBEC0E963E6AD4DF38,122,134,12,0.4532547047537365,PASS
7CDF69C0DBB1C03E801F56E9E042D3D367AA58C3D8D7F012D3CE9DDB3C1FF7F6,116,140,24,0.13361440253771617,PASS
16176B0E4ABD5F6E61770434612878A43721714C230DD887EAD4FD802920C3F4,138,118,20,0.2112995473337106,PASS
FDE9CB0908C8788C1DBF4354A2086E7A068E3AAD3FF36CD2D3DC0C0CD3D4D372,128,128,0,1.0,PASS
DA4FBAE339C4C0EF4C0520AFF1920DA525B8E7DA2B3E5AAF30F306A132ED34A1,128,128,0,1.0,PASS
94F3DDA95120D255BA67F41F78F9B91D9ED0B630F4E9C6547B4074FEA2E89B07,121,135,14,0.38157390570502125,PASS
E457EBBC8B49E65BF4C57E219A3E0A340DB3432FA238FCB98B600163B85A3DD8,127,129,2,0.9005235503397743,PASS
4C859A64F241B282B891A3E3748A1ABB4ACB00666997586EC1DD836902638FE8,139,117,22,0.16913144470267139,PASS
82D87018C148B6D3EC7173A176E9DC4697D3EF4100A42A14D5FD9515F59DA1C9,131,125,6,0.7076604666545525,PASS
1F28923DD41CF2B1A27DF8A8878EBD7FB9DBABB00A7EB16E981D5F626F9952AF,116,140,24,0.13361440253771617,PASS
1BE641584F56534500C5081AAE70DD5D3A08C75780EC81E3E184898620CF7670,144,112,32,0.04550026389635853,PASS
C22B2E1092F984C165ABFE7EF3568F75C716E3F9C3FEEFCB63F68CDDB02AF6C6,111,145,34,0.03358661289689768,PASS
DEC722AA2ECCD6CB417E524F922DA3DBFD33B464B87090931B182E6C3F84323D,127,129,2,0.9005235503397743,PASS
5F781C76194826694235B096443788DC0BB46E72227750FA7403EAD9397F3A19,133,123,10,0.5319710580974012,PASS
1F92507481F399E6AAA739CAD7D058141C05B5FBE004BAA17A35C8B4EC742E6E,131,125,6,0.7076604666545525,PASS
BDA54DD68D5640C012C577B58C043874750D1B1825D4853B6F80E991D3652011,142,114,28,0.08011831372763423,PASS
BDFFA634F6AAFD59D112009297BD95AFDC39F075A2C11D224045BF549D5746A9,123,133,10,0.5319710580974012,PASS
5AC7E41C0E2033967CADF37A21BB73B5D2CC7987CE8490E7407C4F22A14A6A4,133,123,10,0.5319710580974012,PASS
1041B1E5126925D80345F2E07350372D147DFCCC8F0E516B54B0052FE9452C16,141,115,26,0.10416255883043901,PASS
73DBC29F29F463025243E7EB9B6A1A8D7BCECF2D9A600D51C1A5003210B80F5A,133,123,10,0.5319710580974012,PASS
E380093541BFD8B7DC65CC3D045B8787ADFCD5D713A8C27AAEFDC912A7BA539A,121,135,14,0.38157390570502125,PASS
E3FD529DFB8E8F7AD7F721CB5D07F36EEED8F9D707F8B1175A4A52C4AC1DF652,108,148,40,0.0124193306515523,PASS
82AF735EF6E9EF3F4DBE8734F264267407415343E79F98E042C274E4D4E03FF0,122,134,12,0.4532547047537365,PASS
16E8AF2928570802B82EACDBF1CF27C6B1CC67B81C6928D1081720598DAFA08E,138,118,20,0.2112995473337106,PASS
E43AB6AF9355D99C52C1188DF8B93C030C2404768D96E766900D8EC1EEA82C05,138,118,20,0.2112995473337106,PASS
811870A8E5E6A0807BF3841900B2B2BC053FFB16F14C99B42B66ADEC9598FBF1,132,124,8,0.6170750774519738,PASS
10009CDAC8CB88669FC2ED04DDB9BF6DE73613924AB3AA102022A03D7BFE80A0,138,118,20,0.2112995473337106,PASS
DAE102DED19E6F34FE63B07F5F67C5C42E7B30260F78AEBAEF3BDC1498521295,119,137,18,0.2605890342736178,PASS
A6AF3918518FC4AB204B19137893F8F2E1805B46A6549E92A43AB65FB0B8659,136,120,16,0.31731050786291404,PASS
864B3238E399A41AD7F6BF85703107365005FA34DA7E0DB942B649BE2125D0CE,132,124,8,0.6170750774519738,PASS
805AED7F8136F370576EFFBB1F0EC545E6426511DB3F26CE635DC138BCE38F9A,117,139,22,0.16913144470267139,PASS
CF6AE0DF069872B531B19F6BDA85C23FDB858A979E7B90DD19A25279B24108FB,123,133,10,0.5319710580974012,PASS
E4B98C16B84CA2CEDC26CD23C1747A357525E8BA02FB8E74567B6E097745E71,128,128,0,1.0,PASS
891824F1783BC5ED40DD99BC3C7F24D1FB2F3F357B3F242F00734CF5D854B19B,121,135,14,0.38157390570502125,PASS
61E20BCA45F4C437FA8BADF73EE0B964CF024B93ED1C6A8B6268E77387592ED1,123,133,10,0.5319710580974012,PASS
1E874A23F9303DDB2701DD31E1A2E3675EC6635CAAA0E5611422990C42F521F9,135,121,14,0.38157390570502125,PASS
10DCC5EC2B252DE7455E09F243EF5ACDFBCA6175F76BDC99DE6DD0F2ECA5BC0,117,139,22,0.16913144470267139,PASS
6D9BD0E1BCD94F0E8A0B4A0BF318313FF49C833D0967D9ECEF2B018D88530F75,127,129,2,0.9005235503397743,PASS
879AF3D010FD466FD72B1296FF9262A6559833BD103CC1A9BF4FBFB93F84DD04,120,136,16,0.31731050786291404,PASS
9E9D93F6AB0D6C71481BCDCD3A1E3406C8725F12C61C838D5E6AE168FE6BEA9E,124,132,8,0.6170750774519738,PASS
1CE088043C12F759ADCA34D8CE099581AB751A45AB35AC3755AC5BF6AB0FD493,131,125,6,0.7076604666545525,PASS
55CF98E17FA99638516EFC3CFF4FAA1F5097C0E3A6E22FF30153E4F9D0F4ADA,118,138,20,0.2112995473337106,PASS
39AD1ACE2421CED845DEF63510E8209137D9FC8E0018A3A83ACC17496ACD0DDF,135,121,14,0.38157390570502125,PASS
43C7BDCF5E3E5CF41986CF6D2FEB05C56C0A90C149BA78F26D69490253C9CDF4,124,132,8,0.6170750774519738,PASS
E6A1DBB044BBEFDBF493EB6D04D9F2E5E287B5D353E61A1236EB74FB9F8EACB4,111,145,34,0.03358661289689768,PASS
50B91776D527943172CFA8125285F3063EC3D4AD26CE42286E9188ABEB34D7A4,133,123,10,0.5319710580974012,PASS
C204C741E035702321C1526D0194949A91AA4BD983CF492CEF2FB47AB3E894CA,140,116,24,0.13361440253771617,PASS
54978DCFEF212EAC9871EF7C440E12017A6417C7BE876DC4C87B9E398D403497,128,128,0,1.0,PASS
2021C2F16D5DEDE3A1317A5ACDDAE046524189DBF62A7CE07379D3E93998C773,125,131,6,0.7076604666545525,PASS
2AE830DCB701E635643908BA5888B5D3771F57608D6F4643A295658466A53651,136,120,16,0.31731050786291404,PASS
1D8D98975B2D6A079E6B16FD0F83B719659A9C07156E0D9A8F916B794B470846,128,128,0,1.0,PASS
6189C922CDD96F24EE6A222CF5A4FE87943BECDAFB854EEBE45EE2671C1E51DC,120,136,16,0.31731050786291404,PASS
89623966ECE4D39669171F45F38BD930EE06240F517A0125338E381CE5BFAA2B,131,125,6,0.7076604666545525,PASS
274C4AF1FF4B50498A2369E9F40EDE9B75F85549520E0EB543F3D313ADCCB49A,125,131,6,0.7076604666545525,PASS
B115D82982F95649AD3D125D495C00B873A554E3C24DAC447C2C6B1E0ED650D1,138,118,20,0.2112995473337106,PASS
319F8D40403FEFF1EC53AFEDEFD3028A372B4BE7BF65E5772FB7FF28E5B5B44E,106,150,44,0.005959526470109114,FAIL
E891AAD451B8F384EA1D9959476F089D6578A51FEF506EAB2F568F4B4DF7BC8A,120,136,16,0.31731050786291404,PASS
B30C33086379C39D56DD017EEB4D1B22BEB8652C5CF34AAC24384F92B27660A7,130,126,4,0.8025873486341526,PASS
1BDF10CB1A77531A535C007C5023AABBA0E36B4F37A2B8C66846A9E23DE93E36,129,127,2,0.9005235503397743,PASS
8B15E9D0938BA6B3619D94F727DD227782697F661462F3F83521695C5019D333,127,129,2,0.9005235503397743,PASS
77F7032F3FC768D2E44944038ADCCFDDAD948D75CCFDB7D6D8450E137687FEAF,113,143,30,0.060792723530522785,PASS
45EABD4C201AC779459F1F50554E2A5C65BD96167415D71B4A877C710822EB7B,129,127,2,0.9005235503397743,PASS
61760E8E9DBFD27935A7C578044850101F88D43F1C8E8AA0AEA37B9D537C9AE8,131,125,6,0.7076604666545525,PASS
540241CC1D737081E8DADDB402718DD01D300C1D0AD6FB0F956EE9515D6A4F2C,137,119,18,0.2605890342736178,PASS
DBA6D042C13723CFF639F2D743C9DE2C06ECE1DBFE0A579ABB5C81061C5BC73E,120,136,16,0.31731050786291404,PASS
5E0546340621E1F8A399DEA33D523AF7F17B53E0484415130697656FEECE54A0,132,124,8,0.6170750774519738,PASS
8B645B1CBEB94B0877A45FCE4EE07B67ACF60FDE6FA9F500FADA133ECB8AAA12,118,138,20,0.2112995473337106,PASS
7EC398F3C668C0F85DD88FE4C7078948B63B40D8B250E7C926CAA45657402393,134,122,12,0.4532547047537365,PASS
112BA4892E8DCC607CEABA716666E260DFDCAE37CE0AAC1F5B62028B20E6561D,132,124,8,0.6170750774519738,PASS
5A98AA6CDDFBC0E9207BCC8CCD0507ADEC4045A4AE19070BC31D736CE6FFDAAC,127,129,2,0.9005235503397743,PASS
3FB0E841E01795C854A5B07B95ABDEAD017BE79838BD2897B861B4C2C194E95C,130,126,4,0.8025873486341526,PASS
CC5DA224529CB440A00647A5C56E5754831FE7CF5B4034C90AB43BF944B335FD,133,123,10,0.5319710580974012,PASS
A31253E236C68210146BCAC5F8C8714A28B0070ED2FEDD01D8448E5E2E14047C,145,111,34,0.03358661289689768,PASS
206C6126899AE3A2DF99692408F9546D4838A2045ED4E39FC068FCD7F1712DF2,134,122,12,0.4532547047537365,PASS
69ADA8A251E65C55CA49B04B07234302E676D4757AAFDFA2D763673FD13F247B,122,134,12,0.4532547047537365,PASS
8F0888E4BD137FD6659BAD43760E167679AA373FDE031DF9A21BC748C8F6A6C,123,133,10,0.5319710580974012,PASS
7223F85FB552E1BCF9E0CE1A05372A721BE7723748E9E1CBCD07F0FCA6C0A337,122,134,12,0.4532547047537365,PASS
8411CB32185DE3663ED1D3F87048778FFD5B8AB81DCE95F8359439AA2480C031,133,123,10,0.5319710580974012,PASS
1A57450701FE288BD1B299B184EF8766B41622C2A91AFA3DD873F400FF12233A,134,122,12,0.4532547047537365,PASS
23C2DAE25C0184665F20E65068B24BE5889B03DD2B312FBEA9F1B6BEDBD1ACC2,130,126,4,0.8025873486341526,PASS
1DDBF9F8C66D65AAC45B3674CE19D7F364F8124F5859F05EF7EA8F5DCBF97CE9,108,148,40,0.0124193306515523,PASS
9F934EC65CDE8646D6EFD6AB16B15E07BA2DA36978D7550EC9BB8DC6F72733A8,115,141,26,0.10416255883043901,PASS
32E58A602C1E302839C86A7F18C77BB4B1430DB95A8EFD5FD3FB7D8B7CF720EE,120,136,16,0.31731050786291404,PASS
4232DEE8F39FA56D1A38F3BD9AD9C1A357FECFD7B4C19D7BE2DA6084561F9C7F,111,145,34,0.03358661289689768,PASS
9F7009987ABBFE5937D606A8BD3CB36F79F7F2C4E602021AB3AD0E6CCA919C40,125,131,6,0.7076604666545525,PASS
392580A291C295C7FD7497681389CE571A04213945D2C521AF229AAA15DAA5F4,139,117,22,0.16913144470267139,PASS
3A7BD66D433A2AC5F2216A02A05C2404179A19C79F3AA3C74C8FCF129FD6EB9D,128,128,0,1.0,PASS
87817D516AE15140688692F9F4BC4F106DE1B1C4E972F31A014DF1C48936AA42,138,118,20,0.2112995473337106,PASS
DDAB4AE961F398053671F3A88FF6DBE6A0CF7BF72C101AEC13F0AEB5FA08C8DA,119,137,18,0.2605890342736178,PASS
6B8CF28C0CB6D0962440E3C6A701708176ADAD3C59985205EB5F9E8392F3D650,136,120,16,0.31731050786291404,PASS
FA9B55E7B13BAA416FE7CB0125E3299C3C2CD9047AC17DC8B93361EE95783C6A,123,133,10,0.5319710580974012,PASS
7B878E8CBC83427FE77785BED5FCAFB9471A77F391C9DD37A41A74527CCF4C42,113,143,30,0.060792723530522785,PASS
3C3F0C32F71D8946B6303E3F141B5822982C5CCEE464C8EAA26549495D585422,139,117,22,0.16913144470267139,PASS
5A2B25FBC3F19B6C33AFB3D254185A4D5C8856D1CA2E3DA82BFA98DDA2318BEE,123,133,10,0.5319710580974012,PASS
611DCBB724A82EBE62BF036C995CAB496C092ACCF0E3512023BA6B78D8747971,131,125,6,0.7076604666545525,PASS
9A702AA612785EBE8C450A123A57A826FAF3A6F22EF7F12F9CE9F6A6A544789E,124,132,8,0.6170750774519738,PASS
39A1655FF16C74E4AA9984EC96757B88A182D946B1133A373FF8D2A6CA8FCFBC,122,134,12,0.4532547047537365,PASS
6A368EB120711152098CB89C9B7389A05AFFC8627F4B69204C8DF2339C4D2C69,137,119,18,0.2605890342736178,PASS
33D16E833167B78B0E3C25E7E8C398EBF66ADA35F2BB1BAA4DB87996B43193B4,119,137,18,0.2605890342736178,PASS
AE95D7D092D2F526A31EF904FFD165E5EC290AC824104496086152BAEF0D8673,134,122,12,0.4532547047537365,PASS
7D10F70E39C0260A211E38D6FE54DCE8E0C80CDF0A66F444976C4B7A3B9D17C0,133,123,10,0.5319710580974012,PASS
FD39CD55DBCA38FD47E8C0D04FFEFC6EAC561B43B78DE7F277785F69AF4099D2,109,147,38,0.01754895019147673,PASS
2F0A8F85DECB49CD9EE77A10C2771150A2524BE10D47DD80D2A17C11DE091247,136,120,16,0.31731050786291404,PASS
41B9C67419F53E8F2ECFC8C5B9BC9B17607416B4E13F1616157415532C6C3D23,128,128,0,1.0,PASS
86E85C8F312779CFCE3F8297E2828957FC043D6D3228BEF60E2094F2B73FD246,125,131,6,0.7076604666545525,PASS
71B3C1C49D8B42DFCC5A1CBFE090FB11F85D9DE0DD7B691827078BC61567CF28,124,132,8,0.6170750774519738,PASS
8A81400C02817457C33FD4C46D213E633F7498B6A362A60BF6B4C0F918679AFC,136,120,16,0.31731050786291404,PASS
DC31769772F0BD4FE0908EA1B0D79E97B1095B17AA72A1B81AA8C798C94F708A,129,127,2,0.9005235503397743,PASS
D726AA5921D42E039A685535117FE3C2B77DF6725784AEBB5C197DB855726F86,121,135,14,0.38157390570502125,PASS
F199B47E0A256F499CF1A49B488F05328E104D4C894ABC8A9A62B8CFE39988AD,135,121,14,0.38157390570502125,PASS
2DEA11ED49685BEA8F9B5F3E825478DE1EB898FB58EFC969A0DAC7BB12B4D4A7,118,138,20,0.2112995473337106,PASS
4DA2A0A0D54A66925FF09330E5EA751F4F70043C1A06F7D4C04FCA336BAAA882,136,120,16,0.31731050786291404,PASS
546E9B9B941812854DECC42DF665B11BC8922B8A5EACBD9A3C45B4BB256E5754,129,127,2,0.9005235503397743,PASS
433BD448362ED83749DF699482E2DF988B39399841723FE5ACD59B8F87BBF9F5,119,137,18,0.2605890342736178,PASS
34946EE0FEDA2222C1C9E2B62F607B3B6C282822878197D4F0D88C03B47853FD,135,121,14,0.38157390570502125,PASS
830E76C9B76A0A1B283BDCB26495B69DAF4A91B6C7C48C51C7182A86E4EDB8D1,130,126,4,0.8025873486341526,PASS
FA3E90C7B096DDE4F24F547C667EA88C018E4A37311D6B2D524C525D13EA22A1,131,125,6,0.7076604666545525,PASS
E28667B79FA661A36311C61F0E151DA5E481DA855FFDCF3A5A4443438F7B6997,123,133,10,0.5319710580974012,PASS
57D35B10BC075268E5ABE73D4037420031CF6383D673C71E0FF325E3FE91A47F,124,132,8,0.6170750774519738,PASS
75FB25C9D4634A500545B0EE775CBD6E8B0B407F1554E277C3FBD6EA1E257A64,122,134,12,0.4532547047537365,PASS
9D59E31E20DC10BAA453A499A86FEE063C7D2A98CE7E8E7822AE1C0FA418C487,134,122,12,0.4532547047537365,PASS
1B9167454D2D3D33E35E99E78FA5E04A2FAE3F0CC7E0EF74C9DF727669417C12,119,137,18,0.2605890342736178,PASS
55052F53FEE69D8E863BDD184520252200A177E18C8CE51BC1800C315644A227,145,111,34,0.03358661289689768,PASS
9DF34093649F0715403B732BAA68A94C25B3C736183131205CE6168CF0225434,143,113,30,0.060792723530522785,PASS
A74799BE67D89A0742696205A87B65ED99AA2573F1366E1E0689963660DD9B58,128,128,0,1.0,PASS
B4441DA225614027BAAEB44D62B8484CF221F8B39CF946D606E3631A0327AD31,139,117,22,0.16913144470267139,PASS
F264072B3DC1294BE6D7C294D13A46392706015AFB1F84AC68A957DF0F5FD1A,130,126,4,0.8025873486341526,PASS
8326BEEF2CB30BAC49BAEF447472387CBF3E6B439248468B85C3BA1E84CA262F,127,129,2,0.9005235503397743,PASS
C057103D7A0C04DAC452CDEAC39C3D55EA7533C4450B6A58204D98314E51F5F3,137,119,18,0.2605890342736178,PASS
E0B4D26B8F551AB3D2C35D206AB29F2F1F92D53A2B45744750C8B66662ED2D8D,127,129,2,0.9005235503397743,PASS
6787E9D191CF539B7A910C7AFF2FD3BEB2F31154484FD1450A5C327903FC5921,124,132,8,0.6170750774519738,PASS
26A71E3190561A87B04D7566FCE255EFFDCC9B5B6B17846C4F7170C103376E42,126,130,4,0.8025873486341526,PASS
F28CB47A339E769134F1E512A575C1C7BB5D12C8CB75D2215706F21EB4B3B056,126,130,4,0.8025873486341526,PASS
7AEBF3A5378BAA4DF52D0B82EC742D584638B90B228B732FB919C5CD9FC236AC,123,133,10,0.5319710580974012,PASS
B80DA21E543C87518C8398B69C8C90853B4142DEA7121CCA6E3736295B98E693,139,117,22,0.16913144470267139,PASS
DF573D16DF375BD8C1DCA05267498BBDBFA8B5D20A367D16D14B7A4DBD68EBD8,114,142,28,0.08011831372763423,PASS
2DBCD1EBC072BC2FAC3B7C407C007CCBAD513C48970A08B3565780C8291300A8,142,114,28,0.08011831372763423,PASS
305806AF09111997E80C50FE1976B315BF1BF33A751A092A6A6D9F1243BC2867,134,122,12,0.4532547047537365,PASS
F022C8F6A38CCA0BE2CD8C0A8DC3C9EBABBF8E2897DD1ECEEAC3B24B2ED9FC78,121,135,14,0.38157390570502125,PASS
F179599879F49942AFE941425A4E4CF358FBEBC3F8084AE89FC6BDABD5318638,123,133,10,0.5319710580974012,PASS
3465EDDBC387962C013B4834E15E600C33FC8BB57A174A2B40C0197CEB07E9E7,132,124,8,0.6170750774519738,PASS
AD7A198C119B7D150798728D5884C11503ED42EE7BD5263FB2E6A0869A244668,137,119,18,0.2605890342736178,PASS
76AD17197DBFB72E86462E9E9B3267BA93E7CB55D02DB00F7A3A0789C16AFA6A,118,138,20,0.2112995473337106,PASS
279D9A867573F424C636E3BF6CB65AD57A79B710D51F0D035C54FE31D271C9EC,119,137,18,0.2605890342736178,PASS
7BD885AD882E80C0759BD9FB4C09F9AFB3746A5C7E2281527AF6A450A793D541,128,128,0,1.0,PASS
B92F822A37FC7AE4C6EADB708243318E37E92402FCE5AA545DC69BFB3129D944,126,130,4,0.8025873486341526,PASS
F7F9E75C93CBE9D9A7319D58C9FEB733475B9A60C0618757ADC6339079DE9DC1,114,142,28,0.08011831372763423,PASS
DDCA0B39738A23A27BA26108BDC9005E8374A9C80E958F7A0A64F2E2F47D57F1,131,125,6,0.7076604666545525,PASS
4BEBFEA8D697347A61B6C63ED5035D1A3578E190887EC1A0690F125E83F67F0C,126,130,4,0.8025873486341526,PASS
6EC84DBB84394A9495BD8F2F6FF91161F01CD12212B02D1113860280C488D5C6,143,113,30,0.060792723530522785,PASS
A95B24015C72DE3C2A8EF94F971BB3D7D0B3D243930E7177F9F297A9AAEF44CE,118,138,20,0.2112995473337106,PASS
C68E6DCE912DCF11FA65CF066ACD0247EC6C7CB2E8BE8847012C8DF4DF776884,126,130,4,0.8025873486341526,PASS
D2031710EE81C91490EC860E4D8BCC85DD7198D1A37079A34F0FE85ECDBF77D7,128,128,0,1.0,PASS
167D5AD911787A1F2E7FF4A15B69AAF16333B51CD4BA9B321760592E5F09E7A,122,134,12,0.4532547047537365,PASS
4F75B5BD254B55A0B3F3706C56BB39CB7C4817BF47787636773F08744132E8F9,118,138,20,0.2112995473337106,PASS
E85E1BCF0070380EA505B824B66EBBA1E449E3AF7B111F0D5A22B3B361DA389F,130,126,4,0.8025873486341526,PASS
20C3997896238F42E39D1BEE68EFC2F498C29E749206686390942754BD52776C,133,123,10,0.5319710580974012,PASS
8EC61F61541DBBB94582B3737F899C757BC6E5FD55883FB6BA08C06E689976BF,117,139,22,0.16913144470267139,PASS
FD7D431CC2D42E4D722105725A1B1DF91243F4A227332DA3E233066F216C546,136,120,16,0.31731050786291404,PASS
C4821C3E48DBFF77C921834EB47DBEB47C1D945CB8E2247202D6A9CA1B7B2B99,126,130,4,0.8025873486341526,PASS
2421C2E14ACB4D84FBC6CB7ECDEF415D1D7C80A51193E7722A21E4B629FE177D,126,130,4,0.8025873486341526,PASS
A1FF6BADEB79E42857AFCB38B7D50208229D8B44993B4048C46E5E6973E41B1A,128,128,0,1.0,PASS
DE7816C958A55F8EFED264EE6F9FE92C3CD2365396F51A97447C19C62082AFAC,121,135,14,0.38157390570502125,PASS
17F05714194231F18722181661C38F87F0BF099D1F239B72F057014BF8829D50,138,118,20,0.2112995473337106,PASS
FA8765482285B6B3A6C28C6D16464CBAEE5C542796B8CAD21FB8BC733FB4C80B,128,128,0,1.0,PASS
7DDC635AEF8E3A7F513BD9FE9D417B037CDF973E0FC3643D3577B34C48754B40,112,144,32,0.04550026389635853,PASS
D2B4EECBAE1BF11958C6FD8C02544BA84A5C3B009892CEBAA705D9988424C64F,136,120,16,0.31731050786291404,PASS
AEC103D1930D037E2CAF0B1D47E55AC2926BC09CFC5809A0FAEBDDF77BA01EED,125,131,6,0.7076604666545525,PASS
EB28ADCB5C1BDFC662E7FF805BA35655FB8DE0621B9388C1FACBE9BF60FA9EE6,113,143,30,0.060792723530522785,PASS
F5ED826B28470ADD645FBDA6BE09493044B2998BE54AAED04729296B21F5A311,132,124,8,0.6170750774519738,PASS
7D276A2842108EFA91D087F45DF098A2B3C6E144F3964E888DE355A7890E1D1B,134,122,12,0.4532547047537365,PASS
DE6DED7AAF83DF7D141856A88AB9D02D9C5587841F6673585691F998912775E8,123,133,10,0.5319710580974012,PASS
A96F46B53487E316CC0336293572EB8939A71EECAB92C7E15569595764DE1C0C,127,129,2,0.9005235503397743,PASS
C95EF0182AB776EDFA318DEE61BCD90295BACACC63B7BFE494BEBABF1F23F3BA,110,146,36,0.024448945310089426,PASS
F6EB2E3D2A9DE0F8FAEA6D4FC5280E68A6DCA9DFBF46DBB2F630DE670E577F0B,109,147,38,0.01754895019147673,PASS
D5921FF9CA4A89FDF7CEB9F923392B05C14C495AEA2862A26A1F7BD1C3C47398,124,132,8,0.6170750774519738,PASS
61E081469BA4A69920E346986ABE8C8F686EB1FBFD68CF01A00DA014A03CA2B9,140,116,24,0.13361440253771617,PASS
46D502635605F086BA3D8D41831A3C3F9EEADF26F102F305E611AF380A6962C2,136,120,16,0.31731050786291404,PASS
783684A144B3657D86C1F1D9D956C92EF3E6DA889A9B8594C8CD0F57FEEC1A28,126,130,4,0.8025873486341526,PASS
F1F9B168C490F07F12B9638FDDB73D28752E4BB8ED8E4E83470AAD3B237AB050,124,132,8,0.6170750774519738,PASS
8A7A9CEB28C2125872C12EF54D14F0C893CEAB31D3B632F78356BC8FE0F32591,129,127,2,0.9005235503397743,PASS
C38CFB197A0D62C399F3052322D619CBD615B890B370D671100CE34F960B8D20,138,118,20,0.2112995473337106,PASS
38B393F5108DB9BA57AEE642B5DC2B764A8A4BFD10D3FE19335B590BFB89B565,119,137,18,0.2605890342736178,PASS
12F00297E476FCDC28CC6172160E54AF353FE6FD2B630A311704832A52D24B1D,135,121,14,0.38157390570502125,PASS
969680C707FA2244859D9E16109965DC30454982172A6805FAA1BCF7AE01B717,140,116,24,0.13361440253771617,PASS
CA1012A28E94E2D8C798161EDF2E8A2230CD96F5594647A9E10D8430316A0DF4,142,114,28,0.08011831372763423,PASS
FE8DCCB88FDBB860DC0E5F249C15447AF08BB015E12FBDE99EF919995FDF221B,119,137,18,0.2605890342736178,PASS
C2BA5030C672E9221677FFBC21222D8FEDAC1F672B0A46F4E37CF50623FF9B4B,122,134,12,0.4532547047537365,PASS
21E66735517BB5E37BD0D284402DEE066FD9BB1DCD8539BCA5E3AA4188DCD8E9,124,132,8,0.6170750774519738,PASS
56C670D9CE65A564E88B875A15142C747843938DC4BC0E21BBCCD9975B86DE85,131,125,6,0.7076604666545525,PASS
83F46D5FAF6287D841FF57EA7A05FDF09C9B291C18FDBE294012E6CE9585663B,120,136,16,0.31731050786291404,PASS
1DE4B70FFBF64DFE6465D5187C7123D8906CCC0926E446036F2296895F038DC3,129,127,2,0.9005235503397743,PASS
CA045945B3B737B0534572BD047079596959CBA6BB24355390F44CF042AD2A1,137,119,18,0.2605890342736178,PASS
3D975358856648FB1A53144890F20A1EE08F83C5AF09199CBF7874E8C3ACC8E8,135,121,14,0.38157390570502125,PASS
C749A29552273509C434E588295CE240BA4F38EEA202DCC745E895FCEFBC3DE9,131,125,6,0.7076604666545525,PASS
6D7F0C93A1E5B3122DCC593002D97B84BB202D3B8169079AEDC59951F938C2EF,130,126,4,0.8025873486341526,PASS
B5E2C81584BA9630B4326D9D02170F1D9C21A27B9A46E6284443A6574C971917,140,116,24,0.13361440253771617,PASS
D94E98413D396C1FEC010D97844D41BB8C1E26940DD7B3D76B79A3D1895475FE,127,129,2,0.9005235503397743,PASS
3F9E57826A183568D2A7C70086D46008DE20F8806F553AE18AA39F50F0365253,140,116,24,0.13361440253771617,PASS
13AABB76B0019A5A7316C5B7541742A4B01AFB6C66D83970DF88687C828F9D7B,129,127,2,0.9005235503397743,PASS
EA3C3499A60B3C46E2B2F46A2EE4ED942673B7B9992AA504D309455DD7E50AFA,127,129,2,0.9005235503397743,PASS
2916912BD16A78B9CED9776AFCAC30CDB342B23EF433AF965DF32E0DE094C6B2,122,134,12,0.4532547047537365,PASS
AC110F3B7EBE4B77C154895E1D0A8E35DF74BCBFE4731D4587CBEED83F280794,119,137,18,0.2605890342736178,PASS
4A89BB749A4EC11F7E606EDBC839EC68D840EAEE9FC0D8E2D202526EEC0D943,132,124,8,0.6170750774519738,PASS
E91F9779F970559534EEE50C63A4CE3EA0A8D3A910BD606F81D352F565479BE7,122,134,12,0.4532547047537365,PASS
41D779175523A58D1D4232A0338F73C6EA5F68242D6F8AE1E8DD5C6C2B2DE014,131,125,6,0.7076604666545525,PASS
20ECF2F5B4D57B7A9712B45B0CEB03D7A66EE6C1EDB66CA0B221D890C9BDCF92,122,134,12,0.4532547047537365,PASS
5815FC42A6ED040BCF1D77210AAAEA22F22E61B986AE2AD11AD3A98D2194C536,136,120,16,0.31731050786291404,PASS
C4D30CF56739FABEE7D3E96399F31258E027E0BFB288497119C53985184C5946,128,128,0,1.0,PASS
CD6AE350452539EEBDABC1917D5C18F3323FD86BF6BF581913AA63A55CF60C09,123,133,10,0.5319710580974012,PASS
C6DE3FCE51476D94EBD0821625E9CF4A4B82203859BDE25CC9C9ADA0E4ED7151,129,127,2,0.9005235503397743,PASS
EF8CECE51E61DC81FBA082E9F9CCFF439865E3391DC828160386C6A260F100B9,133,123,10,0.5319710580974012,PASS
1F884C26630BBBBA630B0B2E1AE29186C11DA98AA55C0AC1E77C00DCADACE0DF,136,120,16,0.31731050786291404,PASS
5EF7A1C1CB208B4560A31A55207CC87F679E63C318AD08277B113882E7692C32,137,119,18,0.2605890342736178,PASS
,256,0,256,1.2777508801076536e-57,FAIL
9E0C6A8BCC19027B31BCB4C32F25B3640E05C2CC766B52A0A9BF56D6F45918A2,134,122,12,0.4532547047537365,PASS
7F13344AD31AB3DE1089ED007A905DA82DBEA4F0AA1B01FF1F6EE2B84C6F7088,130,126,4,0.8025873486341526,PASS
983B3302C4529D0FB54582E8B9B2EE7AE67D518888589235796CAD91031C248A,139,117,22,0.16913144470267139,PASS
4882C3A08992DEF4537511DDFFD2CE60E0DE2656F6C255FA978D3B7B7226EE9C,121,135,14,0.38157390570502125,PASS
AA74E27F3A3C8EC6B57A96C9BC067B39C036C2E0F3D0A7B22348A2CB8AB9E3D7,124,132,8,0.6170750774519738,PASS
94F462A94B1E0C87691CCCBE95EE385F80063D6D9B5625434B3FB78422A3B183,132,124,8,0.6170750774519738,PASS
277826519916B9D7B5EDF508E33C6C6CD62DFEFD0083F78E3F74F47C6501387B,118,138,20,0.2112995473337106,PASS
99B2DFF008796AE36EB974EB52496DAE21ECDFFFD8780199C91CA0FA5F61D6AB,117,139,22,0.16913144470267139,PASS
84B00C968F88CFE8CA1C57D7DE71661B5D385693C2644D727A069A7D69F8C152,130,126,4,0.8025873486341526,PASS
94CACF428A2F5736894CBE72931FE30B2911AF089CD7AA8DCCB35F3A85575ACF,124,132,8,0.6170750774519738,PASS
1E3878E41DCB06036A6F69E420E7704280749EEA53E37C9B7A9348A1BC9DD6CB,130,126,4,0.8025873486341526,PASS
85841D24A2D5056AB2A52365BCC0062E800F01DB6A99E26AFDF99C45D6DB11A3,138,118,20,0.2112995473337106,PASS
8085A9BBCF5B954A6F5E9B9FCD652AE33C978C743C3D7387F5F611D8A5124CE7,118,138,20,0.2112995473337106,PASS
917229D323FD367379F484EEAB7F4F6355F0E4C8DBA31C27E3A6D3F310EF7266,115,141,26,0.10416255883043901,PASS
FC4DD7F7BD7B1ECB67CD2F602FF33591AAEEDC07730255A77CAC0696B7407F7C,110,146,36,0.024448945310089426,PASS
BE38030850386F9D6355D473B59BAFBF689731FE63E22BF434118615151021F0,132,124,8,0.6170750774519738,PASS
7775704599FDB89D41B9D3D07C6E1C17A928F7598CC6CDCA009F16484C22611A,132,124,8,0.6170750774519738,PASS
E99D493460470311A2B04D05DB85ACBED5E7DCF7ADE8EE5287B5DCAED891F9E7,120,136,16,0.31731050786291404,PASS
DE039ED3CF41F0FB9DDC2B879827503540EA1C330B41BDFF3E4C5F8626AA65CC,124,132,8,0.6170750774519738,PASS
C4E4DB431A5B0F1CF944B13BC58F9280CCF14D83F3B93818BF4F8D507513FC2C,128,128,0,1.0,PASS
610E23920EE1B110AD729F55E46D46DE65CF4B9D4F27FFFC683EDAAACE2EED85,118,138,20,0.2112995473337106,PASS
353C84AFE9AB9C1CDD361CD07475F4541DED7DCF1CAD923D2B1F73DF1EEB761F,111,145,34,0.03358661289689768,PASS
4FF2AD9BDA29D5BB449F5F05DF8F6A3D0040040D27056D8A7C59B1963E10C806,133,123,10,0.5319710580974012,PASS
67A70CB3D53F8E797FE559E2594F91B252850092BF559D464DC1F364D9BA1D8E,121,135,14,0.38157390570502125,PASS
1831C16ED5CFFCE0813CEF753352CB5B8278C9C5CC162D1E1E3C9BF9804FA8E,128,128,0,1.0,PASS
D1A5D5CD8127A5AD5BCA00DE536E263C5AB63286F936133C071666136328671,135,121,14,0.38157390570502125,PASS
1DB72983A2A6BCADA4FFF681B83738C3E3547BCC93C89F8B8A46994F7B6A6397,119,137,18,0.2605890342736178,PASS
7138B485FC427B17EDB412DBF64F6896496CE7C0803C53B33AB44F76FD065065,126,130,4,0.8025873486341526,PASS
5844746C6F0A1C179FCD4FA85A3926070BDBCBE65EDD1F8E6E662E234F25F6D0,123,133,10,0.5319710580974012,PASS
C237FF140E627A68EDCAD72D6BD105B1C58E989697C00D46E19B4F123340C5F6,130,126,4,0.8025873486341526,PASS
7C1FB8F9F136923B584207EADE826F03173A7C94A5B92D19F02AEEF9BF4C3C78,121,135,14,0.38157390570502125,PASS
E8B1B72F48C7FBB39A4F1E89DE8CFB61990C6477C2AA316D7F584365DCDF83F2,116,140,24,0.13361440253771617,PASS
E84293CFD2F28E052C5726FD1F2E4BB5D50DD514AD88894107D4429B52B13E8,135,121,14,0.38157390570502125,PASS
CF8E5A46B3DF5535BFE2592CC108D537E7D16AAA77DE65728695016F56D53BB1,117,139,22,0.16913144470267139,PASS
472C0636E981E4C7A960F1D54A63820E74BA6E5FDA5EEA7AFD3951FAC7FE6F8A,118,138,20,0.2112995473337106,PASS
41C6483E19D40A358936D1DB6A3C43C62933CE3B91E12555C3FBEFD9B5947BAF,124,132,8,0.6170750774519738,PASS
D6AB3CF5C18DCBA9A7EC13967C5B48D320C4F6843BDDAA613E18721C449B4CCA,128,128,0,1.0,PASS
174D0C193687640326B2629696993660AD1F28F5145FEEEAB01C47A1D53EA0CC,136,120,16,0.31731050786291404,PASS
4CE1829250087EE5340B49496B486F20E88C16968F93C6D4D652FFBA6CD9C5D6,134,122,12,0.4532547047537365,PASS
5D55A025FC2918B63E599B0945372C995C8059D53BA161B1DAF9AB00837D6B9A,132,124,8,0.6170750774519738,PASS
C6065541224712811CAD24BDED9A3808D753E3A64500CB110544F52D4FDBBB0A,142,114,28,0.08011831372763423,PASS
289A87EB208163E91E53D0A0F3FCFA350BB7A0D2ECEE32177B00CA938F27750F,128,128,0,1.0,PASS
FDDAFF19369E46E826A9FE0E55B2FC50AE415D98863815AE743BD896F2EE18E5,120,136,16,0.31731050786291404,PASS
2ACBFBE9E982CC4258775E320D752C6A209BB605EF47D4B7909E481EF76C1E0A,127,129,2,0.9005235503397743,PASS
33F4412E626E16C1B63145C8976FD015C843189E02977BBA633FBACD571CF595,128,128,0,1.0,PASS
5D85E324E2A529D5A6C16233AEC8A94179EABE23AB27D3160E2CEEAB99B27BD6,125,131,6,0.7076604666545525,PASS
4CAB4BB448FE4212630603A12E47DB982FD887E30C75EBB1E9018E8C5D38EB16,134,122,12,0.4532547047537365,PASS
E175532ABDC7059765CB0F6B92895C2CB5361036B18A020F940FB321C167178F,134,122,12,0.4532547047537365,PASS
2D631D7E1ACA4B3B164CD5DF18C36BB63D2E5D3B91175CA7FF25E1995322DEA1,119,137,18,0.2605890342736178,PASS
8425AE27797648EE8DB1237B4D2155CB8250143F06FED80BA449370144AA5603,140,116,24,0.13361440253771617,PASS
40CDBCC81C0A484A4DE84A673E1ED0FCF75B2018F669C600DDECE82F37177509,133,123,10,0.5319710580974012,PASS
D3B4295D28C173B1811D1BCEBEDDB89BF7453F3AD0A0F42F8B2A2CFA9416DE66,122,134,12,0.4532547047537365,PASS
8F40718016F2D4DBDAEE5CD472561E5B47C7F451E4E2816EBFE7CE96DFFF0661,117,139,22,0.16913144470267139,PASS
845761206AA8185A042387E64C8017156A54A9D3FBF3DBE8303D3116D534B7C3,138,118,20,0.2112995473337106,PASS
334C50EDBE673C1222A83AC445591CD695599B0351733242FCADCD1811F58403,139,117,22,0.16913144470267139,PASS
3EF8565BF33D4D24F9745EDD6E9E9A59566EB31F38DDFDCB70E7CCCDA3F51D07,106,150,44,0.005959526470109114,FAIL
63ACFDCC78F12FC5066D7F4A2A5B6B5311475C7212851B4CDDCC0BAB48F2A7D8,125,131,6,0.7076604666545525,PASS
832D4D6469B860EB0E026BCA64E74447CFC5B0BD31354E4923D8E2180B47C89C,138,118,20,0.2112995473337106,PASS
124840B46CFEDDE35AA69E4E3DC077FD17A7237EDAD0A1A316F499B55415D37D,121,135,14,0.38157390570502125,PASS
1884C6CA7A8061C4CD3A189A5FE3F9F13B86826F5C84FED47AEA82507CF35020,134,122,12,0.4532547047537365,PASS
C3EEA2B7B6836B563DABBC7D6426D6BEC68630AD90ABEE8358293AD526DF5EAA,118,138,20,0.2112995473337106,PASS
D744B0C042B68B9F1BE04E9FB5E0B599133E4E4D0FF6B375698338E47E4D064,129,127,2,0.9005235503397743,PASS
F624D9F4F7F6A11079EEF67B8EC93D96EA02394B18C511FF06CD5EC3A2F2490B,121,135,14,0.38157390570502125,PASS
4C89A15243E751E78983FAA9512C6B1D6F0A4B11B3AE71E9AB27E82C97A534F,130,126,4,0.8025873486341526,PASS
64EA1EC23AB745018A27E82CCB69BE314B05106A3E2A6DB713D83AB6841E82FB,134,122,12,0.4532547047537365,PASS
2514ED1650EF02003AD4C6BD8142FD27FC618C57D7ED617B01A37157A7B5E7AE,126,130,4,0.8025873486341526,PASS
9CFB86EB8BA2D7DD68B7908222CC12269DF11A965557D18801F0730BFC05CE8C,132,124,8,0.6170750774519738,PASS
6BEF7C713C51AFD6AC559AE9ADC3845D7C058910F7A38E105EB51DB50C1A2AA9,126,130,4,0.8025873486341526,PASS
98467DDA0E9D730340DA872378BAFDFA62F0E55D9C62FA604CB5473B7987440D,126,130,4,0.8025873486341526,PASS
B1E073F81782E7F60BB7B2E4662806EDACAA70EAC999A4C01B41BAEEF987F33F,122,134,12,0.4532547047537365,PASS
3763255A3B34E70588449BB105B93CB519D7E73FE055BF1171A595F2A80E9467,127,129,2,0.9005235503397743,PASS
9E0A136C46B8A84418ED8492092EBAC6D9A3E49AEB25C81066AE7D619F0EA172,138,118,20,0.2112995473337106,PASS
775C195B0AF84DB02DA5FC4CDECA5723C683C633FCEC44DE113B3410716941D4,130,126,4,0.8025873486341526,PASS
72860594219328BA9CC72378AB21D51E96C201A0AE833D7B3624E0EA76AA0742,142,114,28,0.08011831372763423,PASS
21E0F26DADA0188DBB71FB472A9A4CB9A82F1491409F2D9858CCEE1ECDAB6FC6,128,128,0,1.0,PASS
318D5BD26CDC7EFC8CC0DEFD93348FFBED96158F3420A2CFF8ED8538F14F02C1,120,136,16,0.31731050786291404,PASS
86846D001421FFD3F43752CC441132D0BA8A5783D00C1A74D10B3654139BC24E,145,111,34,0.03358661289689768,PASS
88C2575ED67199E89CF4CF2E079C99A8AD0A76A1DE913785FB3972A96D611D85,125,131,6,0.7076604666545525,PASS
5B26353D3ECE1AF1F1C382558A7732C215ABC6021E2C7E0C2A8F448556E7CEF2,130,126,4,0.8025873486341526,PASS
D76F6B97A6C28C760F91E088CFC81AE96F2355D05DFE289BC051BB674D41E519,125,131,6,0.7076604666545525,PASS
4D22F98130D1F67DF205CDC2883C694699F7EE85E783AA88053C457C126DEA15,132,124,8,0.6170750774519738,PASS
37C1AC13646224E02D96E33CB21FADA0962201E4D62AD7413107CB9539909D8,143,113,30,0.060792723530522785,PASS
F776BC183110F1A3007BEFD24E11BB01021C3A0E147A732CF3AD4511FEC28FE4,133,123,10,0.5319710580974012,PASS
5418ED4BCCA16F603A750A58476AE81161301F3E8A20D2B8A3ED809F5F9E4EDD,133,123,10,0.5319710580974012,PASS
DFE0FD2E6729478981589268E1BED2BD0C19207A3A6DA7A82FD903CBBE6D766,126,130,4,0.8025873486341526,PASS
315BD19196479FBAF1AD145C40CE9B4ACFA80BAF100CB939852F13F928174F7E,128,128,0,1.0,PASS
B4F8A2E7AB57FB492AC1B31D85469F0EE190742B55929BC89B822A92BEA265B2,129,127,2,0.9005235503397743,PASS
45CDDBDB4A0E273F780A7E281D5C5D2E49FA90923C0E0477EE5D3B6E10DCDBA8,125,131,6,0.7076604666545525,PASS
C50B7CBC20B22E51BC16E7132069B201931D3D2BAE8818575BD6BC0215396331,139,117,22,0.16913144470267139,PASS
BB7B8A42E4BE765F91EED178B2054C579E3CAAC89A680D67847409A79BB83CDB,124,132,8,0.6170750774519738,PASS
3053C7FA01BC1DFB9FDAB8DB9EBD13462CDF976FAE4CC2BD4AFB458F69C99C14,114,142,28,0.08011831372763423,PASS
7A9BE21CC9AD2A45E69987745D45AE0A8C3E466E4865E2BBE72DA18A75F6A519,126,130,4,0.8025873486341526,PASS
56E779C5B9EB4A626B8957737A0CAE028B4C94727E19C4881D0D692E9B13C8F4,130,126,4,0.8025873486341526,PASS
C64593964751CA0AC404987514F546ED59F55F706119F8A4085BA331D294ED42,138,118,20,0.2112995473337106,PASS
65BDC0DDDDACF1FD412F5D2C49F1B2EDF3D26C23C198BFAB0DEA8F0C7CE779F1,112,144,32,0.04550026389635853,PASS
41F62B28EF5B35F38DA49EB5B62C9CC128FCB4F7A64D3B56B27B3D36C32418A1,122,134,12,0.4532547047537365,PASS
1E1FF1851C6C26A2226977BBD7B87FCF0ADA733EE53807ECAE6BB7459D78D8D0,117,139,22,0.16913144470267139,PASS
2FEF23A3B1E95C807D810ED32DD0955F6E8477280E2A8E4ECD11D66928643ED4,131,125,6,0.7076604666545525,PASS
DCBAB56E027D555675A4E944F784A46DB65EF99AE4D4D79F8004A8A43C84FE40,127,129,2,0.9005235503397743,PASS
95620B0D87B74AF6FADE27BDA4D030A1B87633E890962F49C7DA18D7F523E495,125,131,6,0.7076604666545525,PASS
152C77E3C3FF311419E2EC69F7E8F16665A5A0E13C24D6D4D4E41259A771E4F1,125,131,6,0.7076604666545525,PASS
56664144DA43FA713EEBDC1D351FA79D83DC821103A50CD8543F8266501345ED,134,122,12,0.4532547047537365,PASS
B4AF8D37B3B19DF39C73761348496899E9B9B18D8D72FBEB594416A63C95176E,119,137,18,0.2605890342736178,PASS
5CF01A9AD768A6E8BBA4CD7BD929AF68D858766DEC37B5C721D77C8E44DF0A87,118,138,20,0.2112995473337106,PASS
998C2066F7D487A6D7165F15D29A39C18E90191632E2EBD3188E382C61C356E9,134,122,12,0.4532547047537365,PASS
6524C4A611904CC3B92897F81C9B39094B7C23CE055964CC010C863A7D16DEAA,142,114,28,0.08011831372763423,PASS
690FE622502D5CCE5809126B56FDD5ECC7946FEC2EC6C1F7F0AB90BD6FE4C75,122,134,12,0.4532547047537365,PASS
F69B811BB504417BB361E0F852964E346C63834CD405B07AC7770E23631208B,140,116,24,0.13361440253771617,PASS
E33F0CC7093598B28311ECB1494B3D52309A56545E3BBB82265ED749B2DCA8C7,131,125,6,0.7076604666545525,PASS
E4D3F2ECA725CBCF9B869D4E2C83EC50F08622162529717C235649329C6A0985,135,121,14,0.38157390570502125,PASS
A1E4D32A87FF71E8297E560822AA133FC4CE5F073A68634D200BE1F208428863,138,118,20,0.2112995473337106,PASS
9EA6A353806F7CCEAC9B4C8A515334F89F1CC40B69C914E3E9B62E3C459CA720,131,125,6,0.7076604666545525,PASS
AAEA78CC2C0000F5B7F29072E0450D522ED7E569C3CAA992972C897DAC67DD28,133,123,10,0.5319710580974012,PASS
C979097E4851150BE8C4AAC169DC4B966CEA2E9CE2DD9B34CF9B027E31CD5CD8,128,128,0,1.0,PASS
BAB5B28EA8B0A822232F863082B2F7ECFA38AF4D421F62C610F545DD8ED45CBD,129,127,2,0.9005235503397743,PASS
931EB3C15B3819FDE1D253C29172D7D2AC8362465E2514F47286D2A3E75C8596,130,126,4,0.8025873486341526,PASS
69793989BE3F24FF7C351FAAE52CEF777C613EAC418A34DD01CBAB03F0AAE4B5,118,138,20,0.2112995473337106,PASS
C9C65904F4C591409221A108AD440E2F7644F7C4E171D074C769656B92580FB1,142,114,28,0.08011831372763423,PASS
1ED0B5DECC864B5351DB9C0FAF54ABF670A4A06C1A380730D81D312BDAB831F2,131,125,6,0.7076604666545525,PASS
A9A98CF52F15E9E86EB039BD0B34E469996971303073F4E3295CD32E94B1CF2B,126,130,4,0.8025873486341526,PASS
6EBF9175B4BD20FC1E56560211A9B319BDB33D2DE1220B0CB9EBC7CF9319F0E4,124,132,8,0.6170750774519738,PASS
20C6733D32FFE11B9635C91E9FC08BC11393E5FDDB4146709AA7A287AB098B10,130,126,4,0.8025873486341526,PASS
C860CC9F0DDEA2DF5C940EDC415B23E5973800E354FC221A2AF6006ED481E9F3,134,122,12,0.4532547047537365,PASS
BE41E43161FEE29CFD335256A2F587CD09596DDB87A8B91C1DFE1358BEE4E77,119,137,18,0.2605890342736178,PASS
E307A3DAE0CDFDACB74863045A5AC6BB85A8C3AEDD9DC457DAF5C7D8F5086E73,118,138,20,0.2112995473337106,PASS
4C12F555FA5681C511071FDC042E190E5B2173AA09050E544DD310A95ED0E54E,142,114,28,0.08011831372763423,PASS
589323461DA1C93CD52A0D05725EDA1F7E99CF352FF167C3903D827E0DFD6350,126,130,4,0.8025873486341526,PASS
C206F41D347F75B6C9E1728C1326BEB11CC8FA43A46F80641D05777217AB239D,130,126,4,0.8025873486341526,PASS
EF2481DD3E6766B1B520672127726E717A62904BDBB2353134A26D26EC9A19E5,129,127,2,0.9005235503397743,PASS
BC57D2E0F399BC1D0DD756D2EE209CA8BC5DE1C09630D0A03819F51980FC0191,136,120,16,0.31731050786291404,PASS
FB4E73C8E5F135645EC995B6D583AC6D613BA73829715C12E51E97DD8857F462,121,135,14,0.38157390570502125,PASS
E8BE0D7EE11EE901E9940F08FA91DEA9E7D29E881BD00A180C7D80EC1F932B0F,132,124,8,0.6170750774519738,PASS
1899EC096FA474092ADB298548D8963D298C87F1CC2316342181BFE0174E07AB,140,116,24,0.13361440253771617,PASS
EA13389BA9B04243A014A0049872D198604DE683543F66399C8A2723F5D3C389,144,112,32,0.04550026389635853,PASS
EA6C4581A70E6EA14CE5D5965909C07FEB125A5E4E99A5D42133DC3BDDE13B62,127,129,2,0.9005235503397743,PASS
5813DC0968714C6A3DD841FBF2D28E3AA5E15DF592ABE7A470B0BE6868457EDE,125,131,6,0.7076604666545525,PASS
9FE911083BDF9577D7625E2ACF34856D41018F17E32A6F901EF47095E2F178A1,126,130,4,0.8025873486341526,PASS
83D7B35CD3A0D5B99B7AC220BED2F02F260A0755D3DE0A59771E8362D7AF87CB,122,134,12,0.4532547047537365,PASS
FC831F662A8882F626DE80760E43ABAA04E35E55C966371ABF1B6B7EB3136C5,128,128,0,1.0,PASS
5FABE598775C93572E27199274791B46540BA141CABB5C030EDE70590DF22EE5,128,128,0,1.0,PASS
422D8713D8B296154557A75AB8B2D677A5F0438DDCBD25353BBB083B2EE5ED6A,123,133,10,0.5319710580974012,PASS
F9AD8CF16777AAC582D86D1A9287D204F409616A5CAF14EF48298A3DC2892BF4,131,125,6,0.7076604666545525,PASS
D821011892E7DA39EE1FE3D6D37C5CEB3E75585BE0087B9F720A4E8F6DF24342,124,132,8,0.6170750774519738,PASS
5AE5AF3134A87684EC3787C7338D2CF31D320E7EE4F09C7BB49A2C4125B1ACD2,127,129,2,0.9005235503397743,PASS
CEDF08F3A26ADFCD043B4D559FCBD066A3BB0CA72311306748FAA5F21C950592,128,128,0,1.0,PASS
47398EA69EFFFAC00ADB1B4ED98C609E92CE21883C7E7991C6D741552BC661E1,127,129,2,0.9005235503397743,PASS
12243576EA488A3675D4CF5A54D49991A510DD4BDB53EC651D6C846FBAE9E247,128,128,0,1.0,PASS
312106AFD608B4063CB74A1C465CE37B91A11CD4EC9839B9F27A3843617312AF,135,121,14,0.38157390570502125,PASS
9B68DA8F99AC29E63A0F5DE9A72972374024209195A1DC6A15EE4F94AD3CA79F,127,129,2,0.9005235503397743,PASS
,256,0,256,1.2777508801076536e-57,FAIL
7DCC9FA135B4884D1715CE783C3A6EA2E495083AFBF474E0F8C6678CB8164EE2,127,129,2,0.9005235503397743,PASS
905B016AA46485DD528FFD4E9A3C5AEF347D3FECF1C1FD94BB93D4D9BF5AE11D,115,141,26,0.10416255883043901,PASS
D939A3115A5A98E4CF5D02D47736F9BC8B4F8195F6BB487B2A211A02FCC58214,131,125,6,0.7076604666545525,PASS
E2E78D1582A0E4047F027E8178F87A41EBDDEAD8A99D15B190FD39036E3F72D0,128,128,0,1.0,PASS
6D5BE5BCDEEDF9B30862E74127999921A986D983EDD12410D73CAB8258619BB9,126,130,4,0.8025873486341526,PASS
8C211DE06D1894EBE05F3C0367FA9B789B1FBD582EF17C41957807D1D15CD6A4,127,129,2,0.9005235503397743,PASS
1577BC4175F5121E2E59A88AE5A1D1A2504B97094DD124C5BED10B6AD7355319,133,123,10,0.5319710580974012,PASS
890EEC48F4A5F62F9F624039AEF62660F0607B4E466A2831C9D303D5809CE451,137,119,18,0.2605890342736178,PASS
636543966FDF598D26D8232B664C6B7562931FF42AAA3E6A207CE4F2B4EDF3FA,119,137,18,0.2605890342736178,PASS
45A53CF6F1615579C09F615BBFDCE3E28D5A6AD71A7C038874CD742D3A534E1E,122,134,12,0.4532547047537365,PASS
54404B19DFC6D2E9F4B6982AB531FAD7BAD860C0E310931B6B763D859C06D1B8,130,126,4,0.8025873486341526,PASS
FAFD4CBDEB3818A3F1DD5D25676F7D96686EA1CF804B37F826134E7D1E1F44BE,114,142,28,0.08011831372763423,PASS
Average,128.59918124302195,127.40081875697804,1.198362486043905,0.5014723605119994,0.9853926311871977
